,사망자수,확진자수,시도명,전일대비증감수,지역발생수,해외유입수,게시글번호,등록일,수정일
0,16,12323,검역,37,0,37,18667,2022-08-12 08:46:52.844,null
1,195,290315,제주,1984,1968,16,18666,2022-08-12 08:46:52.844,null
2,1316,1256882,경남,7768,7727,41,18665,2022-08-12 08:46:52.844,null
3,1481,920435,경북,6663,6633,30,18664,2022-08-12 08:46:52.843,null
4,526,682601,전남,5235,5225,10,18663,2022-08-12 08:46:52.843,null
5,910,700528,전북,4999,4978,21,18662,2022-08-12 08:46:52.843,null
6,1015,835014,충남,5747,5718,29,18661,2022-08-12 08:46:52.842,null
7,764,648612,충북,4239,4221,18,18660,2022-08-12 08:46:52.842,null
8,905,613030,강원,4311,4287,24,18659,2022-08-12 08:46:52.842,null
9,6512,5721871,경기,32748,32706,42,18658,2022-08-12 08:46:52.842,null
10,39,162430,세종,984,978,6,18657,2022-08-12 08:46:52.841,null
11,354,458046,울산,3104,3086,18,18656,2022-08-12 08:46:52.841,null
12,733,599470,대전,3797,3760,37,18655,2022-08-12 08:46:52.841,null
13,590,611485,광주,4040,4013,27,18654,2022-08-12 08:46:52.841,null
14,1432,1228654,인천,7010,6939,71,18653,2022-08-12 08:46:52.84,null
15,1385,880722,대구,5816,5796,20,18652,2022-08-12 08:46:52.84,null
16,2268,1266446,부산,7397,7393,4,18651,2022-08-12 08:46:52.84,null
17,5058,4222976,서울,22835,22822,13,18650,2022-08-12 08:46:52.839,null
18,25499,21111840,합계,128714,128250,464,18649,2022-08-12 08:46:52.839,null
19,16,12287,검역,34,0,34,18648,2022-08-11 09:12:52.221,null
20,195,288332,제주,2024,2009,15,18647,2022-08-11 09:12:52.22,null
21,1314,1249116,경남,8211,8178,33,18646,2022-08-11 09:12:52.22,null
22,1479,913773,경북,7126,7086,40,18645,2022-08-11 09:12:52.22,null
23,522,677367,전남,5342,5319,23,18644,2022-08-11 09:12:52.22,null
24,909,695532,전북,5501,5472,29,18643,2022-08-11 09:12:52.219,null
25,1013,829267,충남,5844,5809,35,18642,2022-08-11 09:12:52.219,null
26,763,644376,충북,4639,4609,30,18641,2022-08-11 09:12:52.219,null
27,902,608719,강원,4607,4589,18,18640,2022-08-11 09:12:52.219,null
28,6491,5689137,경기,34846,34780,66,18639,2022-08-11 09:12:52.219,null
29,39,161446,세종,1053,1045,8,18638,2022-08-11 09:12:52.218,null
30,354,454943,울산,3243,3216,27,18637,2022-08-11 09:12:52.218,null
31,733,595673,대전,4268,4245,23,18636,2022-08-11 09:12:52.218,null
32,590,607445,광주,4804,4779,25,18635,2022-08-11 09:12:52.218,null
33,1432,1221646,인천,6692,6613,79,18634,2022-08-11 09:12:52.217,null
34,1383,874906,대구,6301,6284,17,18633,2022-08-11 09:12:52.217,null
35,2265,1259054,부산,8190,8186,4,18632,2022-08-11 09:12:52.217,null
36,5041,4200150,서울,24516,24500,16,18631,2022-08-11 09:12:52.217,null
37,25441,20983169,합계,137241,136719,522,18630,2022-08-11 09:12:52.216,null
38,16,12253,검역,35,0,35,18629,2022-08-10 09:27:04.658,null
39,195,286308,제주,1993,1977,16,18628,2022-08-10 09:27:04.658,null
40,1310,1240906,경남,8887,8834,53,18627,2022-08-10 09:27:04.658,null
41,1476,906647,경북,8512,8464,48,18626,2022-08-10 09:27:04.657,null
42,520,672028,전남,5863,5841,22,18625,2022-08-10 09:27:04.657,null
43,903,690031,전북,6086,6047,39,18624,2022-08-10 09:27:04.657,null
44,1009,823433,충남,6642,6619,23,18623,2022-08-10 09:27:04.657,null
45,759,639739,충북,5349,5324,25,18622,2022-08-10 09:27:04.656,null
46,897,604112,강원,5275,5252,23,18621,2022-08-10 09:27:04.656,null
47,6480,5654300,경기,38095,38016,79,18620,2022-08-10 09:27:04.656,null
48,39,160394,세종,1327,1318,9,18619,2022-08-10 09:27:04.656,null
49,353,451704,울산,4197,4180,17,18618,2022-08-10 09:27:04.655,null
50,733,591405,대전,4675,4644,31,18617,2022-08-10 09:27:04.655,null
51,589,602643,광주,5159,5119,40,18616,2022-08-10 09:27:04.655,null
52,1429,1214957,인천,7715,7615,100,18615,2022-08-10 09:27:04.655,null
53,1381,868605,대구,6997,6979,18,18614,2022-08-10 09:27:04.655,null
54,2263,1250865,부산,8917,8902,15,18613,2022-08-10 09:27:04.654,null
55,5030,4175643,서울,26068,26046,22,18612,2022-08-10 09:27:04.654,null
56,25382,20845973,합계,151792,151177,615,18611,2022-08-10 09:27:04.654,null
57,16,12218,검역,35,0,35,18610,2022-08-09 09:08:06.265,null
58,195,284315,제주,1656,1638,18,18609,2022-08-09 09:08:06.264,null
59,1308,1232021,경남,9437,9366,71,18608,2022-08-09 09:08:06.264,null
60,1475,898135,경북,5898,5864,34,18607,2022-08-09 09:08:06.264,null
61,520,666170,전남,5016,4998,18,18606,2022-08-09 09:08:06.264,null
62,902,683947,전북,5507,5481,26,18605,2022-08-09 09:08:06.264,null
63,999,816791,충남,5952,5926,26,18604,2022-08-09 09:08:06.263,null
64,757,634391,충북,5100,5074,26,18603,2022-08-09 09:08:06.263,null
65,893,598839,강원,4760,4749,11,18602,2022-08-09 09:08:06.263,null
66,6474,5616226,경기,39024,38975,49,18601,2022-08-09 09:08:06.263,null
67,38,159068,세종,1155,1153,2,18600,2022-08-09 09:08:06.262,null
68,353,447511,울산,3523,3508,15,18599,2022-08-09 09:08:06.262,null
69,731,586730,대전,4952,4917,35,18598,2022-08-09 09:08:06.262,null
70,584,597484,광주,3461,3419,42,18597,2022-08-09 09:08:06.262,null
71,1429,1207246,인천,7770,7640,130,18596,2022-08-09 09:08:06.262,null
72,1379,861608,대구,7151,7132,19,18595,2022-08-09 09:08:06.261,null
73,2259,1241953,부산,10011,9999,12,18594,2022-08-09 09:08:06.261,null
74,5020,4149586,서울,29489,29470,19,18593,2022-08-09 09:08:06.261,null
75,25332,20694239,합계,149897,149309,588,18592,2022-08-09 09:08:06.26,null
76,16,12184,검역,46,0,46,18591,2022-08-08 09:04:08.901,null
77,193,282659,제주,1243,1229,14,18590,2022-08-08 09:04:08.9,null
78,1307,1222584,경남,3048,3016,32,18589,2022-08-08 09:04:08.9,null
79,1474,892238,경북,3420,3372,48,18588,2022-08-08 09:04:08.9,null
80,519,661154,전남,2045,2039,6,18587,2022-08-08 09:04:08.9,null
81,901,678443,전북,2232,2206,26,18586,2022-08-08 09:04:08.9,null
82,996,810839,충남,2234,2222,12,18585,2022-08-08 09:04:08.899,null
83,754,629292,충북,1961,1928,33,18584,2022-08-08 09:04:08.899,null
84,889,594081,강원,2509,2491,18,18583,2022-08-08 09:04:08.899,null
85,6466,5577226,경기,15095,15065,30,18582,2022-08-08 09:04:08.899,null
86,38,157915,세종,520,508,12,18581,2022-08-08 09:04:08.898,null
87,352,443994,울산,1604,1593,11,18580,2022-08-08 09:04:08.898,null
88,730,581779,대전,1772,1758,14,18579,2022-08-08 09:04:08.898,null
89,581,594023,광주,1997,1970,27,18578,2022-08-08 09:04:08.898,null
90,1429,1199478,인천,2792,2672,120,18577,2022-08-08 09:04:08.897,null
91,1377,854458,대구,2285,2275,10,18576,2022-08-08 09:04:08.897,null
92,2258,1231947,부산,2622,2613,9,18575,2022-08-08 09:04:08.897,null
93,5012,4120126,서울,7867,7853,14,18574,2022-08-08 09:04:08.897,null
94,25292,20544420,합계,55292,54810,482,18573,2022-08-08 09:04:08.896,null
95,16,12138,검역,28,0,28,18572,2022-08-07 09:09:11.122,null
96,190,281416,제주,1828,1814,14,18571,2022-08-07 09:09:11.122,null
97,1305,1219536,경남,6736,6690,46,18570,2022-08-07 09:09:11.122,null
98,1474,888818,경북,5893,5847,46,18569,2022-08-07 09:09:11.122,null
99,519,659109,전남,3288,3285,3,18568,2022-08-07 09:09:11.121,null
100,901,676211,전북,4481,4461,20,18567,2022-08-07 09:09:11.121,null
101,995,808605,충남,4470,4437,33,18566,2022-08-07 09:09:11.121,null
102,752,627331,충북,3656,3637,19,18565,2022-08-07 09:09:11.121,null
103,889,591572,강원,3431,3423,8,18564,2022-08-07 09:09:11.12,null
104,6457,5562131,경기,26291,26242,49,18563,2022-08-07 09:09:11.12,null
105,38,157395,세종,863,852,11,18562,2022-08-07 09:09:11.12,null
106,350,442390,울산,3135,3115,20,18561,2022-08-07 09:09:11.12,null
107,729,580007,대전,3452,3431,21,18560,2022-08-07 09:09:11.119,null
108,581,592026,광주,3415,3391,24,18559,2022-08-07 09:09:11.119,null
109,1427,1196686,인천,5625,5545,80,18558,2022-08-07 09:09:11.119,null
110,1377,852173,대구,4721,4686,35,18557,2022-08-07 09:09:11.119,null
111,2258,1229325,부산,5828,5825,3,18556,2022-08-07 09:09:11.118,null
112,5005,4112259,서울,18366,18342,24,18555,2022-08-07 09:09:11.118,null
113,25263,20489128,합계,105507,105023,484,18554,2022-08-07 09:09:11.118,null
114,16,12110,검역,41,0,41,18553,2022-08-06 09:16:42.617,null
115,188,279588,제주,1642,1636,6,18552,2022-08-06 09:16:42.617,null
116,1302,1212800,경남,6760,6724,36,18551,2022-08-06 09:16:42.617,null
117,1472,882925,경북,5721,5685,36,18550,2022-08-06 09:16:42.616,null
118,518,655821,전남,3591,3568,23,18549,2022-08-06 09:16:42.616,null
119,900,671730,전북,4085,4054,31,18548,2022-08-06 09:16:42.616,null
120,992,804135,충남,4714,4662,52,18547,2022-08-06 09:16:42.616,null
121,750,623675,충북,3913,3891,22,18546,2022-08-06 09:16:42.615,null
122,888,588141,강원,3975,3965,10,18545,2022-08-06 09:16:42.615,null
123,6453,5535840,경기,29097,29017,80,18544,2022-08-06 09:16:42.615,null
124,38,156532,세종,823,813,10,18543,2022-08-06 09:16:42.614,null
125,350,439255,울산,2958,2947,11,18542,2022-08-06 09:16:42.614,null
126,727,576555,대전,3462,3437,25,18541,2022-08-06 09:16:42.614,null
127,580,588611,광주,2845,2810,35,18540,2022-08-06 09:16:42.614,null
128,1426,1191061,인천,5595,5487,108,18539,2022-08-06 09:16:42.613,null
129,1376,847452,대구,4706,4688,18,18538,2022-08-06 09:16:42.613,null
130,2257,1223497,부산,6578,6567,11,18537,2022-08-06 09:16:42.613,null
131,5003,4093893,서울,20160,20142,18,18536,2022-08-06 09:16:42.612,null
132,25236,20383621,합계,110666,110093,573,18535,2022-08-06 09:16:42.612,null
133,16,12069,검역,35,0,35,18534,2022-08-05 08:21:30.876,null
134,188,277946,제주,1705,1688,17,18533,2022-08-05 08:21:30.876,null
135,1298,1206040,경남,6385,6360,25,18532,2022-08-05 08:21:30.875,null
136,1469,877204,경북,5783,5751,32,18531,2022-08-05 08:21:30.875,null
137,517,652230,전남,3887,3872,15,18530,2022-08-05 08:21:30.875,null
138,900,667648,전북,4116,4103,13,18529,2022-08-05 08:21:30.875,null
139,990,799431,충남,4807,4764,43,18528,2022-08-05 08:21:30.874,null
140,748,619763,충북,3754,3718,36,18527,2022-08-05 08:21:30.874,null
141,887,584167,강원,4011,3998,13,18526,2022-08-05 08:21:30.874,null
142,6443,5506753,경기,29427,29382,45,18525,2022-08-05 08:21:30.873,null
143,38,155709,세종,873,870,3,18524,2022-08-05 08:21:30.873,null
144,348,436300,울산,2937,2927,10,18523,2022-08-05 08:21:30.873,null
145,725,573094,대전,3625,3596,29,18522,2022-08-05 08:21:30.873,null
146,578,585768,광주,3394,3367,27,18521,2022-08-05 08:21:30.873,null
147,1424,1185469,인천,5906,5799,107,18520,2022-08-05 08:21:30.872,null
148,1375,842746,대구,4801,4781,20,18519,2022-08-05 08:21:30.872,null
149,2253,1216922,부산,6638,6629,9,18518,2022-08-05 08:21:30.872,null
150,4994,4073752,서울,20817,20799,18,18517,2022-08-05 08:21:30.871,null
151,25191,20273011,합계,112901,112404,497,18516,2022-08-05 08:21:30.871,null
152,16,12034,검역,35,0,35,18515,2022-08-04 09:00:17.968,null
153,188,276244,제주,1895,1888,7,18514,2022-08-04 09:00:17.968,null
154,1295,1199658,경남,5815,5796,19,18513,2022-08-04 09:00:17.968,null
155,1468,871422,경북,5687,5659,28,18512,2022-08-04 09:00:17.967,null
156,513,648343,전남,3159,3143,16,18511,2022-08-04 09:00:17.967,null
157,895,663532,전북,4231,4203,28,18510,2022-08-04 09:00:17.967,null
158,990,794624,충남,4362,4341,21,18509,2022-08-04 09:00:17.967,null
159,747,616012,충북,3622,3598,24,18508,2022-08-04 09:00:17.967,null
160,886,580156,강원,4370,4362,8,18507,2022-08-04 09:00:17.966,null
161,6429,5477347,경기,27827,27799,28,18506,2022-08-04 09:00:17.966,null
162,38,154837,세종,918,916,2,18505,2022-08-04 09:00:17.966,null
163,348,433367,울산,2881,2864,17,18504,2022-08-04 09:00:17.966,null
164,723,569469,대전,3314,3293,21,18503,2022-08-04 09:00:17.965,null
165,577,582374,광주,3416,3375,41,18502,2022-08-04 09:00:17.965,null
166,1424,1179566,인천,5543,5440,103,18501,2022-08-04 09:00:17.965,null
167,1372,837945,대구,4394,4377,17,18500,2022-08-04 09:00:17.965,null
168,2250,1210285,부산,6186,6180,6,18499,2022-08-04 09:00:17.964,null
169,4985,4052939,서울,20239,20225,14,18498,2022-08-04 09:00:17.964,null
170,25144,20160154,합계,107894,107459,435,18497,2022-08-04 09:00:17.964,null
171,16,11999,검역,18,0,18,18496,2022-08-03 09:03:34.217,null
172,187,274349,제주,1968,1954,14,18495,2022-08-03 09:03:34.216,null
173,1293,1193844,경남,6380,6352,28,18494,2022-08-03 09:03:34.216,null
174,1468,865735,경북,6185,6146,39,18493,2022-08-03 09:03:34.216,null
175,512,645188,전남,3635,3614,21,18492,2022-08-03 09:03:34.216,null
176,894,659302,전북,4304,4276,28,18491,2022-08-03 09:03:34.215,null
177,989,790262,충남,5561,5539,22,18490,2022-08-03 09:03:34.215,null
178,744,612390,충북,3954,3916,38,18489,2022-08-03 09:03:34.215,null
179,885,575787,강원,4613,4589,24,18488,2022-08-03 09:03:34.215,null
180,6416,5449537,경기,31701,31638,63,18487,2022-08-03 09:03:34.214,null
181,38,153921,세종,950,933,17,18486,2022-08-03 09:03:34.214,null
182,348,430486,울산,2859,2829,30,18485,2022-08-03 09:03:34.214,null
183,722,566155,대전,3532,3503,29,18484,2022-08-03 09:03:34.213,null
184,577,578959,광주,3553,3489,64,18483,2022-08-03 09:03:34.213,null
185,1424,1174028,인천,6266,6163,103,18482,2022-08-03 09:03:34.213,null
186,1369,833552,대구,4761,4746,15,18481,2022-08-03 09:03:34.213,null
187,2249,1204102,부산,6659,6649,10,18480,2022-08-03 09:03:34.212,null
188,4979,4032709,서울,23023,22986,37,18479,2022-08-03 09:03:34.212,null
189,25110,20052305,합계,119922,119322,600,18478,2022-08-03 09:03:34.212,null
190,16,11981,검역,33,0,33,18477,2022-08-02 09:03:33.779,null
191,187,272381,제주,1503,1487,16,18476,2022-08-02 09:03:33.778,null
192,1291,1187466,경남,6002,5978,24,18475,2022-08-02 09:03:33.778,null
193,1466,859550,경북,4404,4362,42,18474,2022-08-02 09:03:33.778,null
194,511,641555,전남,3131,3101,30,18473,2022-08-02 09:03:33.778,null
195,894,654998,전북,3652,3615,37,18472,2022-08-02 09:03:33.778,null
196,989,784701,충남,4297,4275,22,18471,2022-08-02 09:03:33.777,null
197,743,608437,충북,3323,3293,30,18470,2022-08-02 09:03:33.777,null
198,883,571175,강원,3120,3109,11,18469,2022-08-02 09:03:33.777,null
199,6408,5417847,경기,30098,30049,49,18468,2022-08-02 09:03:33.777,null
200,38,152972,세종,1010,1004,6,18467,2022-08-02 09:03:33.776,null
201,348,427629,울산,2540,2532,8,18466,2022-08-02 09:03:33.776,null
202,722,562623,대전,4166,4119,47,18465,2022-08-02 09:03:33.776,null
203,576,575406,광주,2649,2595,54,18464,2022-08-02 09:03:33.776,null
204,1423,1167765,인천,5747,5624,123,18463,2022-08-02 09:03:33.775,null
205,1368,828795,대구,4486,4469,17,18462,2022-08-02 09:03:33.775,null
206,2247,1197451,부산,7013,7009,4,18461,2022-08-02 09:03:33.775,null
207,4974,4009707,서울,24615,24600,15,18460,2022-08-02 09:03:33.775,null
208,25084,19932439,합계,111789,111221,568,18459,2022-08-02 09:03:33.774,null
209,16,11950,검역,27,0,27,18458,2022-08-01 09:00:17.825,null
210,187,270878,제주,1013,1005,8,18457,2022-08-01 09:00:17.825,null
211,1291,1181465,경남,2256,2226,30,18456,2022-08-01 09:00:17.825,null
212,1464,855146,경북,2398,2379,19,18455,2022-08-01 09:00:17.824,null
213,511,638424,전남,1448,1446,2,18454,2022-08-01 09:00:17.824,null
214,893,651347,전북,1579,1561,18,18453,2022-08-01 09:00:17.824,null
215,989,780405,충남,1809,1781,28,18452,2022-08-01 09:00:17.824,null
216,742,605115,충북,1445,1417,28,18451,2022-08-01 09:00:17.824,null
217,883,568058,강원,1451,1441,10,18450,2022-08-01 09:00:17.823,null
218,6404,5387764,경기,13007,12983,24,18449,2022-08-01 09:00:17.823,null
219,38,151967,세종,359,349,10,18448,2022-08-01 09:00:17.823,null
220,348,425091,울산,1096,1092,4,18447,2022-08-01 09:00:17.823,null
221,722,558457,대전,1488,1462,26,18446,2022-08-01 09:00:17.822,null
222,576,572757,광주,1495,1473,22,18445,2022-08-01 09:00:17.822,null
223,1423,1162049,인천,2459,2301,158,18444,2022-08-01 09:00:17.822,null
224,1367,824310,대구,1948,1933,15,18443,2022-08-01 09:00:17.822,null
225,2244,1190441,부산,2071,2067,4,18442,2022-08-01 09:00:17.822,null
226,4970,3985115,서울,7340,7337,3,18441,2022-08-01 09:00:17.821,null
227,25068,19820739,합계,44689,44253,436,18440,2022-08-01 09:00:17.821,null
228,16,11923,검역,24,0,24,18439,2022-07-31 08:57:55.679,null
229,187,269865,제주,1583,1560,23,18438,2022-07-31 08:57:55.679,null
230,1290,1179209,경남,3973,3955,18,18437,2022-07-31 08:57:55.679,null
231,1463,852748,경북,4145,4117,28,18436,2022-07-31 08:57:55.679,null
232,508,636976,전남,2195,2185,10,18435,2022-07-31 08:57:55.678,null
233,893,649768,전북,3010,2992,18,18434,2022-07-31 08:57:55.678,null
234,988,778596,충남,3250,3238,12,18433,2022-07-31 08:57:55.678,null
235,742,603670,충북,2543,2528,15,18432,2022-07-31 08:57:55.678,null
236,882,566607,강원,2475,2460,15,18431,2022-07-31 08:57:55.677,null
237,6398,5374757,경기,18589,18568,21,18430,2022-07-31 08:57:55.677,null
238,38,151608,세종,588,581,7,18429,2022-07-31 08:57:55.677,null
239,348,423995,울산,2070,2063,7,18428,2022-07-31 08:57:55.677,null
240,721,556969,대전,2418,2396,22,18427,2022-07-31 08:57:55.677,null
241,575,571262,광주,2284,2258,26,18426,2022-07-31 08:57:55.676,null
242,1421,1159590,인천,3951,3876,75,18425,2022-07-31 08:57:55.676,null
243,1366,822362,대구,2506,2487,19,18424,2022-07-31 08:57:55.676,null
244,2242,1188370,부산,3836,3835,1,18423,2022-07-31 08:57:55.676,null
245,4969,3977775,서울,14149,14149,0,18422,2022-07-31 08:57:55.675,null
246,25047,19776050,합계,73589,73248,341,18421,2022-07-31 08:57:55.675,null
247,16,11899,검역,12,0,12,18420,2022-07-30 07:41:55.335,null
248,187,268282,제주,1837,1825,12,18419,2022-07-30 07:41:55.335,null
249,1290,1175236,경남,4448,4423,25,18418,2022-07-30 07:41:55.335,null
250,1461,848603,경북,3812,3774,38,18417,2022-07-30 07:41:55.335,null
251,507,634781,전남,2316,2288,28,18416,2022-07-30 07:41:55.334,null
252,893,646758,전북,2926,2907,19,18415,2022-07-30 07:41:55.334,null
253,988,775346,충남,3357,3345,12,18414,2022-07-30 07:41:55.334,null
254,741,601127,충북,2781,2762,19,18413,2022-07-30 07:41:55.334,null
255,880,564132,강원,2610,2604,6,18412,2022-07-30 07:41:55.333,null
256,6394,5356168,경기,22433,22374,59,18411,2022-07-30 07:41:55.333,null
257,38,151020,세종,623,615,8,18410,2022-07-30 07:41:55.333,null
258,347,421925,울산,2097,2090,7,18409,2022-07-30 07:41:55.333,null
259,719,554551,대전,2477,2459,18,18408,2022-07-30 07:41:55.332,null
260,574,568978,광주,2172,2144,28,18407,2022-07-30 07:41:55.332,null
261,1421,1155639,인천,4117,4042,75,18406,2022-07-30 07:41:55.332,null
262,1366,819856,대구,2874,2859,15,18405,2022-07-30 07:41:55.332,null
263,2241,1184534,부산,4522,4520,2,18404,2022-07-30 07:41:55.331,null
264,4964,3963626,서울,16588,16574,14,18403,2022-07-30 07:41:55.331,null
265,25027,19702461,합계,82002,81605,397,18402,2022-07-30 07:41:55.331,null
266,16,11887,검역,37,0,37,18401,2022-07-29 08:58:43.602,null
267,187,266445,제주,1622,1597,25,18400,2022-07-29 08:58:43.602,null
268,1289,1170788,경남,4447,4425,22,18399,2022-07-29 08:58:43.602,null
269,1461,844791,경북,3796,3770,26,18398,2022-07-29 08:58:43.602,null
270,506,632468,전남,2366,2352,14,18397,2022-07-29 08:58:43.601,null
271,893,643832,전북,2921,2893,28,18396,2022-07-29 08:58:43.601,null
272,987,771999,충남,3497,3474,23,18395,2022-07-29 08:58:43.601,null
273,741,598347,충북,2578,2557,21,18394,2022-07-29 08:58:43.601,null
274,880,561522,강원,2774,2768,6,18393,2022-07-29 08:58:43.6,null
275,6376,5333741,경기,23565,23516,49,18392,2022-07-29 08:58:43.6,null
276,38,150398,세종,632,622,10,18391,2022-07-29 08:58:43.6,null
277,346,419829,울산,2160,2153,7,18390,2022-07-29 08:58:43.6,null
278,719,552076,대전,2557,2534,23,18389,2022-07-29 08:58:43.6,null
279,573,566809,광주,2381,2369,12,18388,2022-07-29 08:58:43.599,null
280,1418,1151538,인천,4380,4280,100,18387,2022-07-29 08:58:43.599,null
281,1366,816984,대구,3498,3481,17,18386,2022-07-29 08:58:43.599,null
282,2238,1180014,부산,4592,4584,8,18385,2022-07-29 08:58:43.598,null
283,4958,3947049,서울,17517,17506,11,18384,2022-07-29 08:58:43.598,null
284,24992,19620517,합계,85320,84881,439,18383,2022-07-29 08:58:43.598,null
285,16,11850,검역,23,0,23,18382,2022-07-28 08:49:34.169,null
286,187,264823,제주,1839,1826,13,18381,2022-07-28 08:49:34.168,null
287,1288,1166341,경남,4435,4416,19,18380,2022-07-28 08:49:34.168,null
288,1457,840996,경북,4287,4245,42,18379,2022-07-28 08:49:34.168,null
289,504,630105,전남,2418,2410,8,18378,2022-07-28 08:49:34.168,null
290,893,640911,전북,2800,2784,16,18377,2022-07-28 08:49:34.167,null
291,983,768503,충남,3658,3634,24,18376,2022-07-28 08:49:34.167,null
292,740,595770,충북,2905,2881,24,18375,2022-07-28 08:49:34.167,null
293,879,558750,강원,2853,2841,12,18374,2022-07-28 08:49:34.167,null
294,6362,5310198,경기,24254,24214,40,18373,2022-07-28 08:49:34.167,null
295,38,149770,세종,728,722,6,18372,2022-07-28 08:49:34.166,null
296,345,417669,울산,2377,2365,12,18371,2022-07-28 08:49:34.166,null
297,719,549519,대전,2572,2548,24,18370,2022-07-28 08:49:34.166,null
298,573,564428,광주,2469,2443,26,18369,2022-07-28 08:49:34.166,null
299,1416,1147162,인천,4848,4752,96,18368,2022-07-28 08:49:34.165,null
300,1366,813487,대구,3053,3031,22,18367,2022-07-28 08:49:34.165,null
301,2237,1175423,부산,4696,4689,7,18366,2022-07-28 08:49:34.165,null
302,4954,3929537,서울,18169,18158,11,18365,2022-07-28 08:49:34.165,null
303,24957,19535242,합계,88384,87959,425,18364,2022-07-28 08:49:34.164,null
304,16,11827,검역,21,0,21,18363,2022-07-27 09:13:09.71,null
305,187,262985,제주,2054,2040,14,18362,2022-07-27 09:13:09.71,null
306,1287,1161907,경남,5480,5425,55,18361,2022-07-27 09:13:09.71,null
307,1456,836714,경북,4968,4921,47,18360,2022-07-27 09:13:09.71,null
308,503,627688,전남,2637,2630,7,18359,2022-07-27 09:13:09.71,null
309,893,638114,전북,3371,3334,37,18358,2022-07-27 09:13:09.709,null
310,983,764845,충남,4189,4184,5,18357,2022-07-27 09:13:09.709,null
311,739,592867,충북,3242,3203,39,18356,2022-07-27 09:13:09.709,null
312,879,555897,강원,3303,3287,16,18355,2022-07-27 09:13:09.709,null
313,6352,5285963,경기,27214,27154,60,18354,2022-07-27 09:13:09.708,null
314,38,149042,세종,832,825,7,18353,2022-07-27 09:13:09.708,null
315,345,415292,울산,2674,2657,17,18352,2022-07-27 09:13:09.708,null
316,719,546947,대전,2845,2822,23,18351,2022-07-27 09:13:09.707,null
317,573,561959,광주,2890,2844,46,18350,2022-07-27 09:13:09.707,null
318,1416,1142324,인천,5314,5207,107,18349,2022-07-27 09:13:09.707,null
319,1364,810435,대구,3879,3856,23,18348,2022-07-27 09:13:09.707,null
320,2233,1170733,부산,5289,5287,2,18347,2022-07-27 09:13:09.706,null
321,4949,3911407,서울,20083,20077,6,18346,2022-07-27 09:13:09.706,null
322,24932,19446946,합계,100285,99753,532,18345,2022-07-27 09:13:09.706,null
323,16,11806,검역,17,0,17,18344,2022-07-26 09:03:14.995,null
324,187,260931,제주,1624,1606,18,18343,2022-07-26 09:03:14.994,null
325,1286,1156429,경남,5463,5437,26,18342,2022-07-26 09:03:14.994,null
326,1453,831747,경북,3355,3326,29,18341,2022-07-26 09:03:14.994,null
327,502,625059,전남,2547,2534,13,18340,2022-07-26 09:03:14.994,null
328,892,634745,전북,2915,2908,7,18339,2022-07-26 09:03:14.994,null
329,983,760656,충남,4198,4176,22,18338,2022-07-26 09:03:14.994,null
330,739,589628,충북,3008,2993,15,18337,2022-07-26 09:03:14.993,null
331,879,552596,강원,2478,2471,7,18336,2022-07-26 09:03:14.993,null
332,6344,5258766,경기,27280,27256,24,18335,2022-07-26 09:03:14.993,null
333,37,148210,세종,796,792,4,18334,2022-07-26 09:03:14.993,null
334,345,412618,울산,2393,2393,0,18333,2022-07-26 09:03:14.993,null
335,719,544102,대전,2706,2672,34,18332,2022-07-26 09:03:14.992,null
336,573,559069,광주,2315,2290,25,18331,2022-07-26 09:03:14.992,null
337,1416,1137061,인천,5363,5273,90,18330,2022-07-26 09:03:14.992,null
338,1363,806559,대구,3444,3431,13,18329,2022-07-26 09:03:14.992,null
339,2229,1165446,부산,6318,6310,8,18328,2022-07-26 09:03:14.991,null
340,4944,3891336,서울,23107,23106,1,18327,2022-07-26 09:03:14.991,null
341,24907,19346764,합계,99327,98974,353,18326,2022-07-26 09:03:14.991,null
342,16,11789,검역,46,0,46,18325,2022-07-25 09:13:26.82,null
343,187,259309,제주,1207,1193,14,18324,2022-07-25 09:13:26.82,null
344,1284,1150966,경남,1947,1926,21,18323,2022-07-25 09:13:26.82,null
345,1450,828393,경북,1771,1739,32,18322,2022-07-25 09:13:26.82,null
346,501,622519,전남,992,987,5,18321,2022-07-25 09:13:26.82,null
347,891,631831,전북,1216,1200,16,18320,2022-07-25 09:13:26.819,null
348,982,756458,충남,1401,1382,19,18319,2022-07-25 09:13:26.819,null
349,738,586620,충북,1259,1241,18,18318,2022-07-25 09:13:26.819,null
350,879,550119,강원,1066,1058,8,18317,2022-07-25 09:13:26.819,null
351,6343,5231497,경기,10903,10876,27,18316,2022-07-25 09:13:26.818,null
352,37,147414,세종,232,224,8,18315,2022-07-25 09:13:26.818,null
353,344,410231,울산,702,702,0,18314,2022-07-25 09:13:26.818,null
354,719,541396,대전,1251,1233,18,18313,2022-07-25 09:13:26.818,null
355,573,556754,광주,1106,1080,26,18312,2022-07-25 09:13:26.818,null
356,1416,1131698,인천,1948,1880,68,18311,2022-07-25 09:13:26.817,null
357,1359,803115,대구,1432,1423,9,18310,2022-07-25 09:13:26.817,null
358,2228,1159131,부산,1437,1431,6,18309,2022-07-25 09:13:26.817,null
359,4943,3868256,서울,5967,5965,2,18308,2022-07-25 09:13:26.817,null
360,24890,19247496,합계,35883,35540,343,18307,2022-07-25 09:13:26.816,null
361,16,11743,검역,11,0,11,18306,2022-07-24 09:09:59.515,null
362,187,258102,제주,1678,1665,13,18305,2022-07-24 09:09:59.514,null
363,1283,1149019,경남,3517,3503,14,18304,2022-07-24 09:09:59.514,null
364,1448,826622,경북,3005,2966,39,18303,2022-07-24 09:09:59.514,null
365,501,621527,전남,1776,1760,16,18302,2022-07-24 09:09:59.514,null
366,891,630615,전북,2354,2334,20,18301,2022-07-24 09:09:59.513,null
367,982,755057,충남,2645,2620,25,18300,2022-07-24 09:09:59.513,null
368,738,585361,충북,2257,2238,19,18299,2022-07-24 09:09:59.513,null
369,879,549053,강원,1895,1882,13,18298,2022-07-24 09:09:59.513,null
370,6340,5220594,경기,17297,17273,24,18297,2022-07-24 09:09:59.512,null
371,37,147182,세종,585,582,3,18296,2022-07-24 09:09:59.512,null
372,344,409529,울산,1984,1978,6,18295,2022-07-24 09:09:59.512,null
373,719,540145,대전,1986,1977,9,18294,2022-07-24 09:09:59.512,null
374,572,555648,광주,1670,1636,34,18293,2022-07-24 09:09:59.511,null
375,1415,1129750,인천,3490,3425,65,18292,2022-07-24 09:09:59.511,null
376,1357,801683,대구,1923,1907,16,18291,2022-07-24 09:09:59.511,null
377,2226,1157694,부산,3551,3548,3,18290,2022-07-24 09:09:59.511,null
378,4938,3862289,서울,13809,13806,3,18289,2022-07-24 09:09:59.51,null
379,24873,19211613,합계,65433,65100,333,18288,2022-07-24 09:09:59.51,null
380,16,11732,검역,33,0,33,18287,2022-07-23 09:14:20.123,null
381,187,256424,제주,1589,1580,9,18286,2022-07-23 09:14:20.122,null
382,1282,1145502,경남,3778,3763,15,18285,2022-07-23 09:14:20.122,null
383,1448,823617,경북,2943,2931,12,18284,2022-07-23 09:14:20.122,null
384,501,619751,전남,1748,1735,13,18283,2022-07-23 09:14:20.122,null
385,891,628261,전북,2176,2163,13,18282,2022-07-23 09:14:20.122,null
386,980,752412,충남,2676,2659,17,18281,2022-07-23 09:14:20.121,null
387,735,583104,충북,2140,2125,15,18280,2022-07-23 09:14:20.121,null
388,879,547158,강원,2030,2021,9,18279,2022-07-23 09:14:20.121,null
389,6334,5203297,경기,18380,18338,42,18278,2022-07-23 09:14:20.121,null
390,37,146597,세종,493,486,7,18277,2022-07-23 09:14:20.12,null
391,344,407545,울산,1865,1863,2,18276,2022-07-23 09:14:20.12,null
392,719,538159,대전,1976,1960,16,18275,2022-07-23 09:14:20.12,null
393,572,553978,광주,1634,1612,22,18274,2022-07-23 09:14:20.119,null
394,1415,1126260,인천,3759,3710,49,18273,2022-07-23 09:14:20.119,null
395,1357,799760,대구,2559,2550,9,18272,2022-07-23 09:14:20.119,null
396,2223,1154143,부산,3942,3937,5,18271,2022-07-23 09:14:20.119,null
397,4935,3848480,서울,14830,14825,5,18270,2022-07-23 09:14:20.118,null
398,24855,19146180,합계,68551,68258,293,18269,2022-07-23 09:14:20.118,null
399,16,11699,검역,25,0,25,18268,2022-07-22 09:02:41.4,null
400,187,254837,제주,1471,1457,14,18267,2022-07-22 09:02:41.4,null
401,1276,1141724,경남,3564,3542,22,18266,2022-07-22 09:02:41.399,null
402,1447,820674,경북,2900,2882,18,18265,2022-07-22 09:02:41.399,null
403,501,618004,전남,1631,1621,10,18264,2022-07-22 09:02:41.399,null
404,891,626085,전북,2257,2239,18,18263,2022-07-22 09:02:41.399,null
405,978,749736,충남,2641,2627,14,18262,2022-07-22 09:02:41.399,null
406,734,580964,충북,2169,2151,18,18261,2022-07-22 09:02:41.398,null
407,879,545128,강원,2140,2125,15,18260,2022-07-22 09:02:41.398,null
408,6324,5184927,경기,18822,18784,38,18259,2022-07-22 09:02:41.398,null
409,37,146106,세종,528,523,5,18258,2022-07-22 09:02:41.398,null
410,344,405680,울산,1871,1869,2,18257,2022-07-22 09:02:41.398,null
411,718,536186,대전,1843,1825,18,18256,2022-07-22 09:02:41.397,null
412,570,552344,광주,1597,1573,24,18255,2022-07-22 09:02:41.397,null
413,1414,1122504,인천,3710,3657,53,18254,2022-07-22 09:02:41.397,null
414,1357,797201,대구,2287,2271,16,18253,2022-07-22 09:02:41.397,null
415,2221,1150202,부산,3797,3793,4,18252,2022-07-22 09:02:41.396,null
416,4931,3833658,서울,15379,15370,9,18251,2022-07-22 09:02:41.396,null
417,24825,19077659,합계,68632,68309,323,18250,2022-07-22 09:02:41.396,null
418,16,11674,검역,21,0,21,18249,2022-07-21 08:59:27.967,null
419,186,253367,제주,1601,1572,29,18248,2022-07-21 08:59:27.967,null
420,1274,1138162,경남,3479,3463,16,18247,2022-07-21 08:59:27.967,null
421,1447,817793,경북,2829,2809,20,18246,2022-07-21 08:59:27.966,null
422,498,616376,전남,1694,1686,8,18245,2022-07-21 08:59:27.966,null
423,889,623833,전북,2185,2166,19,18244,2022-07-21 08:59:27.966,null
424,977,747095,충남,2638,2632,6,18243,2022-07-21 08:59:27.966,null
425,733,578795,충북,1893,1881,12,18242,2022-07-21 08:59:27.965,null
426,878,542988,강원,1993,1978,15,18241,2022-07-21 08:59:27.965,null
427,6313,5166113,경기,19503,19480,23,18240,2022-07-21 08:59:27.965,null
428,37,145578,세종,492,488,4,18239,2022-07-21 08:59:27.965,null
429,344,403810,울산,2020,2014,6,18238,2022-07-21 08:59:27.965,null
430,716,534343,대전,2029,2012,17,18237,2022-07-21 08:59:27.964,null
431,570,550747,광주,1650,1628,22,18236,2022-07-21 08:59:27.964,null
432,1414,1118802,인천,3939,3863,76,18235,2022-07-21 08:59:27.964,null
433,1356,794914,대구,2405,2391,14,18234,2022-07-21 08:59:27.964,null
434,2219,1146406,부산,4129,4125,4,18233,2022-07-21 08:59:27.963,null
435,4927,3818284,서울,16670,16662,8,18232,2022-07-21 08:59:27.963,null
436,24794,19009080,합계,71170,70850,320,18231,2022-07-21 08:59:27.963,null
437,16,11653,검역,15,0,15,18230,2022-07-20 09:10:48.546,null
438,186,251766,제주,1940,1926,14,18229,2022-07-20 09:10:48.546,null
439,1274,1134684,경남,3846,3824,22,18228,2022-07-20 09:10:48.546,null
440,1445,814967,경북,3149,3112,37,18227,2022-07-20 09:10:48.546,null
441,495,614682,전남,1604,1593,11,18226,2022-07-20 09:10:48.545,null
442,889,621648,전북,2200,2179,21,18225,2022-07-20 09:10:48.545,null
443,976,744457,충남,2865,2845,20,18224,2022-07-20 09:10:48.545,null
444,733,576902,충북,2210,2187,23,18223,2022-07-20 09:10:48.545,null
445,878,540995,강원,2204,2186,18,18222,2022-07-20 09:10:48.545,null
446,6309,5146619,경기,21362,21318,44,18221,2022-07-20 09:10:48.544,null
447,37,145086,세종,522,504,18,18220,2022-07-20 09:10:48.544,null
448,343,401790,울산,2106,2100,6,18219,2022-07-20 09:10:48.544,null
449,716,532314,대전,2059,2028,31,18218,2022-07-20 09:10:48.544,null
450,570,549098,광주,1723,1694,29,18217,2022-07-20 09:10:48.544,null
451,1414,1114902,인천,4412,4324,88,18216,2022-07-20 09:10:48.543,null
452,1355,792509,대구,2573,2557,16,18215,2022-07-20 09:10:48.543,null
453,2218,1142277,부산,4413,4407,6,18214,2022-07-20 09:10:48.543,null
454,4923,3801622,서울,17199,17189,10,18213,2022-07-20 09:10:48.543,null
455,24777,18937971,합계,76402,75973,429,18212,2022-07-20 09:10:48.542,null
456,16,11638,검역,28,0,28,18211,2022-07-19 09:09:13.974,null
457,186,249826,제주,1221,1214,7,18210,2022-07-19 09:09:13.974,null
458,1274,1130838,경남,3970,3944,26,18209,2022-07-19 09:09:13.974,null
459,1444,811818,경북,2218,2203,15,18208,2022-07-19 09:09:13.974,null
460,495,613080,전남,1658,1649,9,18207,2022-07-19 09:09:13.973,null
461,889,619449,전북,2095,2084,11,18206,2022-07-19 09:09:13.973,null
462,973,741592,충남,2756,2729,27,18205,2022-07-19 09:09:13.973,null
463,733,574694,충북,1987,1975,12,18204,2022-07-19 09:09:13.973,null
464,878,538791,강원,2009,2006,3,18203,2022-07-19 09:09:13.973,null
465,6305,5125263,경기,20100,20083,17,18202,2022-07-19 09:09:13.972,null
466,37,144564,세종,559,551,8,18201,2022-07-19 09:09:13.972,null
467,343,399684,울산,2068,2066,2,18200,2022-07-19 09:09:13.972,null
468,715,530255,대전,1954,1926,28,18199,2022-07-19 09:09:13.972,null
469,570,547375,광주,1368,1348,20,18198,2022-07-19 09:09:13.972,null
470,1413,1110491,인천,4238,4124,114,18197,2022-07-19 09:09:13.971,null
471,1355,789938,대구,2423,2412,11,18196,2022-07-19 09:09:13.971,null
472,2218,1137865,부산,4892,4884,8,18195,2022-07-19 09:09:13.971,null
473,4921,3784432,서울,18038,18033,5,18194,2022-07-19 09:09:13.971,null
474,24765,18861593,합계,73582,73231,351,18193,2022-07-19 09:09:13.97,null
475,16,11610,검역,32,0,32,18192,2022-07-18 09:14:42.854,null
476,185,248606,제주,832,819,13,18191,2022-07-18 09:14:42.854,null
477,1274,1126868,경남,1164,1138,26,18190,2022-07-18 09:14:42.853,null
478,1444,809601,경북,1068,1049,19,18189,2022-07-18 09:14:42.853,null
479,495,611422,전남,547,540,7,18188,2022-07-18 09:14:42.852,null
480,889,617357,전북,683,672,11,18187,2022-07-18 09:14:42.852,null
481,971,738836,충남,982,969,13,18186,2022-07-18 09:14:42.851,null
482,733,572708,충북,717,702,15,18185,2022-07-18 09:14:42.851,null
483,878,536782,강원,678,668,10,18184,2022-07-18 09:14:42.85,null
484,6300,5105171,경기,8268,8241,27,18183,2022-07-18 09:14:42.85,null
485,36,144007,세종,269,264,5,18182,2022-07-18 09:14:42.849,null
486,343,397617,울산,609,608,1,18181,2022-07-18 09:14:42.849,null
487,715,528301,대전,758,749,9,18180,2022-07-18 09:14:42.848,null
488,570,546007,광주,580,557,23,18179,2022-07-18 09:14:42.848,null
489,1412,1106259,인천,1944,1857,87,18178,2022-07-18 09:14:42.847,null
490,1355,787517,대구,1022,1008,14,18177,2022-07-18 09:14:42.847,null
491,2216,1132975,부산,1250,1247,3,18176,2022-07-18 09:14:42.846,null
492,4921,3766412,서울,4896,4892,4,18175,2022-07-18 09:14:42.846,null
493,24753,18788056,합계,26299,25980,319,18174,2022-07-18 09:14:42.845,null
494,16,11578,검역,35,0,35,18173,2022-07-17 09:22:16.834,null
495,185,247774,제주,1033,1023,10,18172,2022-07-17 09:22:16.833,null
496,1274,1125704,경남,2231,2209,22,18171,2022-07-17 09:22:16.833,null
497,1444,808533,경북,1683,1663,20,18170,2022-07-17 09:22:16.832,null
498,495,610875,전남,908,906,2,18169,2022-07-17 09:22:16.832,null
499,888,616674,전북,1245,1230,15,18168,2022-07-17 09:22:16.831,null
500,970,737854,충남,1520,1512,8,18167,2022-07-17 09:22:16.831,null
501,733,571991,충북,1279,1261,18,18166,2022-07-17 09:22:16.831,null
502,878,536104,강원,1158,1146,12,18165,2022-07-17 09:22:16.83,null
503,6298,5096903,경기,11043,11025,18,18164,2022-07-17 09:22:16.829,null
504,36,143738,세종,317,313,4,18163,2022-07-17 09:22:16.829,null
505,343,397008,울산,1369,1361,8,18162,2022-07-17 09:22:16.829,null
506,714,527543,대전,1172,1150,22,18161,2022-07-17 09:22:16.828,null
507,569,545427,광주,937,912,25,18160,2022-07-17 09:22:16.828,null
508,1411,1104315,인천,2103,2037,66,18159,2022-07-17 09:22:16.827,null
509,1355,786495,대구,1176,1162,14,18158,2022-07-17 09:22:16.827,null
510,2215,1131725,부산,2568,2566,2,18157,2022-07-17 09:22:16.826,null
511,4918,3761516,서울,8565,8561,4,18156,2022-07-17 09:22:16.825,null
512,24742,18761757,합계,40342,40037,305,18155,2022-07-17 09:22:16.825,null
513,16,11543,검역,20,0,20,18154,2022-07-16 09:29:56.541,null
514,185,246741,제주,967,957,10,18153,2022-07-16 09:29:56.541,null
515,1274,1123473,경남,2299,2282,17,18152,2022-07-16 09:29:56.541,null
516,1440,806850,경북,1622,1603,19,18151,2022-07-16 09:29:56.54,null
517,495,609967,전남,889,881,8,18150,2022-07-16 09:29:56.54,null
518,888,615429,전북,1145,1136,9,18149,2022-07-16 09:29:56.54,null
519,970,736334,충남,1640,1620,20,18148,2022-07-16 09:29:56.54,null
520,733,570712,충북,1283,1273,10,18147,2022-07-16 09:29:56.539,null
521,878,534946,강원,1111,1103,8,18146,2022-07-16 09:29:56.539,null
522,6295,5085860,경기,11448,11417,31,18145,2022-07-16 09:29:56.539,null
523,36,143421,세종,305,302,3,18144,2022-07-16 09:29:56.539,null
524,343,395639,울산,1178,1171,7,18143,2022-07-16 09:29:56.539,null
525,712,526371,대전,1055,1044,11,18142,2022-07-16 09:29:56.538,null
526,569,544490,광주,812,797,15,18141,2022-07-16 09:29:56.538,null
527,1411,1102212,인천,2127,2061,66,18140,2022-07-16 09:29:56.538,null
528,1353,785319,대구,1335,1316,19,18139,2022-07-16 09:29:56.537,null
529,2214,1129157,부산,2617,2611,6,18138,2022-07-16 09:29:56.537,null
530,4916,3752951,서울,9457,9449,8,18137,2022-07-16 09:29:56.537,null
531,24728,18721415,합계,41310,41023,287,18136,2022-07-16 09:29:56.537,null
532,16,11523,검역,27,0,27,18135,2022-07-15 09:08:08.336,null
533,185,245774,제주,878,872,6,18134,2022-07-15 09:08:08.336,null
534,1274,1121175,경남,2064,2042,22,18133,2022-07-15 09:08:08.336,null
535,1436,805230,경북,1618,1596,22,18132,2022-07-15 09:08:08.336,null
536,494,609078,전남,855,845,10,18131,2022-07-15 09:08:08.335,null
537,888,614284,전북,1070,1064,6,18130,2022-07-15 09:08:08.335,null
538,970,734712,충남,1416,1406,10,18129,2022-07-15 09:08:08.335,null
539,733,569431,충북,1041,1030,11,18128,2022-07-15 09:08:08.335,null
540,877,533836,강원,1120,1112,8,18127,2022-07-15 09:08:08.335,null
541,6289,5074415,경기,10530,10508,22,18126,2022-07-15 09:08:08.334,null
542,36,143116,세종,259,258,1,18125,2022-07-15 09:08:08.334,null
543,343,394461,울산,1054,1044,10,18124,2022-07-15 09:08:08.334,null
544,712,525320,대전,1006,998,8,18123,2022-07-15 09:08:08.334,null
545,569,543678,광주,816,810,6,18122,2022-07-15 09:08:08.334,null
546,1410,1100085,인천,2095,2026,69,18121,2022-07-15 09:08:08.333,null
547,1352,783984,대구,1546,1534,12,18120,2022-07-15 09:08:08.333,null
548,2214,1126544,부산,2536,2534,2,18119,2022-07-15 09:08:08.333,null
549,4914,3743496,서울,8951,8942,9,18118,2022-07-15 09:08:08.333,null
550,24712,18680142,합계,38882,38621,261,18117,2022-07-15 09:08:08.332,null
551,16,11497,검역,15,0,15,18116,2022-07-14 09:16:18.156,null
552,185,244897,제주,854,842,12,18115,2022-07-14 09:16:18.156,null
553,1273,1119111,경남,2085,2058,27,18114,2022-07-14 09:16:18.156,null
554,1433,803612,경북,1573,1555,18,18113,2022-07-14 09:16:18.155,null
555,494,608223,전남,850,844,6,18112,2022-07-14 09:16:18.155,null
556,887,613215,전북,1149,1127,22,18111,2022-07-14 09:16:18.155,null
557,969,733296,충남,1516,1498,18,18110,2022-07-14 09:16:18.155,null
558,733,568390,충북,1044,1032,12,18109,2022-07-14 09:16:18.154,null
559,876,532716,강원,1037,1029,8,18108,2022-07-14 09:16:18.154,null
560,6286,5063892,경기,10635,10590,45,18107,2022-07-14 09:16:18.154,null
561,36,142857,세종,266,260,6,18106,2022-07-14 09:16:18.154,null
562,343,393407,울산,1086,1078,8,18105,2022-07-14 09:16:18.153,null
563,712,524314,대전,1022,1011,11,18104,2022-07-14 09:16:18.153,null
564,569,542862,광주,800,785,15,18103,2022-07-14 09:16:18.153,null
565,1409,1097991,인천,1967,1881,86,18102,2022-07-14 09:16:18.153,null
566,1350,782438,대구,1281,1266,15,18101,2022-07-14 09:16:18.152,null
567,2213,1124010,부산,2361,2357,4,18100,2022-07-14 09:16:18.152,null
568,4912,3734550,서울,9655,9645,10,18099,2022-07-14 09:16:18.152,null
569,24696,18641278,합계,39196,38858,338,18098,2022-07-14 09:16:18.152,null
570,16,11482,검역,17,0,17,18097,2022-07-13 09:08:32.658,null
571,185,244043,제주,964,950,14,18096,2022-07-13 09:08:32.658,null
572,1272,1117028,경남,2166,2143,23,18095,2022-07-13 09:08:32.657,null
573,1431,802039,경북,1650,1626,24,18094,2022-07-13 09:08:32.657,null
574,494,607373,전남,850,839,11,18093,2022-07-13 09:08:32.657,null
575,887,612068,전북,1050,1032,18,18092,2022-07-13 09:08:32.657,null
576,966,731780,충남,1598,1573,25,18091,2022-07-13 09:08:32.657,null
577,733,567346,충북,1069,1032,37,18090,2022-07-13 09:08:32.656,null
578,876,531679,강원,1047,1037,10,18089,2022-07-13 09:08:32.656,null
579,6284,5053273,경기,11175,11118,57,18088,2022-07-13 09:08:32.656,null
580,36,142591,세종,375,369,6,18087,2022-07-13 09:08:32.656,null
581,343,392321,울산,1129,1119,10,18086,2022-07-13 09:08:32.655,null
582,712,523292,대전,968,956,12,18085,2022-07-13 09:08:32.655,null
583,568,542062,광주,814,794,20,18084,2022-07-13 09:08:32.655,null
584,1409,1096026,인천,2097,2021,76,18083,2022-07-13 09:08:32.655,null
585,1350,781157,대구,1429,1405,24,18082,2022-07-13 09:08:32.654,null
586,2209,1121652,부산,2505,2501,4,18081,2022-07-13 09:08:32.654,null
587,4909,3724897,서울,9363,9353,10,18080,2022-07-13 09:08:32.654,null
588,24680,18602109,합계,40266,39868,398,18079,2022-07-13 09:08:32.654,null
589,16,11465,검역,16,0,16,18078,2022-07-12 04:00:39.025,null
590,185,243079,제주,542,528,14,18077,2022-07-12 04:00:39.025,null
591,1269,1114862,경남,2106,2096,10,18076,2022-07-12 04:00:39.025,null
592,1430,800389,경북,1162,1151,11,18075,2022-07-12 04:00:39.025,null
593,494,606523,전남,754,747,7,18074,2022-07-12 04:00:39.025,null
594,887,611021,전북,991,981,10,18073,2022-07-12 04:00:39.024,null
595,966,730182,충남,1289,1278,11,18072,2022-07-12 04:00:39.024,null
596,733,566278,충북,977,967,10,18071,2022-07-12 04:00:39.024,null
597,876,530633,강원,889,885,4,18070,2022-07-12 04:00:39.024,null
598,6284,5042098,경기,10306,10280,26,18069,2022-07-12 04:00:39.024,null
599,36,142217,세종,320,317,3,18068,2022-07-12 04:00:39.023,null
600,343,391192,울산,1001,998,3,18067,2022-07-12 04:00:39.023,null
601,712,522324,대전,914,908,6,18066,2022-07-12 04:00:39.023,null
602,568,541248,광주,662,656,6,18065,2022-07-12 04:00:39.023,null
603,1409,1093934,인천,1917,1831,86,18064,2022-07-12 04:00:39.022,null
604,1349,779728,대구,1433,1409,24,18063,2022-07-12 04:00:39.022,null
605,2204,1119149,부산,2669,2665,4,18062,2022-07-12 04:00:39.022,null
606,4907,3715539,서울,9412,9403,9,18061,2022-07-12 04:00:39.022,null
607,24668,18561861,합계,37360,37100,260,18060,2022-07-12 04:00:39.021,null
608,16,11450,검역,23,0,23,18059,2022-07-11 06:11:37.502,null
609,184,242537,제주,359,355,4,18058,2022-07-11 06:11:37.502,null
610,1269,1112756,경남,658,642,16,18057,2022-07-11 06:11:37.501,null
611,1427,799227,경북,534,518,16,18056,2022-07-11 06:11:37.501,null
612,492,605770,전남,236,229,7,18055,2022-07-11 06:11:37.501,null
613,887,610030,전북,310,303,7,18054,2022-07-11 06:11:37.501,null
614,966,728893,충남,446,438,8,18053,2022-07-11 06:11:37.5,null
615,733,565302,충북,317,313,4,18052,2022-07-11 06:11:37.5,null
616,876,529745,강원,313,310,3,18051,2022-07-11 06:11:37.5,null
617,6283,5031812,경기,3987,3976,11,18050,2022-07-11 06:11:37.5,null
618,36,141899,세종,103,103,0,18049,2022-07-11 06:11:37.5,null
619,343,390191,울산,331,331,0,18048,2022-07-11 06:11:37.499,null
620,712,521410,대전,469,465,4,18047,2022-07-11 06:11:37.499,null
621,568,540586,광주,267,256,11,18046,2022-07-11 06:11:37.499,null
622,1409,1092017,인천,638,582,56,18045,2022-07-11 06:11:37.499,null
623,1349,778296,대구,454,447,7,18044,2022-07-11 06:11:37.498,null
624,2204,1116484,부산,626,626,0,18043,2022-07-11 06:11:37.498,null
625,4907,3706133,서울,2622,2619,3,18042,2022-07-11 06:11:37.498,null
626,24661,18524538,합계,12693,12513,180,18041,2022-07-11 06:11:37.497,null
627,16,11427,검역,13,0,13,18040,2022-07-10 09:38:28.246,null
628,184,242178,제주,492,484,8,18039,2022-07-10 09:38:28.246,null
629,1268,1112098,경남,1061,1041,20,18038,2022-07-10 09:38:28.245,null
630,1424,798693,경북,903,877,26,18037,2022-07-10 09:38:28.245,null
631,489,605534,전남,440,439,1,18036,2022-07-10 09:38:28.245,null
632,887,609720,전북,574,551,23,18035,2022-07-10 09:38:28.245,null
633,966,728447,충남,786,774,12,18034,2022-07-10 09:38:28.245,null
634,731,564985,충북,562,550,12,18033,2022-07-10 09:38:28.244,null
635,875,529432,강원,435,433,2,18032,2022-07-10 09:38:28.244,null
636,6281,5027825,경기,5448,5437,11,18031,2022-07-10 09:38:28.243,null
637,36,141796,세종,196,190,6,18030,2022-07-10 09:38:28.243,null
638,343,389860,울산,646,643,3,18029,2022-07-10 09:38:28.242,null
639,711,520941,대전,524,521,3,18028,2022-07-10 09:38:28.242,null
640,568,540319,광주,370,351,19,18027,2022-07-10 09:38:28.242,null
641,1409,1091379,인천,931,868,63,18026,2022-07-10 09:38:28.242,null
642,1349,777842,대구,488,477,11,18025,2022-07-10 09:38:28.241,null
643,2201,1115858,부산,1297,1286,11,18024,2022-07-10 09:38:28.241,null
644,4905,3703511,서울,5244,5238,6,18023,2022-07-10 09:38:28.241,null
645,24643,18511845,합계,20410,20160,250,18022,2022-07-10 09:38:28.241,null
646,16,11414,검역,13,0,13,18021,2022-07-09 09:25:08.693,null
647,183,241686,제주,366,357,9,18020,2022-07-09 09:25:08.693,null
648,1268,1111037,경남,1095,1079,16,18019,2022-07-09 09:25:08.693,null
649,1420,797790,경북,745,734,11,18018,2022-07-09 09:25:08.692,null
650,486,605094,전남,477,472,5,18017,2022-07-09 09:25:08.692,null
651,885,609146,전북,519,508,11,18016,2022-07-09 09:25:08.692,null
652,966,727661,충남,760,747,13,18015,2022-07-09 09:25:08.692,null
653,731,564423,충북,567,559,8,18014,2022-07-09 09:25:08.691,null
654,875,528997,강원,546,534,12,18013,2022-07-09 09:25:08.691,null
655,6281,5022377,경기,5629,5595,34,18012,2022-07-09 09:25:08.691,null
656,36,141600,세종,176,173,3,18011,2022-07-09 09:25:08.691,null
657,342,389214,울산,580,577,3,18010,2022-07-09 09:25:08.69,null
658,711,520417,대전,504,497,7,18009,2022-07-09 09:25:08.69,null
659,568,539949,광주,350,343,7,18008,2022-07-09 09:25:08.69,null
660,1409,1090448,인천,1067,1011,56,18007,2022-07-09 09:25:08.69,null
661,1349,777354,대구,712,701,11,18006,2022-07-09 09:25:08.689,null
662,2193,1114561,부산,1280,1279,1,18005,2022-07-09 09:25:08.689,null
663,4905,3698267,서울,4900,4897,3,18004,2022-07-09 09:25:08.689,null
664,24624,18491435,합계,20286,20063,223,18003,2022-07-09 09:25:08.689,null
665,16,11401,검역,17,0,17,18002,2022-07-08 06:22:42.967,null
666,183,241320,제주,394,383,11,18001,2022-07-08 06:22:42.967,null
667,1263,1109943,경남,1039,1018,21,18000,2022-07-08 06:22:42.967,null
668,1417,797045,경북,759,750,9,17999,2022-07-08 06:22:42.966,null
669,486,604618,전남,380,371,9,17998,2022-07-08 06:22:42.966,null
670,885,608629,전북,544,535,9,17997,2022-07-08 06:22:42.966,null
671,966,726901,충남,772,762,10,17996,2022-07-08 06:22:42.966,null
672,730,563857,충북,494,487,7,17995,2022-07-08 06:22:42.965,null
673,874,528451,강원,486,478,8,17994,2022-07-08 06:22:42.965,null
674,6280,5016754,경기,5410,5395,15,17993,2022-07-08 06:22:42.965,null
675,36,141424,세종,165,160,5,17992,2022-07-08 06:22:42.965,null
676,342,388634,울산,490,484,6,17991,2022-07-08 06:22:42.965,null
677,711,519917,대전,561,560,1,17990,2022-07-08 06:22:42.964,null
678,568,539599,광주,362,355,7,17989,2022-07-08 06:22:42.964,null
679,1409,1089384,인천,978,932,46,17988,2022-07-08 06:22:42.964,null
680,1348,776642,대구,627,617,10,17987,2022-07-08 06:22:42.964,null
681,2188,1113285,부산,1240,1240,0,17986,2022-07-08 06:22:42.963,null
682,4903,3693368,서울,4605,4605,0,17985,2022-07-08 06:22:42.963,null
683,24605,18471172,합계,19323,19132,191,17984,2022-07-08 06:22:42.963,null
684,16,11384,검역,6,0,6,17983,2022-07-07 06:14:03.308,null
685,182,240926,제주,413,408,5,17982,2022-07-07 06:14:03.308,null
686,1262,1108904,경남,971,959,12,17981,2022-07-07 06:14:03.307,null
687,1417,796286,경북,798,782,16,17980,2022-07-07 06:14:03.307,null
688,485,604238,전남,411,406,5,17979,2022-07-07 06:14:03.307,null
689,885,608086,전북,458,449,9,17978,2022-07-07 06:14:03.307,null
690,966,726129,충남,699,696,3,17977,2022-07-07 06:14:03.307,null
691,730,563363,충북,441,430,11,17976,2022-07-07 06:14:03.306,null
692,874,527965,강원,561,548,13,17975,2022-07-07 06:14:03.306,null
693,6280,5011349,경기,4983,4967,16,17974,2022-07-07 06:14:03.306,null
694,36,141259,세종,111,107,4,17973,2022-07-07 06:14:03.306,null
695,342,388144,울산,480,472,8,17972,2022-07-07 06:14:03.305,null
696,711,519356,대전,488,485,3,17971,2022-07-07 06:14:03.305,null
697,568,539237,광주,313,303,10,17970,2022-07-07 06:14:03.305,null
698,1408,1088406,인천,983,927,56,17969,2022-07-07 06:14:03.305,null
699,1346,776016,대구,658,649,9,17968,2022-07-07 06:14:03.304,null
700,2184,1112045,부산,1157,1155,2,17967,2022-07-07 06:14:03.304,null
701,4901,3688769,서울,4580,4574,6,17966,2022-07-07 06:14:03.304,null
702,24593,18451862,합계,18511,18317,194,17965,2022-07-07 06:14:03.304,null
703,16,11378,검역,9,0,9,17964,2022-07-06 09:11:15.605,null
704,182,240513,제주,381,375,6,17963,2022-07-06 09:11:15.605,null
705,1261,1107933,경남,1066,1049,17,17962,2022-07-06 09:11:15.605,null
706,1415,795489,경북,942,925,17,17961,2022-07-06 09:11:15.605,null
707,485,603827,전남,459,452,7,17960,2022-07-06 09:11:15.605,null
708,885,607628,전북,479,464,15,17959,2022-07-06 09:11:15.604,null
709,966,725430,충남,665,662,3,17958,2022-07-06 09:11:15.604,null
710,730,562922,충북,488,467,21,17957,2022-07-06 09:11:15.604,null
711,874,527404,강원,596,581,15,17956,2022-07-06 09:11:15.604,null
712,6278,5006368,경기,5174,5159,15,17955,2022-07-06 09:11:15.604,null
713,36,141148,세종,153,150,3,17954,2022-07-06 09:11:15.603,null
714,342,387664,울산,518,507,11,17953,2022-07-06 09:11:15.603,null
715,710,518868,대전,453,451,2,17952,2022-07-06 09:11:15.603,null
716,568,538924,광주,337,326,11,17951,2022-07-06 09:11:15.603,null
717,1407,1087425,인천,1071,1022,49,17950,2022-07-06 09:11:15.602,null
718,1346,775358,대구,646,627,19,17949,2022-07-06 09:11:15.602,null
719,2182,1110890,부산,1164,1162,2,17948,2022-07-06 09:11:15.602,null
720,4900,3684190,서울,4770,4768,2,17947,2022-07-06 09:11:15.602,null
721,24583,18433359,합계,19371,19147,224,17946,2022-07-06 09:11:15.601,null
722,16,11369,검역,15,0,15,17945,2022-07-05 08:52:36.84,null
723,182,240132,제주,285,275,10,17944,2022-07-05 08:52:36.839,null
724,1260,1106868,경남,1074,1065,9,17943,2022-07-05 08:52:36.839,null
725,1414,794547,경북,657,643,14,17942,2022-07-05 08:52:36.839,null
726,484,603368,전남,385,380,5,17941,2022-07-05 08:52:36.839,null
727,884,607152,전북,401,396,5,17940,2022-07-05 08:52:36.839,null
728,966,724765,충남,585,583,2,17939,2022-07-05 08:52:36.838,null
729,730,562434,충북,412,407,5,17938,2022-07-05 08:52:36.838,null
730,874,526808,강원,532,531,1,17937,2022-07-05 08:52:36.838,null
731,6277,5001197,경기,4896,4881,15,17936,2022-07-05 08:52:36.838,null
732,36,140995,세종,117,108,9,17935,2022-07-05 08:52:36.837,null
733,342,387146,울산,465,462,3,17934,2022-07-05 08:52:36.837,null
734,710,518415,대전,435,435,0,17933,2022-07-05 08:52:36.837,null
735,568,538587,광주,280,272,8,17932,2022-07-05 08:52:36.836,null
736,1407,1086354,인천,983,920,63,17931,2022-07-05 08:52:36.836,null
737,1346,774712,대구,677,672,5,17930,2022-07-05 08:52:36.836,null
738,2182,1109727,부산,1169,1169,0,17929,2022-07-05 08:52:36.836,null
739,4898,3679421,서울,4779,4777,2,17928,2022-07-05 08:52:36.835,null
740,24576,18413997,합계,18147,17976,171,17927,2022-07-05 08:52:36.835,null
741,16,11354,검역,9,0,9,17926,2022-07-04 09:17:32.165,null
742,182,239847,제주,174,171,3,17925,2022-07-04 09:17:32.164,null
743,1260,1105795,경남,332,316,16,17924,2022-07-04 09:17:32.164,null
744,1413,793891,경북,313,299,14,17923,2022-07-04 09:17:32.164,null
745,484,602983,전남,148,147,1,17922,2022-07-04 09:17:32.164,null
746,884,606751,전북,126,119,7,17921,2022-07-04 09:17:32.163,null
747,966,724180,충남,240,240,0,17920,2022-07-04 09:17:32.163,null
748,730,562022,충북,166,160,6,17919,2022-07-04 09:17:32.163,null
749,874,526277,강원,235,227,8,17918,2022-07-04 09:17:32.163,null
750,6277,4996307,경기,1895,1890,5,17917,2022-07-04 09:17:32.162,null
751,36,140878,세종,57,55,2,17916,2022-07-04 09:17:32.162,null
752,342,386681,울산,148,148,0,17915,2022-07-04 09:17:32.162,null
753,710,517980,대전,213,211,2,17914,2022-07-04 09:17:32.162,null
754,568,538307,광주,144,130,14,17913,2022-07-04 09:17:32.162,null
755,1407,1085373,인천,348,282,66,17912,2022-07-04 09:17:32.161,null
756,1346,774035,대구,253,242,11,17911,2022-07-04 09:17:32.161,null
757,2182,1108558,부산,291,291,0,17910,2022-07-04 09:17:32.161,null
758,4897,3674645,서울,1161,1161,0,17909,2022-07-04 09:17:32.161,null
759,24574,18395864,합계,6253,6089,164,17908,2022-07-04 09:17:32.16,null
760,16,11345,검역,15,0,15,17907,2022-07-03 08:59:04.234,null
761,182,239673,제주,207,200,7,17906,2022-07-03 08:59:04.234,null
762,1260,1105463,경남,588,572,16,17905,2022-07-03 08:59:04.233,null
763,1413,793578,경북,537,521,16,17904,2022-07-03 08:59:04.233,null
764,483,602835,전남,248,241,7,17903,2022-07-03 08:59:04.233,null
765,884,606625,전북,268,257,11,17902,2022-07-03 08:59:04.233,null
766,966,723940,충남,418,412,6,17901,2022-07-03 08:59:04.232,null
767,730,561856,충북,215,209,6,17900,2022-07-03 08:59:04.232,null
768,874,526042,강원,269,257,12,17899,2022-07-03 08:59:04.232,null
769,6277,4994412,경기,2663,2637,26,17898,2022-07-03 08:59:04.232,null
770,36,140821,세종,70,70,0,17897,2022-07-03 08:59:04.232,null
771,342,386533,울산,285,283,2,17896,2022-07-03 08:59:04.231,null
772,710,517767,대전,241,237,4,17895,2022-07-03 08:59:04.231,null
773,567,538163,광주,188,181,7,17894,2022-07-03 08:59:04.231,null
774,1407,1085025,인천,566,516,50,17893,2022-07-03 08:59:04.231,null
775,1346,773782,대구,294,291,3,17892,2022-07-03 08:59:04.23,null
776,2181,1108267,부산,547,547,0,17891,2022-07-03 08:59:04.23,null
777,4896,3673484,서울,2440,2437,3,17890,2022-07-03 08:59:04.23,null
778,24570,18389611,합계,10059,9868,191,17889,2022-07-03 08:59:04.229,null
779,16,11330,검역,14,0,14,17888,2022-07-02 09:04:27.164,null
780,182,239466,제주,216,206,10,17887,2022-07-02 09:04:27.164,null
781,1259,1104875,경남,576,571,5,17886,2022-07-02 09:04:27.163,null
782,1410,793041,경북,503,490,13,17885,2022-07-02 09:04:27.163,null
783,483,602587,전남,243,236,7,17884,2022-07-02 09:04:27.163,null
784,883,606357,전북,274,264,10,17883,2022-07-02 09:04:27.163,null
785,966,723522,충남,381,379,2,17882,2022-07-02 09:04:27.162,null
786,730,561641,충북,265,253,12,17881,2022-07-02 09:04:27.162,null
787,874,525773,강원,313,311,2,17880,2022-07-02 09:04:27.162,null
788,6276,4991749,경기,2819,2800,19,17879,2022-07-02 09:04:27.162,null
789,36,140751,세종,79,78,1,17878,2022-07-02 09:04:27.162,null
790,342,386248,울산,311,311,0,17877,2022-07-02 09:04:27.161,null
791,710,517526,대전,274,274,0,17876,2022-07-02 09:04:27.161,null
792,567,537975,광주,164,157,7,17875,2022-07-02 09:04:27.161,null
793,1407,1084459,인천,525,472,53,17874,2022-07-02 09:04:27.161,null
794,1346,773488,대구,369,364,5,17873,2022-07-02 09:04:27.16,null
795,2181,1107720,부산,611,608,3,17872,2022-07-02 09:04:27.16,null
796,4894,3671044,서울,2778,2768,10,17871,2022-07-02 09:04:27.16,null
797,24562,18379552,합계,10715,10542,173,17870,2022-07-02 09:04:27.16,null
798,16,11316,검역,8,0,8,17869,2022-07-01 08:51:35.375,null
799,182,239250,제주,184,167,17,17868,2022-07-01 08:51:35.375,null
800,1259,1104299,경남,557,542,15,17867,2022-07-01 08:51:35.375,null
801,1410,792538,경북,464,453,11,17866,2022-07-01 08:51:35.375,null
802,483,602345,전남,227,224,3,17865,2022-07-01 08:51:35.375,null
803,883,606083,전북,253,249,4,17864,2022-07-01 08:51:35.374,null
804,966,723146,충남,317,317,0,17863,2022-07-01 08:51:35.374,null
805,730,561376,충북,264,253,11,17862,2022-07-01 08:51:35.374,null
806,874,525460,강원,241,236,5,17861,2022-07-01 08:51:35.374,null
807,6274,4988935,경기,2463,2453,10,17860,2022-07-01 08:51:35.374,null
808,36,140672,세종,55,54,1,17859,2022-07-01 08:51:35.373,null
809,342,385937,울산,291,290,1,17858,2022-07-01 08:51:35.373,null
810,709,517252,대전,209,208,1,17857,2022-07-01 08:51:35.373,null
811,567,537811,광주,171,167,4,17856,2022-07-01 08:51:35.373,null
812,1407,1083934,인천,475,436,39,17855,2022-07-01 08:51:35.372,null
813,1346,773119,대구,423,414,9,17854,2022-07-01 08:51:35.372,null
814,2180,1107113,부산,586,586,0,17853,2022-07-01 08:51:35.372,null
815,4891,3668271,서울,2340,2333,7,17852,2022-07-01 08:51:35.372,null
816,24555,18368857,합계,9528,9382,146,17851,2022-07-01 08:51:35.371,null
817,16,11308,검역,9,0,9,17850,2022-06-30 09:01:32.277,null
818,182,239066,제주,205,181,24,17849,2022-06-30 09:01:32.277,null
819,1259,1103742,경남,560,547,13,17848,2022-06-30 09:01:32.276,null
820,1408,792074,경북,501,492,9,17847,2022-06-30 09:01:32.276,null
821,483,602118,전남,250,247,3,17846,2022-06-30 09:01:32.275,null
822,883,605830,전북,271,263,8,17845,2022-06-30 09:01:32.275,null
823,966,722829,충남,300,300,0,17844,2022-06-30 09:01:32.274,null
824,730,561112,충북,218,208,10,17843,2022-06-30 09:01:32.274,null
825,874,525219,강원,283,280,3,17842,2022-06-30 09:01:32.273,null
826,6270,4986478,경기,2444,2440,4,17841,2022-06-30 09:01:32.273,null
827,36,140619,세종,71,67,4,17840,2022-06-30 09:01:32.272,null
828,342,385646,울산,281,280,1,17839,2022-06-30 09:01:32.272,null
829,709,517043,대전,230,229,1,17838,2022-06-30 09:01:32.271,null
830,567,537640,광주,194,180,14,17837,2022-06-30 09:01:32.271,null
831,1407,1083459,인천,506,474,32,17836,2022-06-30 09:01:32.27,null
832,1346,772696,대구,402,396,6,17835,2022-06-30 09:01:32.269,null
833,2180,1106529,부산,588,588,0,17834,2022-06-30 09:01:32.269,null
834,4889,3665933,서울,2282,2281,1,17833,2022-06-30 09:01:32.268,null
835,24547,18359341,합계,9595,9453,142,17832,2022-06-30 09:01:32.268,null
836,16,11299,검역,10,0,10,17831,2022-06-29 09:13:21.185,null
837,182,238861,제주,169,156,13,17830,2022-06-29 09:13:21.185,null
838,1259,1103182,경남,578,558,20,17829,2022-06-29 09:13:21.185,null
839,1404,791573,경북,544,526,18,17828,2022-06-29 09:13:21.185,null
840,482,601869,전남,268,263,5,17827,2022-06-29 09:13:21.185,null
841,882,605559,전북,290,274,16,17826,2022-06-29 09:13:21.184,null
842,965,722529,충남,380,377,3,17825,2022-06-29 09:13:21.184,null
843,730,560894,충북,231,209,22,17824,2022-06-29 09:13:21.184,null
844,874,524936,강원,346,341,5,17823,2022-06-29 09:13:21.184,null
845,6270,4984038,경기,2663,2643,20,17822,2022-06-29 09:13:21.183,null
846,36,140548,세종,81,74,7,17821,2022-06-29 09:13:21.183,null
847,342,385365,울산,341,336,5,17820,2022-06-29 09:13:21.183,null
848,709,516813,대전,269,268,1,17819,2022-06-29 09:13:21.183,null
849,566,537446,광주,210,206,4,17818,2022-06-29 09:13:21.183,null
850,1407,1082954,인천,617,576,41,17817,2022-06-29 09:13:21.182,null
851,1346,772294,대구,392,385,7,17816,2022-06-29 09:13:21.182,null
852,2179,1105943,부산,595,595,0,17815,2022-06-29 09:13:21.182,null
853,4888,3663653,서울,2479,2471,8,17814,2022-06-29 09:13:21.182,null
854,24537,18349756,합계,10463,10258,205,17813,2022-06-29 09:13:21.181,null
855,16,11289,검역,7,0,7,17812,2022-06-28 08:52:54.495,null
856,182,238692,제주,85,81,4,17811,2022-06-28 08:52:54.495,null
857,1259,1102605,경남,637,630,7,17810,2022-06-28 08:52:54.495,null
858,1403,791029,경북,340,334,6,17809,2022-06-28 08:52:54.494,null
859,482,601601,전남,309,307,2,17808,2022-06-28 08:52:54.493,null
860,880,605269,전북,286,274,12,17807,2022-06-28 08:52:54.493,null
861,965,722149,충남,321,319,2,17806,2022-06-28 08:52:54.492,null
862,730,560663,충북,221,217,4,17805,2022-06-28 08:52:54.492,null
863,874,524591,강원,318,316,2,17804,2022-06-28 08:52:54.492,null
864,6270,4981389,경기,2583,2571,12,17803,2022-06-28 08:52:54.491,null
865,36,140467,세종,52,52,0,17802,2022-06-28 08:52:54.49,null
866,342,385024,울산,269,268,1,17801,2022-06-28 08:52:54.49,null
867,709,516544,대전,221,221,0,17800,2022-06-28 08:52:54.489,null
868,566,537236,광주,129,128,1,17799,2022-06-28 08:52:54.489,null
869,1406,1082342,인천,502,451,51,17798,2022-06-28 08:52:54.488,null
870,1346,771904,대구,460,457,3,17797,2022-06-28 08:52:54.488,null
871,2178,1105348,부산,684,684,0,17796,2022-06-28 08:52:54.487,null
872,4886,3661177,서울,2472,2467,5,17795,2022-06-28 08:52:54.487,null
873,24530,18339319,합계,9896,9777,119,17794,2022-06-28 08:52:54.486,null
874,16,11282,검역,16,0,16,17793,2022-06-27 09:12:17.189,null
875,182,238609,제주,67,60,7,17792,2022-06-27 09:12:17.189,null
876,1258,1101969,경남,211,202,9,17791,2022-06-27 09:12:17.188,null
877,1401,790689,경북,200,190,10,17790,2022-06-27 09:12:17.188,null
878,482,601292,전남,131,129,2,17789,2022-06-27 09:12:17.188,null
879,880,604983,전북,92,90,2,17788,2022-06-27 09:12:17.188,null
880,965,721828,충남,142,141,1,17787,2022-06-27 09:12:17.188,null
881,730,560443,충북,85,80,5,17786,2022-06-27 09:12:17.187,null
882,874,524273,강원,131,128,3,17785,2022-06-27 09:12:17.187,null
883,6268,4978811,경기,1014,1008,6,17784,2022-06-27 09:12:17.187,null
884,36,140415,세종,26,25,1,17783,2022-06-27 09:12:17.187,null
885,342,384755,울산,86,84,2,17782,2022-06-27 09:12:17.187,null
886,709,516323,대전,99,99,0,17781,2022-06-27 09:12:17.186,null
887,566,537107,광주,83,80,3,17780,2022-06-27 09:12:17.186,null
888,1406,1081842,인천,206,170,36,17779,2022-06-27 09:12:17.186,null
889,1346,771444,대구,91,89,2,17778,2022-06-27 09:12:17.186,null
890,2178,1104673,부산,149,146,3,17777,2022-06-27 09:12:17.185,null
891,4886,3658710,서울,600,594,6,17776,2022-06-27 09:12:17.185,null
892,24525,18329448,합계,3429,3315,114,17775,2022-06-27 09:12:17.185,null
893,16,11266,검역,11,0,11,17774,2022-06-26 09:35:56.857,null
894,182,238542,제주,100,90,10,17773,2022-06-26 09:35:56.856,null
895,1258,1101758,경남,341,337,4,17772,2022-06-26 09:35:56.856,null
896,1401,790489,경북,316,310,6,17771,2022-06-26 09:35:56.856,null
897,479,601161,전남,193,191,2,17770,2022-06-26 09:35:56.856,null
898,880,604891,전북,179,174,5,17769,2022-06-26 09:35:56.856,null
899,965,721686,충남,201,199,2,17768,2022-06-26 09:35:56.855,null
900,730,560358,충북,172,165,7,17767,2022-06-26 09:35:56.855,null
901,874,524142,강원,179,176,3,17766,2022-06-26 09:35:56.855,null
902,6268,4977797,경기,1635,1633,2,17765,2022-06-26 09:35:56.855,null
903,36,140389,세종,64,61,3,17764,2022-06-26 09:35:56.854,null
904,342,384669,울산,229,227,2,17763,2022-06-26 09:35:56.854,null
905,709,516224,대전,150,150,0,17762,2022-06-26 09:35:56.854,null
906,566,537024,광주,123,110,13,17761,2022-06-26 09:35:56.854,null
907,1406,1081636,인천,372,322,50,17760,2022-06-26 09:35:56.854,null
908,1346,771353,대구,283,276,7,17759,2022-06-26 09:35:56.853,null
909,2178,1104524,부산,388,388,0,17758,2022-06-26 09:35:56.853,null
910,4886,3658110,서울,1310,1302,8,17757,2022-06-26 09:35:56.853,null
911,24522,18326019,합계,6246,6111,135,17756,2022-06-26 09:35:56.853,null
912,16,11255,검역,7,0,7,17755,2022-06-25 09:49:50.333,null
913,182,238442,제주,85,77,8,17754,2022-06-25 09:49:50.333,null
914,1258,1101417,경남,405,396,9,17753,2022-06-25 09:49:50.333,null
915,1401,790173,경북,346,340,6,17752,2022-06-25 09:49:50.333,null
916,479,600968,전남,222,206,16,17751,2022-06-25 09:49:50.332,null
917,880,604712,전북,179,175,4,17750,2022-06-25 09:49:50.332,null
918,964,721485,충남,265,261,4,17749,2022-06-25 09:49:50.332,null
919,730,560186,충북,178,169,9,17748,2022-06-25 09:49:50.332,null
920,873,523963,강원,249,246,3,17747,2022-06-25 09:49:50.332,null
921,6265,4976162,경기,1718,1713,5,17746,2022-06-25 09:49:50.331,null
922,36,140325,세종,53,48,5,17745,2022-06-25 09:49:50.331,null
923,342,384440,울산,191,190,1,17744,2022-06-25 09:49:50.331,null
924,709,516074,대전,163,160,3,17743,2022-06-25 09:49:50.331,null
925,566,536901,광주,125,123,2,17742,2022-06-25 09:49:50.33,null
926,1406,1081264,인천,334,334,0,17741,2022-06-25 09:49:50.33,null
927,1346,771070,대구,316,314,2,17740,2022-06-25 09:49:50.33,null
928,2178,1104136,부산,402,402,0,17739,2022-06-25 09:49:50.33,null
929,4885,3656800,서울,1552,1551,1,17738,2022-06-25 09:49:50.33,null
930,24516,18319773,합계,6790,6705,85,17737,2022-06-25 09:49:50.327,null
931,16,11248,검역,11,0,11,17736,2022-06-24 09:06:08.348,null
932,182,238359,제주,132,122,10,17735,2022-06-24 09:06:08.348,null
933,1256,1101012,경남,400,394,6,17734,2022-06-24 09:06:08.347,null
934,1399,789828,경북,405,393,12,17733,2022-06-24 09:06:08.347,null
935,478,600746,전남,182,182,0,17732,2022-06-24 09:06:08.347,null
936,880,604533,전북,205,198,7,17731,2022-06-24 09:06:08.347,null
937,964,721220,충남,251,249,2,17730,2022-06-24 09:06:08.347,null
938,729,560008,충북,178,176,2,17729,2022-06-24 09:06:08.346,null
939,871,523714,강원,304,295,9,17728,2022-06-24 09:06:08.346,null
940,6260,4974445,경기,1862,1858,4,17727,2022-06-24 09:06:08.346,null
941,36,140272,세종,65,58,7,17726,2022-06-24 09:06:08.346,null
942,342,384249,울산,179,176,3,17725,2022-06-24 09:06:08.345,null
943,708,515911,대전,159,158,1,17724,2022-06-24 09:06:08.345,null
944,566,536777,광주,143,140,3,17723,2022-06-24 09:06:08.345,null
945,1406,1080931,인천,366,340,26,17722,2022-06-24 09:06:08.345,null
946,1346,770754,대구,384,379,5,17721,2022-06-24 09:06:08.344,null
947,2177,1103738,부산,396,396,0,17720,2022-06-24 09:06:08.344,null
948,4882,3655248,서울,1605,1602,3,17719,2022-06-24 09:06:08.344,null
949,24498,18312993,합계,7227,7116,111,17718,2022-06-24 09:06:08.344,null
950,16,11237,검역,1,0,1,17717,2022-06-23 09:07:13.328,null
951,182,238227,제주,101,95,6,17716,2022-06-23 09:07:13.328,null
952,1256,1100613,경남,467,457,10,17715,2022-06-23 09:07:13.328,null
953,1393,789423,경북,388,379,9,17714,2022-06-23 09:07:13.328,null
954,478,600566,전남,226,225,1,17713,2022-06-23 09:07:13.328,null
955,880,604329,전북,182,178,4,17712,2022-06-23 09:07:13.327,null
956,964,720969,충남,273,272,1,17711,2022-06-23 09:07:13.327,null
957,729,559830,충북,212,206,6,17710,2022-06-23 09:07:13.327,null
958,870,523410,강원,265,261,4,17709,2022-06-23 09:07:13.327,null
959,6260,4972589,경기,1971,1966,5,17708,2022-06-23 09:07:13.326,null
960,36,140207,세종,63,63,0,17707,2022-06-23 09:07:13.326,null
961,342,384070,울산,241,239,2,17706,2022-06-23 09:07:13.326,null
962,708,515752,대전,205,203,2,17705,2022-06-23 09:07:13.326,null
963,565,536634,광주,145,141,4,17704,2022-06-23 09:07:13.326,null
964,1406,1080566,인천,372,346,26,17703,2022-06-23 09:07:13.325,null
965,1346,770371,대구,351,343,8,17702,2022-06-23 09:07:13.325,null
966,2176,1103343,부산,454,454,0,17701,2022-06-23 09:07:13.325,null
967,4881,3653647,서울,1580,1577,3,17700,2022-06-23 09:07:13.325,null
968,24488,18305783,합계,7497,7405,92,17699,2022-06-23 09:07:13.324,null
969,16,11236,검역,0,0,0,17698,2022-06-22 09:03:39.182,null
970,182,238126,제주,163,152,11,17697,2022-06-22 09:03:39.182,null
971,1257,1100146,경남,539,528,11,17696,2022-06-22 09:03:39.181,null
972,1390,789035,경북,525,504,21,17695,2022-06-22 09:03:39.181,null
973,478,600340,전남,269,268,1,17694,2022-06-22 09:03:39.181,null
974,880,604147,전북,265,258,7,17693,2022-06-22 09:03:39.181,null
975,964,720703,충남,365,365,0,17692,2022-06-22 09:03:39.18,null
976,729,559618,충북,223,215,8,17691,2022-06-22 09:03:39.18,null
977,869,523145,강원,364,359,5,17690,2022-06-22 09:03:39.18,null
978,6258,4970653,경기,2281,2281,0,17689,2022-06-22 09:03:39.18,null
979,36,140144,세종,76,67,9,17688,2022-06-22 09:03:39.179,null
980,342,383829,울산,332,330,2,17687,2022-06-22 09:03:39.179,null
981,708,515547,대전,204,204,0,17686,2022-06-22 09:03:39.179,null
982,564,536489,광주,183,180,3,17685,2022-06-22 09:03:39.179,null
983,1405,1080196,인천,404,385,19,17684,2022-06-22 09:03:39.179,null
984,1345,770020,대구,469,462,7,17683,2022-06-22 09:03:39.178,null
985,2173,1102899,부산,552,551,1,17682,2022-06-22 09:03:39.178,null
986,4878,3652068,서울,1778,1777,1,17681,2022-06-22 09:03:39.178,null
987,24474,18298341,합계,8992,8886,106,17680,2022-06-22 09:03:39.177,null
988,16,11237,검역,2,0,2,17679,2022-06-21 09:06:33.816,null
989,182,237963,제주,69,67,2,17678,2022-06-21 09:06:33.815,null
990,1256,1099607,경남,577,573,4,17677,2022-06-21 09:06:33.815,null
991,1390,788512,경북,369,364,5,17676,2022-06-21 09:06:33.815,null
992,478,600071,전남,276,276,0,17675,2022-06-21 09:06:33.815,null
993,880,603883,전북,253,249,4,17674,2022-06-21 09:06:33.815,null
994,964,720338,충남,323,322,1,17673,2022-06-21 09:06:33.814,null
995,729,559395,충북,235,231,4,17672,2022-06-21 09:06:33.814,null
996,869,522781,강원,304,303,1,17671,2022-06-21 09:06:33.814,null
997,6256,4968386,경기,2521,2519,2,17670,2022-06-21 09:06:33.814,null
998,36,140068,세종,63,62,1,17669,2022-06-21 09:06:33.814,null
999,342,383499,울산,317,315,2,17668,2022-06-21 09:06:33.813,null
1000,707,515343,대전,175,175,0,17667,2022-06-21 09:06:33.813,null
1001,564,536306,광주,180,178,2,17666,2022-06-21 09:06:33.813,null
1002,1405,1079793,인천,481,441,40,17665,2022-06-21 09:06:33.813,null
1003,1344,769551,대구,587,584,3,17664,2022-06-21 09:06:33.812,null
1004,2170,1102349,부산,535,535,0,17663,2022-06-21 09:06:33.812,null
1005,4875,3650291,서울,2043,2040,3,17662,2022-06-21 09:06:33.812,null
1006,24463,18289373,합계,9310,9234,76,17661,2022-06-21 09:06:33.812,null
1007,16,11235,검역,4,0,4,17660,2022-06-20 11:02:30.884,null
1008,182,237894,제주,77,72,5,17659,2022-06-20 11:02:30.884,null
1009,1256,1099030,경남,194,184,10,17658,2022-06-20 11:02:30.884,null
1010,1390,788144,경북,228,222,6,17657,2022-06-20 11:02:30.883,null
1011,477,599795,전남,111,110,1,17656,2022-06-20 11:02:30.883,null
1012,880,603630,전북,72,68,4,17655,2022-06-20 11:02:30.883,null
1013,963,720015,충남,134,127,7,17654,2022-06-20 11:02:30.883,null
1014,729,559160,충북,83,82,1,17653,2022-06-20 11:02:30.883,null
1015,869,522477,강원,154,154,0,17652,2022-06-20 11:02:30.882,null
1016,6255,4965875,경기,886,884,2,17651,2022-06-20 11:02:30.882,null
1017,36,140005,세종,44,40,4,17650,2022-06-20 11:02:30.882,null
1018,342,383183,울산,115,115,0,17649,2022-06-20 11:02:30.882,null
1019,706,515168,대전,91,87,4,17648,2022-06-20 11:02:30.881,null
1020,564,536126,광주,116,107,9,17647,2022-06-20 11:02:30.881,null
1021,1405,1079315,인천,222,188,34,17646,2022-06-20 11:02:30.881,null
1022,1343,768964,대구,139,137,2,17645,2022-06-20 11:02:30.881,null
1023,2170,1101815,부산,149,148,1,17644,2022-06-20 11:02:30.88,null
1024,4868,3648259,서울,719,717,2,17643,2022-06-20 11:02:30.88,null
1025,24451,18280090,합계,3538,3442,96,17642,2022-06-20 11:02:30.88,null
1026,16,11231,검역,2,0,2,17622,2022-06-19 07:43:21.146,null
1027,182,237817,제주,127,120,7,17621,2022-06-19 07:43:21.146,null
1028,1256,1098836,경남,374,370,4,17620,2022-06-19 07:43:21.145,null
1029,1390,787916,경북,405,397,8,17619,2022-06-19 07:43:21.145,null
1030,476,599684,전남,212,209,3,17618,2022-06-19 07:43:21.144,null
1031,880,603558,전북,184,179,5,17617,2022-06-19 07:43:21.144,null
1032,962,719881,충남,218,216,2,17616,2022-06-19 07:43:21.143,null
1033,729,559077,충북,194,190,4,17615,2022-06-19 07:43:21.143,null
1034,867,522323,강원,250,249,1,17614,2022-06-19 07:43:21.142,null
1035,6254,4964989,경기,1406,1399,7,17613,2022-06-19 07:43:21.142,null
1036,36,139961,세종,52,47,5,17612,2022-06-19 07:43:21.141,null
1037,342,383068,울산,243,243,0,17611,2022-06-19 07:43:21.141,null
1038,706,515077,대전,138,138,0,17610,2022-06-19 07:43:21.14,null
1039,564,536010,광주,134,130,4,17609,2022-06-19 07:43:21.14,null
1040,1405,1079093,인천,278,257,21,17608,2022-06-19 07:43:21.139,null
1041,1342,768825,대구,402,394,8,17607,2022-06-19 07:43:21.138,null
1042,2169,1101666,부산,344,343,1,17606,2022-06-19 07:43:21.138,null
1043,4865,3647540,서울,1108,1107,1,17605,2022-06-19 07:43:21.137,null
1044,24441,18276552,합계,6071,5988,83,17604,2022-06-19 07:43:21.137,null
1045,16,11229,검역,22,0,22,17603,2022-06-18 08:18:29.862,null
1046,182,237690,제주,101,93,8,17602,2022-06-18 08:18:29.861,null
1047,1256,1098462,경남,480,476,4,17601,2022-06-18 08:18:29.861,null
1048,1388,787511,경북,431,425,6,17600,2022-06-18 08:18:29.861,null
1049,475,599472,전남,208,204,4,17599,2022-06-18 08:18:29.861,null
1050,880,603374,전북,207,201,6,17598,2022-06-18 08:18:29.861,null
1051,962,719663,충남,247,247,0,17597,2022-06-18 08:18:29.86,null
1052,729,558883,충북,202,201,1,17596,2022-06-18 08:18:29.86,null
1053,866,522073,강원,306,303,3,17595,2022-06-18 08:18:29.86,null
1054,6254,4963583,경기,1698,1697,1,17594,2022-06-18 08:18:29.86,null
1055,35,139909,세종,71,69,2,17593,2022-06-18 08:18:29.859,null
1056,342,382825,울산,244,244,0,17592,2022-06-18 08:18:29.859,null
1057,704,514939,대전,126,125,1,17591,2022-06-18 08:18:29.859,null
1058,563,535876,광주,135,130,5,17590,2022-06-18 08:18:29.859,null
1059,1404,1078815,인천,260,250,10,17589,2022-06-18 08:18:29.859,null
1060,1342,768423,대구,438,432,6,17588,2022-06-18 08:18:29.858,null
1061,2165,1101322,부산,421,421,0,17587,2022-06-18 08:18:29.858,null
1062,4864,3646432,서울,1245,1245,0,17586,2022-06-18 08:18:29.858,null
1063,24427,18270481,합계,6842,6763,79,17585,2022-06-18 08:18:29.858,null
1064,16,11207,검역,0,0,0,17584,2022-06-17 09:05:05.383,null
1065,182,237589,제주,137,131,6,17583,2022-06-17 09:05:05.383,null
1066,1255,1097982,경남,522,518,4,17582,2022-06-17 09:05:05.382,null
1067,1387,787080,경북,448,446,2,17581,2022-06-17 09:05:05.382,null
1068,474,599264,전남,233,232,1,17580,2022-06-17 09:05:05.382,null
1069,880,603167,전북,183,181,2,17579,2022-06-17 09:05:05.382,null
1070,962,719416,충남,317,317,0,17578,2022-06-17 09:05:05.381,null
1071,729,558681,충북,188,181,7,17577,2022-06-17 09:05:05.381,null
1072,865,521767,강원,300,298,2,17576,2022-06-17 09:05:05.381,null
1073,6251,4961885,경기,1723,1716,7,17575,2022-06-17 09:05:05.381,null
1074,35,139838,세종,59,59,0,17574,2022-06-17 09:05:05.381,null
1075,342,382581,울산,257,254,3,17573,2022-06-17 09:05:05.38,null
1076,703,514813,대전,177,175,2,17572,2022-06-17 09:05:05.38,null
1077,563,535741,광주,162,159,3,17571,2022-06-17 09:05:05.38,null
1078,1403,1078555,인천,290,265,25,17570,2022-06-17 09:05:05.38,null
1079,1341,767985,대구,447,446,1,17569,2022-06-17 09:05:05.379,null
1080,2165,1100903,부산,475,475,0,17568,2022-06-17 09:05:05.379,null
1081,4863,3645189,서울,1280,1277,3,17567,2022-06-17 09:05:05.379,null
1082,24416,18263643,합계,7198,7130,68,17566,2022-06-17 09:05:05.379,null
1083,16,11207,검역,4,0,4,17565,2022-06-16 09:00:56.934,null
1084,182,237452,제주,131,123,8,17564,2022-06-16 09:00:56.934,null
1085,1255,1097460,경남,441,431,10,17563,2022-06-16 09:00:56.934,null
1086,1387,786633,경북,558,557,1,17562,2022-06-16 09:00:56.933,null
1087,474,599031,전남,239,235,4,17561,2022-06-16 09:00:56.933,null
1088,880,602984,전북,207,198,9,17560,2022-06-16 09:00:56.933,null
1089,962,719099,충남,320,319,1,17559,2022-06-16 09:00:56.933,null
1090,729,558493,충북,245,240,5,17558,2022-06-16 09:00:56.933,null
1091,862,521467,강원,315,312,3,17557,2022-06-16 09:00:56.932,null
1092,6251,4960168,경기,1993,1989,4,17556,2022-06-16 09:00:56.932,null
1093,35,139779,세종,65,62,3,17555,2022-06-16 09:00:56.932,null
1094,341,382324,울산,284,282,2,17554,2022-06-16 09:00:56.932,null
1095,703,514636,대전,195,194,1,17553,2022-06-16 09:00:56.932,null
1096,563,535579,광주,187,184,3,17552,2022-06-16 09:00:56.931,2022-06-20 18:00:54.525
1097,1402,1078267,인천,338,313,25,17551,2022-06-16 09:00:56.931,null
1098,1339,767538,대구,466,461,5,17550,2022-06-16 09:00:56.931,null
1099,2164,1100429,부산,457,457,0,17549,2022-06-16 09:00:56.931,null
1100,4862,3643911,서울,1549,1547,2,17548,2022-06-16 09:00:56.93,null
1101,24407,18256457,합계,7994,7904,90,17547,2022-06-16 09:00:56.93,2022-06-20 18:00:32.168
1102,16,11203,검역,3,0,3,17546,2022-06-15 09:11:05.578,null
1103,182,237321,제주,144,140,4,17545,2022-06-15 09:11:05.578,null
1104,1255,1097019,경남,537,529,8,17544,2022-06-15 09:11:05.577,null
1105,1386,786075,경북,686,678,8,17543,2022-06-15 09:11:05.577,null
1106,474,598792,전남,270,269,1,17542,2022-06-15 09:11:05.577,null
1107,880,602781,전북,270,266,4,17541,2022-06-15 09:11:05.576,null
1108,962,718785,충남,417,414,3,17540,2022-06-15 09:11:05.576,null
1109,729,558248,충북,323,316,7,17539,2022-06-15 09:11:05.576,null
1110,861,521152,강원,449,447,2,17538,2022-06-15 09:11:05.576,null
1111,6250,4958176,경기,2288,2282,6,17537,2022-06-15 09:11:05.575,null
1112,35,139715,세종,59,58,1,17536,2022-06-15 09:11:05.575,null
1113,341,382041,울산,320,320,0,17535,2022-06-15 09:11:05.575,null
1114,703,514441,대전,271,269,2,17534,2022-06-15 09:11:05.575,null
1115,563,535392,광주,214,210,4,17533,2022-06-15 09:11:05.574,null
1116,1401,1077931,인천,401,364,37,17532,2022-06-15 09:11:05.574,null
1117,1339,767073,대구,559,554,5,17531,2022-06-15 09:11:05.574,null
1118,2164,1099972,부산,534,529,5,17530,2022-06-15 09:11:05.573,null
1119,4858,3642362,서울,1690,1686,4,17529,2022-06-15 09:11:05.573,null
1120,24399,18248479,합계,9435,9331,104,17528,2022-06-15 09:11:05.573,null
1121,16,11200,검역,1,0,1,17527,2022-06-14 09:11:40.8,null
1122,182,237178,제주,112,107,5,17526,2022-06-14 09:11:40.8,null
1123,1255,1096482,경남,617,608,9,17525,2022-06-14 09:11:40.8,null
1124,1385,785389,경북,579,578,1,17524,2022-06-14 09:11:40.8,null
1125,474,598522,전남,315,314,1,17523,2022-06-14 09:11:40.799,null
1126,879,602511,전북,297,295,2,17522,2022-06-14 09:11:40.799,null
1127,962,718368,충남,308,308,0,17521,2022-06-14 09:11:40.799,null
1128,729,557925,충북,310,309,1,17520,2022-06-14 09:11:40.799,null
1129,861,520703,강원,425,423,2,17519,2022-06-14 09:11:40.799,null
1130,6249,4955893,경기,2348,2346,2,17518,2022-06-14 09:11:40.798,null
1131,35,139656,세종,75,73,2,17517,2022-06-14 09:11:40.798,null
1132,341,381723,울산,306,306,0,17516,2022-06-14 09:11:40.798,null
1133,703,514170,대전,239,238,1,17515,2022-06-14 09:11:40.798,null
1134,561,535179,광주,198,194,4,17514,2022-06-14 09:11:40.797,null
1135,1400,1077530,인천,595,590,5,17513,2022-06-14 09:11:40.797,null
1136,1339,766514,대구,619,615,4,17512,2022-06-14 09:11:40.797,null
1137,2164,1099439,부산,670,670,0,17511,2022-06-14 09:11:40.797,null
1138,4855,3640674,서울,1764,1763,1,17510,2022-06-14 09:11:40.797,null
1139,24390,18239056,합계,9778,9737,41,17509,2022-06-14 09:11:40.796,null
1140,16,11199,검역,2,0,2,17508,2022-06-13 09:16:40.664,null
1141,182,237066,제주,83,74,9,17507,2022-06-13 09:16:40.664,null
1142,1255,1095865,경남,195,193,2,17506,2022-06-13 09:16:40.664,null
1143,1385,784810,경북,270,266,4,17505,2022-06-13 09:16:40.663,null
1144,474,598208,전남,121,121,0,17504,2022-06-13 09:16:40.663,null
1145,879,602214,전북,109,106,3,17503,2022-06-13 09:16:40.663,null
1146,961,718060,충남,177,175,2,17502,2022-06-13 09:16:40.663,null
1147,729,557615,충북,102,98,4,17501,2022-06-13 09:16:40.663,null
1148,861,520278,강원,187,187,0,17500,2022-06-13 09:16:40.662,null
1149,6249,4953549,경기,1024,1021,3,17499,2022-06-13 09:16:40.662,null
1150,35,139581,세종,16,16,0,17498,2022-06-13 09:16:40.662,null
1151,341,381417,울산,110,110,0,17497,2022-06-13 09:16:40.662,null
1152,702,513931,대전,146,146,0,17496,2022-06-13 09:16:40.661,null
1153,561,534981,광주,108,100,8,17495,2022-06-13 09:16:40.661,null
1154,1400,1076938,인천,123,104,19,17494,2022-06-13 09:16:40.661,null
1155,1339,765895,대구,204,204,0,17493,2022-06-13 09:16:40.66,null
1156,2164,1098770,부산,188,188,0,17492,2022-06-13 09:16:40.66,null
1157,4855,3638911,서울,663,659,4,17491,2022-06-13 09:16:40.66,null
1158,24388,18229288,합계,3828,3768,60,17490,2022-06-13 09:16:40.66,null
1159,16,11197,검역,4,0,4,17489,2022-06-12 09:16:33.544,null
1160,182,236983,제주,143,139,4,17488,2022-06-12 09:16:33.544,null
1161,1253,1095670,경남,440,436,4,17487,2022-06-12 09:16:33.544,null
1162,1384,784540,경북,573,565,8,17486,2022-06-12 09:16:33.544,null
1163,473,598087,전남,279,279,0,17485,2022-06-12 09:16:33.543,null
1164,877,602105,전북,272,264,8,17484,2022-06-12 09:16:33.543,null
1165,961,717883,충남,285,282,3,17483,2022-06-12 09:16:33.543,null
1166,729,557513,충북,246,239,7,17482,2022-06-12 09:16:33.543,null
1167,860,520091,강원,360,357,3,17481,2022-06-12 09:16:33.542,null
1168,6248,4952525,경기,1690,1684,6,17480,2022-06-12 09:16:33.542,null
1169,35,139565,세종,82,82,0,17479,2022-06-12 09:16:33.542,null
1170,341,381307,울산,297,294,3,17478,2022-06-12 09:16:33.542,null
1171,702,513785,대전,268,265,3,17477,2022-06-12 09:16:33.542,null
1172,561,534873,광주,192,188,4,17476,2022-06-12 09:16:33.541,null
1173,1398,1076815,인천,278,263,15,17475,2022-06-12 09:16:33.541,null
1174,1339,765691,대구,396,391,5,17474,2022-06-12 09:16:33.541,null
1175,2159,1098582,부산,417,417,0,17473,2022-06-12 09:16:33.541,null
1176,4853,3638248,서울,1160,1159,1,17472,2022-06-12 09:16:33.54,null
1177,24371,18225460,합계,7382,7304,78,17471,2022-06-12 09:16:33.54,null
1178,16,11193,검역,1,0,1,17470,2022-06-11 09:20:40.869,null
1179,182,236840,제주,126,119,7,17469,2022-06-11 09:20:40.869,null
1180,1252,1095230,경남,471,467,4,17468,2022-06-11 09:20:40.868,null
1181,1380,783967,경북,625,613,12,17467,2022-06-11 09:20:40.868,null
1182,473,597808,전남,318,316,2,17466,2022-06-11 09:20:40.868,null
1183,877,601833,전북,275,272,3,17465,2022-06-11 09:20:40.868,null
1184,960,717598,충남,300,300,0,17464,2022-06-11 09:20:40.867,null
1185,728,557267,충북,304,294,10,17463,2022-06-11 09:20:40.867,null
1186,859,519731,강원,383,381,2,17462,2022-06-11 09:20:40.867,null
1187,6246,4950835,경기,2067,2066,1,17461,2022-06-11 09:20:40.867,null
1188,35,139483,세종,99,99,0,17460,2022-06-11 09:20:40.867,null
1189,341,381010,울산,295,295,0,17459,2022-06-11 09:20:40.866,null
1190,702,513517,대전,250,250,0,17458,2022-06-11 09:20:40.866,null
1191,559,534681,광주,226,225,1,17457,2022-06-11 09:20:40.866,null
1192,1396,1076537,인천,340,323,17,17456,2022-06-11 09:20:40.866,null
1193,1337,765295,대구,534,532,2,17455,2022-06-11 09:20:40.865,null
1194,2156,1098165,부산,446,446,0,17454,2022-06-11 09:20:40.865,null
1195,4852,3637088,서울,1382,1380,2,17453,2022-06-11 09:20:40.865,null
1196,24351,18218078,합계,8442,8378,64,17452,2022-06-11 09:20:40.865,null
1197,16,11192,검역,3,0,3,17451,2022-06-10 09:09:07.616,null
1198,182,236714,제주,162,157,5,17450,2022-06-10 09:09:07.615,null
1199,1251,1094759,경남,550,550,0,17449,2022-06-10 09:09:07.615,null
1200,1379,783343,경북,735,733,2,17448,2022-06-10 09:09:07.615,null
1201,473,597490,전남,350,350,0,17447,2022-06-10 09:09:07.615,null
1202,877,601558,전북,302,298,4,17446,2022-06-10 09:09:07.614,null
1203,960,717298,충남,400,400,0,17445,2022-06-10 09:09:07.614,null
1204,728,556963,충북,317,312,5,17444,2022-06-10 09:09:07.614,null
1205,859,519349,강원,444,441,3,17443,2022-06-10 09:09:07.614,null
1206,6246,4948774,경기,2123,2120,3,17442,2022-06-10 09:09:07.613,null
1207,35,139384,세종,90,90,0,17441,2022-06-10 09:09:07.613,null
1208,341,380715,울산,303,298,5,17440,2022-06-10 09:09:07.613,null
1209,702,513268,대전,266,266,0,17439,2022-06-10 09:09:07.613,null
1210,558,534455,광주,278,276,2,17438,2022-06-10 09:09:07.613,null
1211,1396,1076197,인천,392,391,1,17437,2022-06-10 09:09:07.612,null
1212,1337,764763,대구,569,568,1,17436,2022-06-10 09:09:07.612,null
1213,2152,1097720,부산,494,494,0,17435,2022-06-10 09:09:07.612,null
1214,4849,3635708,서울,1537,1537,0,17434,2022-06-10 09:09:07.612,null
1215,24341,18209650,합계,9315,9281,34,17433,2022-06-10 09:09:07.611,null
1216,16,11189,검역,4,0,4,17432,2022-06-09 09:09:46.152,null
1217,182,236552,제주,199,193,6,17431,2022-06-09 09:09:46.151,null
1218,1251,1094209,경남,697,695,2,17430,2022-06-09 09:09:46.151,null
1219,1378,782608,경북,984,972,12,17429,2022-06-09 09:09:46.151,null
1220,471,597140,전남,494,491,3,17428,2022-06-09 09:09:46.151,null
1221,877,601256,전북,415,407,8,17427,2022-06-09 09:09:46.151,null
1222,958,716898,충남,599,599,0,17426,2022-06-09 09:09:46.15,null
1223,728,556646,충북,438,431,7,17425,2022-06-09 09:09:46.15,null
1224,858,518905,강원,540,539,1,17424,2022-06-09 09:09:46.15,null
1225,6239,4946657,경기,2736,2734,2,17423,2022-06-09 09:09:46.15,null
1226,35,139294,세종,118,118,0,17422,2022-06-09 09:09:46.149,null
1227,341,380412,울산,426,426,0,17421,2022-06-09 09:09:46.149,null
1228,701,513002,대전,396,396,0,17420,2022-06-09 09:09:46.149,null
1229,558,534177,광주,352,347,5,17419,2022-06-09 09:09:46.149,null
1230,1396,1075806,인천,411,399,12,17418,2022-06-09 09:09:46.149,null
1231,1336,764196,대구,673,671,2,17417,2022-06-09 09:09:46.148,null
1232,2151,1097227,부산,670,670,0,17416,2022-06-09 09:09:46.148,null
1233,4847,3634172,서울,2009,2008,1,17415,2022-06-09 09:09:46.148,null
1234,24323,18200346,합계,12161,12096,65,17414,2022-06-09 09:09:46.148,null
1235,16,11185,검역,4,0,4,17413,2022-06-08 09:09:34.144,null
1236,182,236353,제주,174,171,3,17412,2022-06-08 09:09:34.144,null
1237,1250,1093512,경남,746,741,5,17411,2022-06-08 09:09:34.144,null
1238,1375,781624,경북,816,811,5,17410,2022-06-08 09:09:34.143,null
1239,470,596646,전남,446,441,5,17409,2022-06-08 09:09:34.143,null
1240,875,600842,전북,469,467,2,17408,2022-06-08 09:09:34.143,null
1241,957,716305,충남,458,457,1,17407,2022-06-08 09:09:34.143,null
1242,728,556208,충북,401,394,7,17406,2022-06-08 09:09:34.143,null
1243,858,518365,강원,587,587,0,17405,2022-06-08 09:09:34.142,null
1244,6234,4943924,경기,3075,3073,2,17404,2022-06-08 09:09:34.142,null
1245,35,139176,세종,115,115,0,17403,2022-06-08 09:09:34.142,null
1246,341,379986,울산,368,368,0,17402,2022-06-08 09:09:34.142,null
1247,700,512606,대전,370,369,1,17401,2022-06-08 09:09:34.141,null
1248,557,533825,광주,353,350,3,17400,2022-06-08 09:09:34.141,null
1249,1396,1075395,인천,533,517,16,17399,2022-06-08 09:09:34.141,null
1250,1336,763523,대구,992,987,5,17398,2022-06-08 09:09:34.141,null
1251,2150,1096561,부산,823,823,0,17397,2022-06-08 09:09:34.14,null
1252,4845,3632164,서울,2628,2628,0,17396,2022-06-08 09:09:34.14,null
1253,24305,18188200,합계,13358,13299,59,17395,2022-06-08 09:09:34.14,null
1254,16,11181,검역,3,0,3,17394,2022-06-07 09:09:51.221,null
1255,182,236180,제주,134,130,4,17393,2022-06-07 09:09:51.22,null
1256,1249,1092766,경남,409,408,1,17392,2022-06-07 09:09:51.22,null
1257,1375,780808,경북,452,451,1,17391,2022-06-07 09:09:51.22,null
1258,469,596203,전남,205,203,2,17390,2022-06-07 09:09:51.22,null
1259,875,600375,전북,216,216,0,17389,2022-06-07 09:09:51.22,null
1260,957,715847,충남,298,297,1,17388,2022-06-07 09:09:51.219,null
1261,727,555808,충북,245,243,2,17387,2022-06-07 09:09:51.219,null
1262,858,517778,강원,307,307,0,17386,2022-06-07 09:09:51.219,null
1263,6234,4940860,경기,1438,1438,0,17385,2022-06-07 09:09:51.219,null
1264,35,139061,세종,83,83,0,17384,2022-06-07 09:09:51.218,null
1265,341,379618,울산,187,187,0,17383,2022-06-07 09:09:51.218,null
1266,700,512236,대전,197,197,0,17382,2022-06-07 09:09:51.218,null
1267,557,533472,광주,142,139,3,17381,2022-06-07 09:09:51.217,null
1268,1394,1074863,인천,249,234,15,17380,2022-06-07 09:09:51.217,null
1269,1335,762533,대구,339,338,1,17379,2022-06-07 09:09:51.217,null
1270,2150,1095746,부산,316,316,0,17378,2022-06-07 09:09:51.217,null
1271,4845,3629545,서울,952,950,2,17377,2022-06-07 09:09:51.216,null
1272,24299,18174880,합계,6172,6137,35,17376,2022-06-07 09:09:51.216,null
1273,16,11178,검역,0,0,0,17375,2022-06-06 09:01:10.932,null
1274,182,236046,제주,111,111,0,17374,2022-06-06 09:01:10.932,null
1275,1249,1092357,경남,268,266,2,17373,2022-06-06 09:01:10.932,null
1276,1374,780356,경북,422,417,5,17372,2022-06-06 09:01:10.932,null
1277,469,595998,전남,158,156,2,17371,2022-06-06 09:01:10.931,null
1278,873,600159,전북,193,192,1,17370,2022-06-06 09:01:10.931,null
1279,957,715549,충남,193,193,0,17369,2022-06-06 09:01:10.931,null
1280,727,555563,충북,178,176,2,17368,2022-06-06 09:01:10.931,null
1281,858,517471,강원,240,240,0,17367,2022-06-06 09:01:10.931,null
1282,6233,4939422,경기,1340,1340,0,17366,2022-06-06 09:01:10.93,null
1283,35,138978,세종,43,43,0,17365,2022-06-06 09:01:10.93,null
1284,340,379431,울산,105,105,0,17364,2022-06-06 09:01:10.93,null
1285,699,512039,대전,195,193,2,17363,2022-06-06 09:01:10.93,null
1286,557,533330,광주,155,154,1,17362,2022-06-06 09:01:10.929,null
1287,1394,1074614,인천,197,197,0,17361,2022-06-06 09:01:10.929,null
1288,1333,762194,대구,301,299,2,17360,2022-06-06 09:01:10.929,null
1289,2143,1095430,부산,185,185,0,17359,2022-06-06 09:01:10.929,null
1290,4840,3628593,서울,738,738,0,17358,2022-06-06 09:01:10.929,null
1291,24279,18168708,합계,5022,5005,17,17357,2022-06-06 09:01:10.928,null
1292,16,11178,검역,1,0,1,17356,2022-06-05 08:53:46.838,null
1293,182,235935,제주,179,178,1,17355,2022-06-05 08:53:46.837,null
1294,1248,1092089,경남,572,568,4,17354,2022-06-05 08:53:46.837,null
1295,1372,779934,경북,751,748,3,17353,2022-06-05 08:53:46.837,null
1296,467,595840,전남,354,352,2,17352,2022-06-05 08:53:46.837,null
1297,873,599966,전북,378,375,3,17351,2022-06-05 08:53:46.836,null
1298,956,715356,충남,491,490,1,17350,2022-06-05 08:53:46.836,null
1299,727,555385,충북,327,322,5,17349,2022-06-05 08:53:46.836,null
1300,855,517231,강원,384,380,4,17348,2022-06-05 08:53:46.836,null
1301,6231,4938082,경기,2190,2189,1,17347,2022-06-05 08:53:46.836,null
1302,35,138935,세종,105,105,0,17346,2022-06-05 08:53:46.835,null
1303,340,379326,울산,307,307,0,17345,2022-06-05 08:53:46.835,null
1304,698,511844,대전,313,313,0,17344,2022-06-05 08:53:46.835,null
1305,557,533175,광주,262,260,2,17343,2022-06-05 08:53:46.835,null
1306,1394,1074417,인천,415,398,17,17342,2022-06-05 08:53:46.834,null
1307,1331,761893,대구,615,611,4,17341,2022-06-05 08:53:46.834,null
1308,2138,1095245,부산,472,472,0,17340,2022-06-05 08:53:46.834,null
1309,4838,3627855,서울,1719,1719,0,17339,2022-06-05 08:53:46.834,null
1310,24258,18163686,합계,9835,9787,48,17338,2022-06-05 08:53:46.833,null
1311,16,11177,검역,2,0,2,17337,2022-06-04 08:57:26.308,null
1312,182,235756,제주,210,210,0,17336,2022-06-04 08:57:26.308,null
1313,1246,1091517,경남,688,686,2,17335,2022-06-04 08:57:26.308,null
1314,1369,779183,경북,889,888,1,17334,2022-06-04 08:57:26.308,null
1315,466,595486,전남,394,389,5,17333,2022-06-04 08:57:26.307,null
1316,872,599588,전북,415,412,3,17332,2022-06-04 08:57:26.307,null
1317,956,714865,충남,539,537,2,17331,2022-06-04 08:57:26.307,null
1318,727,555058,충북,398,396,2,17330,2022-06-04 08:57:26.307,null
1319,853,516847,강원,546,542,4,17329,2022-06-04 08:57:26.306,null
1320,6229,4935892,경기,2746,2745,1,17328,2022-06-04 08:57:26.306,null
1321,35,138830,세종,104,104,0,17327,2022-06-04 08:57:26.306,null
1322,340,379019,울산,331,330,1,17326,2022-06-04 08:57:26.306,null
1323,696,511531,대전,321,321,0,17325,2022-06-04 08:57:26.305,null
1324,557,532913,광주,321,319,2,17324,2022-06-04 08:57:26.305,null
1325,1393,1074002,인천,532,518,14,17323,2022-06-04 08:57:26.305,null
1326,1331,761278,대구,718,716,2,17322,2022-06-04 08:57:26.305,null
1327,2135,1094773,부산,640,640,0,17321,2022-06-04 08:57:26.305,null
1328,4835,3626136,서울,2254,2254,0,17320,2022-06-04 08:57:26.304,null
1329,24238,18153851,합계,12048,12007,41,17319,2022-06-04 08:57:26.304,null
1330,16,11175,검역,7,0,7,17318,2022-06-03 09:08:45.015,null
1331,181,235546,제주,142,142,0,17317,2022-06-03 09:08:45.015,null
1332,1245,1090829,경남,826,824,2,17316,2022-06-03 09:08:45.015,null
1333,1369,778294,경북,842,839,3,17315,2022-06-03 09:08:45.014,null
1334,466,595092,전남,429,429,0,17314,2022-06-03 09:08:45.014,null
1335,872,599174,전북,447,445,2,17313,2022-06-03 09:08:45.014,null
1336,956,714326,충남,408,408,0,17312,2022-06-03 09:08:45.014,null
1337,727,554660,충북,414,409,5,17311,2022-06-03 09:08:45.014,null
1338,853,516301,강원,586,585,1,17310,2022-06-03 09:08:45.013,null
1339,6225,4933154,경기,2872,2872,0,17309,2022-06-03 09:08:45.013,null
1340,35,138726,세종,111,111,0,17308,2022-06-03 09:08:45.013,null
1341,340,378689,울산,362,362,0,17307,2022-06-03 09:08:45.013,null
1342,696,511210,대전,354,352,2,17306,2022-06-03 09:08:45.012,null
1343,557,532592,광주,330,329,1,17305,2022-06-03 09:08:45.012,null
1344,1392,1073470,인천,445,436,9,17304,2022-06-03 09:08:45.012,null
1345,1331,760563,대구,915,915,0,17303,2022-06-03 09:08:45.012,null
1346,2135,1094151,부산,610,610,0,17302,2022-06-03 09:08:45.012,null
1347,4833,3623883,서울,2442,2439,3,17301,2022-06-03 09:08:45.011,null
1348,24229,18141835,합계,12542,12507,35,17300,2022-06-03 09:08:45.011,null
1349,16,11168,검역,4,0,4,17299,2022-06-02 08:58:40.417,null
1350,179,235404,제주,201,201,0,17298,2022-06-02 08:58:40.417,null
1351,1244,1090003,경남,591,591,0,17297,2022-06-02 08:58:40.416,null
1352,1365,777452,경북,824,818,6,17296,2022-06-02 08:58:40.416,null
1353,463,594665,전남,325,325,0,17295,2022-06-02 08:58:40.416,null
1354,872,598727,전북,293,291,2,17294,2022-06-02 08:58:40.416,null
1355,956,713918,충남,454,454,0,17293,2022-06-02 08:58:40.416,null
1356,727,554246,충북,336,332,4,17292,2022-06-02 08:58:40.415,null
1357,851,515715,강원,415,412,3,17291,2022-06-02 08:58:40.415,null
1358,6223,4930290,경기,2108,2102,6,17290,2022-06-02 08:58:40.415,null
1359,35,138615,세종,99,99,0,17289,2022-06-02 08:58:40.415,null
1360,340,378328,울산,322,322,0,17288,2022-06-02 08:58:40.414,null
1361,696,510856,대전,368,368,0,17287,2022-06-02 08:58:40.414,null
1362,557,532262,광주,264,264,0,17286,2022-06-02 08:58:40.414,null
1363,1392,1073025,인천,381,380,1,17285,2022-06-02 08:58:40.414,null
1364,1331,759648,대구,688,688,0,17284,2022-06-02 08:58:40.414,null
1365,2135,1093546,부산,402,401,1,17283,2022-06-02 08:58:40.413,null
1366,4830,3621445,서울,1823,1818,5,17282,2022-06-02 08:58:40.413,null
1367,24212,18129313,합계,9898,9866,32,17281,2022-06-02 08:58:40.413,null
1368,16,11164,검역,1,0,1,17280,2022-06-01 09:08:40.856,null
1369,179,235203,제주,280,280,0,17279,2022-06-01 09:08:40.855,null
1370,1244,1089412,경남,985,979,6,17278,2022-06-01 09:08:40.855,null
1371,1362,776628,경북,1303,1297,6,17277,2022-06-01 09:08:40.855,null
1372,461,594340,전남,510,509,1,17276,2022-06-01 09:08:40.855,null
1373,872,598434,전북,532,531,1,17275,2022-06-01 09:08:40.855,null
1374,956,713464,충남,663,663,0,17274,2022-06-01 09:08:40.854,null
1375,725,553910,충북,600,594,6,17273,2022-06-01 09:08:40.854,null
1376,850,515300,강원,783,783,0,17272,2022-06-01 09:08:40.854,null
1377,6221,4928182,경기,3535,3535,0,17271,2022-06-01 09:08:40.854,null
1378,35,138516,세종,119,119,0,17270,2022-06-01 09:08:40.853,null
1379,339,378006,울산,461,461,0,17269,2022-06-01 09:08:40.853,null
1380,696,510488,대전,451,449,2,17268,2022-06-01 09:08:40.853,null
1381,557,531998,광주,462,458,4,17267,2022-06-01 09:08:40.853,null
1382,1392,1072644,인천,537,520,17,17266,2022-06-01 09:08:40.853,null
1383,1330,758960,대구,942,942,0,17265,2022-06-01 09:08:40.852,null
1384,2133,1093144,부산,707,707,0,17264,2022-06-01 09:08:40.852,null
1385,4829,3619622,서울,2926,2926,0,17263,2022-06-01 09:08:40.852,null
1386,24197,18119415,합계,15797,15753,44,17262,2022-06-01 09:08:40.851,null
1387,16,11163,검역,7,0,7,17261,2022-05-31 08:56:04.562,null
1388,179,234923,제주,236,236,0,17260,2022-05-31 08:56:04.561,null
1389,1244,1088428,경남,1153,1150,3,17259,2022-05-31 08:56:04.561,null
1390,1362,775325,경북,966,964,2,17258,2022-05-31 08:56:04.561,null
1391,460,593830,전남,614,612,2,17257,2022-05-31 08:56:04.561,null
1392,871,597904,전북,616,614,2,17256,2022-05-31 08:56:04.56,null
1393,954,712805,충남,678,678,0,17255,2022-05-31 08:56:04.56,null
1394,724,553311,충북,628,624,4,17254,2022-05-31 08:56:04.56,null
1395,850,514517,강원,696,695,1,17253,2022-05-31 08:56:04.56,null
1396,6217,4924651,경기,3776,3775,1,17252,2022-05-31 08:56:04.559,null
1397,35,138397,세종,135,135,0,17251,2022-05-31 08:56:04.559,null
1398,339,377545,울산,495,494,1,17250,2022-05-31 08:56:04.559,null
1399,696,510037,대전,548,548,0,17249,2022-05-31 08:56:04.558,null
1400,555,531536,광주,431,428,3,17248,2022-05-31 08:56:04.558,null
1401,1389,1072110,인천,676,660,16,17247,2022-05-31 08:56:04.558,null
1402,1327,758019,대구,1308,1308,0,17246,2022-05-31 08:56:04.558,null
1403,2133,1092438,부산,888,888,0,17245,2022-05-31 08:56:04.557,null
1404,4825,3616699,서울,3340,3339,1,17244,2022-05-31 08:56:04.557,null
1405,24176,18103638,합계,17191,17148,43,17243,2022-05-31 08:56:04.557,null
1406,16,11156,검역,4,0,4,17242,2022-05-30 09:01:59.283,null
1407,178,234687,제주,124,124,0,17241,2022-05-30 09:01:59.283,null
1408,1243,1087275,경남,353,348,5,17240,2022-05-30 09:01:59.283,null
1409,1362,774360,경북,497,494,3,17239,2022-05-30 09:01:59.282,null
1410,460,593216,전남,234,234,0,17238,2022-05-30 09:01:59.282,null
1411,871,597288,전북,228,225,3,17237,2022-05-30 09:01:59.282,null
1412,954,712127,충남,279,279,0,17236,2022-05-30 09:01:59.282,null
1413,723,552684,충북,214,212,2,17235,2022-05-30 09:01:59.282,null
1414,850,513821,강원,296,296,0,17234,2022-05-30 09:01:59.281,null
1415,6214,4920879,경기,1470,1468,2,17233,2022-05-30 09:01:59.281,null
1416,35,138262,세종,68,68,0,17232,2022-05-30 09:01:59.281,null
1417,339,377053,울산,109,109,0,17231,2022-05-30 09:01:59.281,null
1418,696,509489,대전,174,174,0,17230,2022-05-30 09:01:59.28,null
1419,553,531105,광주,202,196,6,17229,2022-05-30 09:01:59.28,null
1420,1389,1071436,인천,276,255,21,17228,2022-05-30 09:01:59.28,null
1421,1327,756711,대구,301,300,1,17227,2022-05-30 09:01:59.28,null
1422,2133,1091554,부산,190,189,1,17226,2022-05-30 09:01:59.28,null
1423,4824,3613359,서울,1120,1120,0,17225,2022-05-30 09:01:59.279,null
1424,24167,18086462,합계,6139,6091,48,17224,2022-05-30 09:01:59.279,null
1425,16,11152,검역,8,0,8,17223,2022-05-29 09:07:44.936,null
1426,178,234563,제주,257,257,0,17222,2022-05-29 09:07:44.935,null
1427,1241,1086922,경남,817,815,2,17221,2022-05-29 09:07:44.935,null
1428,1362,773863,경북,1008,1007,1,17220,2022-05-29 09:07:44.935,null
1429,460,592982,전남,467,466,1,17219,2022-05-29 09:07:44.935,null
1430,871,597060,전북,520,517,3,17218,2022-05-29 09:07:44.934,null
1431,953,711848,충남,631,631,0,17217,2022-05-29 09:07:44.934,null
1432,722,552470,충북,457,456,1,17216,2022-05-29 09:07:44.934,null
1433,850,513525,강원,468,467,1,17215,2022-05-29 09:07:44.934,null
1434,6213,4919409,경기,2839,2839,0,17214,2022-05-29 09:07:44.933,null
1435,35,138194,세종,140,140,0,17213,2022-05-29 09:07:44.933,null
1436,339,376944,울산,394,391,3,17212,2022-05-29 09:07:44.933,null
1437,696,509315,대전,446,446,0,17211,2022-05-29 09:07:44.933,null
1438,553,530903,광주,420,414,6,17210,2022-05-29 09:07:44.933,null
1439,1389,1071160,인천,432,432,0,17209,2022-05-29 09:07:44.932,null
1440,1327,756410,대구,794,794,0,17208,2022-05-29 09:07:44.932,null
1441,2133,1091364,부산,538,538,0,17207,2022-05-29 09:07:44.932,null
1442,4820,3612239,서울,2018,2018,0,17206,2022-05-29 09:07:44.932,null
1443,24158,18080323,합계,12654,12628,26,17205,2022-05-29 09:07:44.931,null
1444,16,11144,검역,5,0,5,17204,2022-05-28 09:10:45.105,null
1445,178,234306,제주,280,280,0,17203,2022-05-28 09:10:45.105,null
1446,1240,1086105,경남,937,931,6,17202,2022-05-28 09:10:45.105,null
1447,1358,772855,경북,1065,1063,2,17201,2022-05-28 09:10:45.105,null
1448,459,592515,전남,508,507,1,17200,2022-05-28 09:10:45.104,null
1449,870,596540,전북,584,582,2,17199,2022-05-28 09:10:45.104,null
1450,953,711217,충남,624,624,0,17198,2022-05-28 09:10:45.104,null
1451,722,552013,충북,488,485,3,17197,2022-05-28 09:10:45.104,null
1452,849,513057,강원,570,570,0,17196,2022-05-28 09:10:45.103,null
1453,6209,4916570,경기,3255,3254,1,17195,2022-05-28 09:10:45.103,null
1454,35,138054,세종,114,114,0,17194,2022-05-28 09:10:45.103,null
1455,339,376550,울산,433,433,0,17193,2022-05-28 09:10:45.103,null
1456,694,508869,대전,467,467,0,17192,2022-05-28 09:10:45.102,null
1457,553,530483,광주,496,495,1,17191,2022-05-28 09:10:45.102,null
1458,1389,1070728,인천,637,624,13,17190,2022-05-28 09:10:45.102,null
1459,1325,755616,대구,975,975,0,17189,2022-05-28 09:10:45.102,null
1460,2132,1090826,부산,682,682,0,17188,2022-05-28 09:10:45.102,null
1461,4818,3610221,서울,2278,2267,11,17187,2022-05-28 09:10:45.101,null
1462,24139,18067669,합계,14398,14353,45,17186,2022-05-28 09:10:45.101,null
1463,16,11140,검역,7,0,7,17185,2022-05-27 09:07:51.334,null
1464,177,234028,제주,281,281,0,17184,2022-05-27 09:07:51.334,null
1465,1233,1085169,경남,1101,1100,1,17183,2022-05-27 09:07:51.333,null
1466,1356,771791,경북,1390,1388,2,17182,2022-05-27 09:07:51.333,null
1467,458,592007,전남,594,593,1,17181,2022-05-27 09:07:51.333,null
1468,869,595957,전북,568,567,1,17180,2022-05-27 09:07:51.333,null
1469,952,710593,충남,776,776,0,17179,2022-05-27 09:07:51.333,null
1470,722,551525,충북,511,510,1,17178,2022-05-27 09:07:51.332,null
1471,846,512487,강원,660,658,2,17177,2022-05-27 09:07:51.332,null
1472,6206,4913319,경기,3569,3567,2,17176,2022-05-27 09:07:51.332,null
1473,35,137940,세종,152,152,0,17175,2022-05-27 09:07:51.332,null
1474,339,376117,울산,509,508,1,17174,2022-05-27 09:07:51.331,null
1475,688,508402,대전,552,551,1,17173,2022-05-27 09:07:51.331,null
1476,553,529987,광주,465,463,2,17172,2022-05-27 09:07:51.331,null
1477,1388,1070091,인천,591,576,15,17171,2022-05-27 09:07:51.331,null
1478,1318,754641,대구,1015,1015,0,17170,2022-05-27 09:07:51.33,null
1479,2131,1090147,부산,811,811,0,17169,2022-05-27 09:07:51.33,null
1480,4816,3607946,서울,3032,3019,13,17168,2022-05-27 09:07:51.33,null
1481,24103,18053287,합계,16584,16535,49,17167,2022-05-27 09:07:51.33,null
1482,16,11133,검역,3,0,3,17166,2022-05-26 09:13:56.807,null
1483,176,233747,제주,304,304,0,17165,2022-05-26 09:13:56.807,null
1484,1228,1084070,경남,1269,1269,0,17164,2022-05-26 09:13:56.807,null
1485,1351,770401,경북,1509,1509,0,17163,2022-05-26 09:13:56.807,null
1486,458,591413,전남,674,674,0,17162,2022-05-26 09:13:56.806,null
1487,868,595389,전북,694,693,1,17161,2022-05-26 09:13:56.806,null
1488,948,709817,충남,797,796,1,17160,2022-05-26 09:13:56.806,null
1489,719,551014,충북,701,696,5,17159,2022-05-26 09:13:56.806,null
1490,844,511827,강원,819,815,4,17158,2022-05-26 09:13:56.805,null
1491,6200,4909754,경기,4351,4350,1,17157,2022-05-26 09:13:56.805,null
1492,35,137789,세종,162,162,0,17156,2022-05-26 09:13:56.805,null
1493,338,375608,울산,572,571,1,17155,2022-05-26 09:13:56.805,null
1494,687,507850,대전,628,628,0,17154,2022-05-26 09:13:56.805,null
1495,552,529522,광주,594,591,3,17153,2022-05-26 09:13:56.804,null
1496,1387,1069501,인천,757,743,14,17152,2022-05-26 09:13:56.804,null
1497,1317,753626,대구,1299,1299,0,17151,2022-05-26 09:13:56.804,null
1498,2130,1089339,부산,895,895,0,17150,2022-05-26 09:13:56.804,null
1499,4809,3604920,서울,2788,2787,1,17149,2022-05-26 09:13:56.803,null
1500,24063,18036720,합계,18816,18782,34,17148,2022-05-26 09:13:56.803,null
1501,16,11130,검역,2,0,2,17147,2022-05-25 09:03:14.347,null
1502,176,233443,제주,581,581,0,17146,2022-05-25 09:03:14.347,null
1503,1224,1082802,경남,1477,1477,0,17145,2022-05-25 09:03:14.347,null
1504,1347,768892,경북,1982,1981,1,17144,2022-05-25 09:03:14.346,null
1505,451,590739,전남,946,946,0,17143,2022-05-25 09:03:14.346,null
1506,867,594697,전북,1021,1019,2,17142,2022-05-25 09:03:14.346,null
1507,948,709020,충남,1035,1035,0,17141,2022-05-25 09:03:14.346,null
1508,719,550314,충북,826,819,7,17140,2022-05-25 09:03:14.346,null
1509,841,511008,강원,1150,1150,0,17139,2022-05-25 09:03:14.345,null
1510,6195,4905409,경기,5261,5258,3,17138,2022-05-25 09:03:14.345,null
1511,35,137627,세종,254,254,0,17137,2022-05-25 09:03:14.345,null
1512,338,375036,울산,702,702,0,17136,2022-05-25 09:03:14.345,null
1513,686,507222,대전,844,843,1,17135,2022-05-25 09:03:14.344,null
1514,552,528930,광주,814,809,5,17134,2022-05-25 09:03:14.344,null
1515,1387,1068746,인천,998,998,0,17133,2022-05-25 09:03:14.344,null
1516,1314,752327,대구,1438,1438,0,17132,2022-05-25 09:03:14.344,null
1517,2127,1088448,부산,1039,1039,0,17131,2022-05-25 09:03:14.344,null
1518,4806,3602133,서울,3586,3586,0,17130,2022-05-25 09:03:14.343,null
1519,24029,18017923,합계,23956,23935,21,17129,2022-05-25 09:03:14.343,null
1520,16,11128,검역,1,0,1,17128,2022-05-24 08:50:03.406,null
1521,176,232862,제주,271,271,0,17127,2022-05-24 08:50:03.406,null
1522,1223,1081325,경남,1829,1826,3,17126,2022-05-24 08:50:03.405,null
1523,1345,766911,경북,1668,1665,3,17125,2022-05-24 08:50:03.405,null
1524,450,589794,전남,922,922,0,17124,2022-05-24 08:50:03.405,null
1525,867,593678,전북,1061,1060,1,17123,2022-05-24 08:50:03.405,null
1526,948,707985,충남,1152,1150,2,17122,2022-05-24 08:50:03.404,null
1527,717,549489,충북,905,901,4,17121,2022-05-24 08:50:03.404,null
1528,837,509858,강원,1065,1065,0,17120,2022-05-24 08:50:03.404,null
1529,6190,4900150,경기,6031,6031,0,17119,2022-05-24 08:50:03.404,null
1530,35,137373,세종,275,275,0,17118,2022-05-24 08:50:03.404,null
1531,338,374334,울산,753,751,2,17117,2022-05-24 08:50:03.403,null
1532,684,506378,대전,908,907,1,17116,2022-05-24 08:50:03.403,null
1533,552,528116,광주,594,590,4,17115,2022-05-24 08:50:03.403,null
1534,1387,1067749,인천,1055,1035,20,17114,2022-05-24 08:50:03.403,null
1535,1313,750891,대구,2054,2054,0,17113,2022-05-24 08:50:03.402,null
1536,2126,1087409,부산,1528,1527,1,17112,2022-05-24 08:50:03.402,null
1537,4802,3598555,서울,4272,4271,1,17111,2022-05-24 08:50:03.402,null
1538,24006,17993985,합계,26344,26301,43,17110,2022-05-24 08:50:03.402,null
1539,16,11127,검역,2,0,2,17109,2022-05-23 08:57:25.496,null
1540,175,232591,제주,258,258,0,17108,2022-05-23 08:57:25.496,null
1541,1220,1079496,경남,554,554,0,17107,2022-05-23 08:57:25.495,null
1542,1345,765243,경북,848,845,3,17106,2022-05-23 08:57:25.495,null
1543,449,588872,전남,409,409,0,17105,2022-05-23 08:57:25.495,null
1544,865,592617,전북,479,478,1,17104,2022-05-23 08:57:25.495,null
1545,948,706843,충남,422,422,0,17103,2022-05-23 08:57:25.494,null
1546,716,548585,충북,330,329,1,17102,2022-05-23 08:57:25.494,null
1547,835,508793,강원,515,515,0,17101,2022-05-23 08:57:25.494,null
1548,6188,4894128,경기,2666,2665,1,17100,2022-05-23 08:57:25.494,null
1549,35,137099,세종,109,109,0,17099,2022-05-23 08:57:25.494,null
1550,338,373581,울산,210,210,0,17098,2022-05-23 08:57:25.493,null
1551,682,505470,대전,386,386,0,17097,2022-05-23 08:57:25.493,null
1552,552,527522,광주,342,342,0,17096,2022-05-23 08:57:25.493,null
1553,1386,1066695,인천,392,383,9,17095,2022-05-23 08:57:25.493,null
1554,1311,748837,대구,481,481,0,17094,2022-05-23 08:57:25.492,null
1555,2125,1085884,부산,359,359,0,17093,2022-05-23 08:57:25.492,null
1556,4801,3594289,서울,1213,1213,0,17092,2022-05-23 08:57:25.492,null
1557,23987,17967672,합계,9975,9958,17,17091,2022-05-23 08:57:25.492,null
1558,16,11125,검역,3,0,3,17090,2022-05-22 07:53:05.841,null
1559,175,232333,제주,280,280,0,17089,2022-05-22 07:53:05.84,null
1560,1218,1078942,경남,1272,1270,2,17088,2022-05-22 07:53:05.84,null
1561,1343,764395,경북,1510,1506,4,17087,2022-05-22 07:53:05.84,null
1562,449,588463,전남,840,840,0,17086,2022-05-22 07:53:05.84,null
1563,864,592138,전북,861,859,2,17085,2022-05-22 07:53:05.84,null
1564,948,706421,충남,854,854,0,17084,2022-05-22 07:53:05.839,null
1565,714,548255,충북,671,670,1,17083,2022-05-22 07:53:05.839,null
1566,834,508278,강원,828,826,2,17082,2022-05-22 07:53:05.839,null
1567,6184,4891462,경기,4266,4266,0,17081,2022-05-22 07:53:05.839,null
1568,35,136990,세종,184,184,0,17080,2022-05-22 07:53:05.838,null
1569,336,373371,울산,651,651,0,17079,2022-05-22 07:53:05.838,null
1570,682,505084,대전,695,693,2,17078,2022-05-22 07:53:05.838,null
1571,552,527180,광주,618,617,1,17077,2022-05-22 07:53:05.838,null
1572,1385,1066303,인천,799,796,3,17076,2022-05-22 07:53:05.837,null
1573,1310,748356,대구,1194,1194,0,17075,2022-05-22 07:53:05.837,null
1574,2123,1085525,부산,869,869,0,17074,2022-05-22 07:53:05.836,null
1575,4797,3593076,서울,2903,2899,4,17073,2022-05-22 07:53:05.836,null
1576,23965,17957697,합계,19298,19274,24,17072,2022-05-22 07:53:05.836,null
1577,16,11122,검역,4,0,4,17071,2022-05-21 08:42:06.178,null
1578,174,232053,제주,380,380,0,17070,2022-05-21 08:42:06.177,null
1579,1215,1077670,경남,1515,1513,2,17069,2022-05-21 08:42:06.177,null
1580,1341,762885,경북,1663,1661,2,17068,2022-05-21 08:42:06.177,null
1581,439,587623,전남,907,907,0,17067,2022-05-21 08:42:06.177,null
1582,863,591277,전북,1021,1021,0,17066,2022-05-21 08:42:06.176,null
1583,946,705567,충남,989,989,0,17065,2022-05-21 08:42:06.176,null
1584,714,547584,충북,795,794,1,17064,2022-05-21 08:42:06.176,null
1585,828,507450,강원,1103,1103,0,17063,2022-05-21 08:42:06.176,null
1586,6174,4887196,경기,5693,5693,0,17062,2022-05-21 08:42:06.176,null
1587,35,136806,세종,209,209,0,17061,2022-05-21 08:42:06.175,null
1588,336,372720,울산,626,626,0,17060,2022-05-21 08:42:06.175,null
1589,682,504389,대전,743,743,0,17059,2022-05-21 08:42:06.175,null
1590,549,526562,광주,751,749,2,17058,2022-05-21 08:42:06.175,null
1591,1383,1065504,인천,1064,1064,0,17057,2022-05-21 08:42:06.174,null
1592,1310,747162,대구,1316,1316,0,17056,2022-05-21 08:42:06.174,null
1593,2118,1084656,부산,1094,1094,0,17055,2022-05-21 08:42:06.174,null
1594,4788,3590173,서울,3589,3589,0,17054,2022-05-21 08:42:06.174,null
1595,23911,17938399,합계,23462,23451,11,17053,2022-05-21 08:42:06.173,null
1596,16,11118,검역,9,0,9,17033,2022-05-20 09:03:54.181,null
1597,174,231676,제주,392,391,1,17032,2022-05-20 09:03:54.181,null
1598,1215,1076155,경남,1509,1506,3,17031,2022-05-20 09:03:54.181,null
1599,1338,761222,경북,1678,1674,4,17030,2022-05-20 09:03:54.18,null
1600,437,586717,전남,1019,1019,0,17029,2022-05-20 09:03:54.18,null
1601,861,590256,전북,954,954,0,17028,2022-05-20 09:03:54.18,null
1602,945,704585,충남,1185,1185,0,17027,2022-05-20 09:03:54.18,null
1603,714,546791,충북,909,905,4,17026,2022-05-20 09:03:54.18,null
1604,827,506347,강원,1268,1268,0,17025,2022-05-20 09:03:54.179,null
1605,6165,4881507,경기,6007,6007,0,17024,2022-05-20 09:03:54.179,null
1606,35,136597,세종,229,229,0,17023,2022-05-20 09:03:54.179,null
1607,336,372094,울산,660,660,0,17022,2022-05-20 09:03:54.179,null
1608,681,503646,대전,845,844,1,17021,2022-05-20 09:03:54.178,null
1609,549,525811,광주,821,821,0,17020,2022-05-20 09:03:54.178,null
1610,1381,1064440,인천,1149,1149,0,17019,2022-05-20 09:03:54.178,null
1611,1310,745846,대구,1297,1297,0,17018,2022-05-20 09:03:54.178,null
1612,2116,1083563,부산,1084,1084,0,17017,2022-05-20 09:03:54.177,null
1613,4785,3586586,서울,4110,4110,0,17016,2022-05-20 09:03:54.177,null
1614,23885,17914957,합계,25125,25103,22,17015,2022-05-20 09:03:54.177,null
1615,16,11109,검역,2,0,2,17014,2022-05-19 09:07:43.783,null
1616,174,231285,제주,367,367,0,17013,2022-05-19 09:07:43.782,null
1617,1213,1074646,경남,1756,1755,1,17012,2022-05-19 09:07:43.782,null
1618,1335,759544,경북,1921,1919,2,17011,2022-05-19 09:07:43.782,null
1619,434,585699,전남,1041,1040,1,17010,2022-05-19 09:07:43.782,null
1620,859,589303,전북,1183,1182,1,17009,2022-05-19 09:07:43.782,null
1621,943,703400,충남,1471,1471,0,17008,2022-05-19 09:07:43.781,null
1622,714,545883,충북,1022,1020,2,17007,2022-05-19 09:07:43.781,null
1623,823,505079,강원,1097,1096,1,17006,2022-05-19 09:07:43.781,null
1624,6157,4875504,경기,6863,6863,0,17005,2022-05-19 09:07:43.781,null
1625,35,136368,세종,269,269,0,17004,2022-05-19 09:07:43.78,null
1626,335,371434,울산,753,753,0,17003,2022-05-19 09:07:43.78,null
1627,681,502801,대전,950,950,0,17002,2022-05-19 09:07:43.78,null
1628,549,524990,광주,818,817,1,17001,2022-05-19 09:07:43.78,null
1629,1376,1063293,인천,1337,1334,3,17000,2022-05-19 09:07:43.78,null
1630,1306,744550,대구,1462,1461,1,16999,2022-05-19 09:07:43.779,null
1631,2115,1082480,부산,1261,1261,0,16998,2022-05-19 09:07:43.779,null
1632,4777,3582481,서울,4557,4557,0,16997,2022-05-19 09:07:43.779,null
1633,23842,17889849,합계,28130,28115,15,16996,2022-05-19 09:07:43.779,null
1634,16,11107,검역,4,0,4,16995,2022-05-18 09:01:44.404,null
1635,174,230921,제주,442,442,0,16994,2022-05-18 09:01:44.404,null
1636,1210,1072890,경남,1929,1926,3,16993,2022-05-18 09:01:44.404,null
1637,1331,757623,경북,2279,2274,5,16992,2022-05-18 09:01:44.404,null
1638,433,584658,전남,1209,1208,1,16991,2022-05-18 09:01:44.403,null
1639,856,588120,전북,1250,1246,4,16990,2022-05-18 09:01:44.403,null
1640,942,701936,충남,1469,1468,1,16989,2022-05-18 09:01:44.403,null
1641,714,544862,충북,1107,1106,1,16988,2022-05-18 09:01:44.403,null
1642,818,503982,강원,1358,1358,0,16987,2022-05-18 09:01:44.403,null
1643,6150,4868644,경기,7779,7777,2,16986,2022-05-18 09:01:44.402,null
1644,35,136099,세종,297,297,0,16985,2022-05-18 09:01:44.402,null
1645,335,370681,울산,856,856,0,16984,2022-05-18 09:01:44.402,null
1646,675,501851,대전,1026,1026,0,16983,2022-05-18 09:01:44.402,null
1647,549,524173,광주,901,900,1,16982,2022-05-18 09:01:44.401,null
1648,1376,1061957,인천,1395,1387,8,16981,2022-05-18 09:01:44.401,null
1649,1305,743090,대구,1528,1527,1,16980,2022-05-18 09:01:44.401,null
1650,2113,1081220,부산,1480,1479,1,16979,2022-05-18 09:01:44.401,null
1651,4770,3577930,서울,5043,5040,3,16978,2022-05-18 09:01:44.401,null
1652,23802,17861744,합계,31352,31317,35,16977,2022-05-18 09:01:44.4,null
1653,16,11103,검역,6,0,6,16976,2022-05-17 09:07:08.551,null
1654,174,230479,제주,308,308,0,16975,2022-05-17 09:07:08.551,null
1655,1208,1070963,경남,2281,2280,1,16974,2022-05-17 09:07:08.55,null
1656,1326,755344,경북,1990,1989,1,16973,2022-05-17 09:07:08.55,null
1657,432,583449,전남,1255,1255,0,16972,2022-05-17 09:07:08.55,null
1658,856,586871,전북,1371,1369,2,16971,2022-05-17 09:07:08.55,null
1659,941,700467,충남,1543,1543,0,16970,2022-05-17 09:07:08.549,null
1660,713,543757,충북,1189,1186,3,16969,2022-05-17 09:07:08.549,null
1661,816,502624,강원,1375,1374,1,16968,2022-05-17 09:07:08.549,null
1662,6144,4860892,경기,9090,9090,0,16967,2022-05-17 09:07:08.549,null
1663,35,135802,세종,294,294,0,16966,2022-05-17 09:07:08.548,null
1664,334,369825,울산,834,834,0,16965,2022-05-17 09:07:08.548,null
1665,675,500825,대전,1077,1075,2,16964,2022-05-17 09:07:08.548,null
1666,549,523272,광주,881,881,0,16963,2022-05-17 09:07:08.548,null
1667,1374,1060562,인천,1725,1715,10,16962,2022-05-17 09:07:08.548,null
1668,1303,741562,대구,2095,2095,0,16961,2022-05-17 09:07:08.547,null
1669,2110,1079744,부산,1914,1914,0,16960,2022-05-17 09:07:08.547,null
1670,4765,3572888,서울,5889,5889,0,16959,2022-05-17 09:07:08.547,null
1671,23771,17830429,합계,35117,35091,26,16958,2022-05-17 09:07:08.547,null
1672,16,11097,검역,9,0,9,16957,2022-05-16 09:06:42.795,null
1673,174,230171,제주,243,243,0,16956,2022-05-16 09:06:42.795,null
1674,1207,1068682,경남,780,778,2,16955,2022-05-16 09:06:42.794,null
1675,1323,753354,경북,1006,1003,3,16954,2022-05-16 09:06:42.794,null
1676,431,582195,전남,505,503,2,16953,2022-05-16 09:06:42.794,null
1677,856,585501,전북,586,585,1,16952,2022-05-16 09:06:42.794,null
1678,940,698924,충남,638,638,0,16951,2022-05-16 09:06:42.793,null
1679,711,542569,충북,453,452,1,16950,2022-05-16 09:06:42.793,null
1680,815,501249,강원,587,584,3,16949,2022-05-16 09:06:42.793,null
1681,6134,4851821,경기,3576,3576,0,16948,2022-05-16 09:06:42.793,null
1682,35,135509,세종,160,160,0,16947,2022-05-16 09:06:42.793,null
1683,334,368991,울산,320,320,0,16946,2022-05-16 09:06:42.792,null
1684,675,499748,대전,462,457,5,16945,2022-05-16 09:06:42.792,null
1685,548,522391,광주,642,642,0,16944,2022-05-16 09:06:42.792,null
1686,1372,1058838,인천,607,605,2,16943,2022-05-16 09:06:42.792,null
1687,1303,739467,대구,564,564,0,16942,2022-05-16 09:06:42.791,null
1688,2108,1077834,부산,474,474,0,16941,2022-05-16 09:06:42.791,null
1689,4762,3567016,서울,1684,1684,0,16940,2022-05-16 09:06:42.791,null
1690,23744,17795357,합계,13296,13268,28,16939,2022-05-16 09:06:42.791,null
1691,16,11088,검역,5,0,5,16938,2022-05-15 09:36:37.906,null
1692,173,229928,제주,366,366,0,16937,2022-05-15 09:36:37.905,null
1693,1206,1067902,경남,1734,1734,0,16936,2022-05-15 09:36:37.905,null
1694,1321,752348,경북,1879,1875,4,16935,2022-05-15 09:36:37.905,null
1695,430,581690,전남,1125,1125,0,16934,2022-05-15 09:36:37.905,null
1696,856,584915,전북,1131,1129,2,16933,2022-05-15 09:36:37.904,null
1697,939,698286,충남,1250,1250,0,16932,2022-05-15 09:36:37.904,null
1698,711,542116,충북,1053,1051,2,16931,2022-05-15 09:36:37.904,null
1699,815,500662,강원,963,962,1,16930,2022-05-15 09:36:37.904,null
1700,6123,4848245,경기,5800,5799,1,16929,2022-05-15 09:36:37.904,null
1701,35,135349,세종,228,228,0,16928,2022-05-15 09:36:37.903,null
1702,334,368671,울산,767,767,0,16927,2022-05-15 09:36:37.903,null
1703,670,499286,대전,923,923,0,16926,2022-05-15 09:36:37.903,null
1704,548,521749,광주,696,693,3,16925,2022-05-15 09:36:37.902,null
1705,1368,1058231,인천,1158,1150,8,16924,2022-05-15 09:36:37.902,null
1706,1302,738903,대구,1304,1304,0,16923,2022-05-15 09:36:37.901,null
1707,2105,1077360,부산,1027,1027,0,16922,2022-05-15 09:36:37.901,null
1708,4757,3565332,서울,4025,4025,0,16921,2022-05-15 09:36:37.9,null
1709,23709,17782061,합계,25434,25408,26,16920,2022-05-15 09:36:37.899,null
1710,16,11083,검역,3,0,3,16919,2022-05-14 10:15:34.969,null
1711,172,229562,제주,405,405,0,16918,2022-05-14 10:15:34.969,null
1712,1205,1066168,경남,1959,1957,2,16917,2022-05-14 10:15:34.969,null
1713,1316,750469,경북,2107,2104,3,16916,2022-05-14 10:15:34.969,null
1714,430,580565,전남,1234,1234,0,16915,2022-05-14 10:15:34.968,null
1715,855,583784,전북,1205,1204,1,16914,2022-05-14 10:15:34.968,null
1716,936,697036,충남,1283,1282,1,16913,2022-05-14 10:15:34.968,null
1717,709,541063,충북,1086,1081,5,16912,2022-05-14 10:15:34.968,null
1718,811,499699,강원,1155,1155,0,16911,2022-05-14 10:15:34.968,null
1719,6113,4842445,경기,6982,6980,2,16910,2022-05-14 10:15:34.967,null
1720,35,135121,세종,272,272,0,16909,2022-05-14 10:15:34.967,null
1721,334,367904,울산,781,781,0,16908,2022-05-14 10:15:34.967,null
1722,669,498363,대전,890,888,2,16907,2022-05-14 10:15:34.967,null
1723,547,521053,광주,986,986,0,16906,2022-05-14 10:15:34.967,null
1724,1367,1057073,인천,1413,1407,6,16905,2022-05-14 10:15:34.966,null
1725,1297,737599,대구,1516,1516,0,16904,2022-05-14 10:15:34.966,null
1726,2104,1076333,부산,1540,1540,0,16903,2022-05-14 10:15:34.966,null
1727,4745,3561307,서울,4764,4764,0,16902,2022-05-14 10:15:34.966,null
1728,23661,17756627,합계,29581,29556,25,16901,2022-05-14 10:15:34.965,null
1729,16,11080,검역,3,0,3,16900,2022-05-13 09:11:44.357,null
1730,171,229157,제주,469,469,0,16899,2022-05-13 09:11:44.357,null
1731,1205,1064209,경남,2082,2081,1,16898,2022-05-13 09:11:44.357,null
1732,1310,748362,경북,2284,2283,1,16897,2022-05-13 09:11:44.357,null
1733,429,579331,전남,1394,1394,0,16896,2022-05-13 09:11:44.356,null
1734,854,582580,전북,1402,1400,2,16895,2022-05-13 09:11:44.356,null
1735,935,695753,충남,1397,1397,0,16894,2022-05-13 09:11:44.356,null
1736,707,539978,충북,1121,1120,1,16893,2022-05-13 09:11:44.356,null
1737,809,498544,강원,1194,1193,1,16892,2022-05-13 09:11:44.356,null
1738,6101,4835488,경기,7763,7762,1,16891,2022-05-13 09:11:44.355,null
1739,35,134850,세종,280,280,0,16890,2022-05-13 09:11:44.355,null
1740,334,367124,울산,816,816,0,16889,2022-05-13 09:11:44.355,null
1741,665,497479,대전,1058,1055,3,16888,2022-05-13 09:11:44.355,null
1742,545,520067,광주,1099,1097,2,16887,2022-05-13 09:11:44.354,null
1743,1365,1055660,인천,1513,1513,0,16886,2022-05-13 09:11:44.354,null
1744,1296,736086,대구,1796,1796,0,16885,2022-05-13 09:11:44.354,null
1745,2101,1074793,부산,1602,1602,0,16884,2022-05-13 09:11:44.354,null
1746,4728,3556545,서울,5178,5178,0,16883,2022-05-13 09:11:44.353,null
1747,23606,17727086,합계,32451,32436,15,16882,2022-05-13 09:11:44.353,null
1748,16,11077,검역,4,0,4,16881,2022-05-12 09:07:15.763,null
1749,171,228698,제주,465,465,0,16880,2022-05-12 09:07:15.763,null
1750,1201,1062127,경남,2259,2258,1,16879,2022-05-12 09:07:15.763,null
1751,1305,746078,경북,2629,2627,2,16878,2022-05-12 09:07:15.763,null
1752,427,577938,전남,1486,1486,0,16877,2022-05-12 09:07:15.762,null
1753,853,581178,전북,1465,1464,1,16876,2022-05-12 09:07:15.762,null
1754,931,694365,충남,1605,1605,0,16875,2022-05-12 09:07:15.762,null
1755,705,538858,충북,1400,1398,2,16874,2022-05-12 09:07:15.762,null
1756,806,497352,강원,1322,1322,0,16873,2022-05-12 09:07:15.761,null
1757,6092,4827730,경기,8392,8392,0,16872,2022-05-12 09:07:15.761,null
1758,35,134571,세종,331,331,0,16871,2022-05-12 09:07:15.761,null
1759,333,366309,울산,965,965,0,16870,2022-05-12 09:07:15.761,null
1760,663,496421,대전,1283,1282,1,16869,2022-05-12 09:07:15.761,null
1761,544,518968,광주,1291,1291,0,16868,2022-05-12 09:07:15.76,null
1762,1364,1054147,인천,1684,1683,1,16867,2022-05-12 09:07:15.76,null
1763,1295,734292,대구,1888,1888,0,16866,2022-05-12 09:07:15.76,null
1764,2099,1073193,부산,1742,1742,0,16865,2022-05-12 09:07:15.76,null
1765,4714,3551375,서울,5695,5695,0,16864,2022-05-12 09:07:15.759,null
1766,23554,17694677,합계,35906,35894,12,16863,2022-05-12 09:07:15.759,null
1767,16,11073,검역,4,0,4,16862,2022-05-11 09:04:22.765,null
1768,171,228233,제주,710,710,0,16861,2022-05-11 09:04:22.765,null
1769,1198,1059870,경남,2794,2788,6,16860,2022-05-11 09:04:22.764,null
1770,1302,743450,경북,3335,3334,1,16859,2022-05-11 09:04:22.764,null
1771,425,576452,전남,1875,1874,1,16858,2022-05-11 09:04:22.764,null
1772,852,579714,전북,1961,1961,0,16857,2022-05-11 09:04:22.764,null
1773,930,692762,충남,2086,2084,2,16856,2022-05-11 09:04:22.763,null
1774,699,537462,충북,1677,1675,2,16855,2022-05-11 09:04:22.763,null
1775,801,496032,강원,1638,1636,2,16854,2022-05-11 09:04:22.763,null
1776,6078,4819342,경기,10504,10503,1,16853,2022-05-11 09:04:22.763,null
1777,35,134240,세종,371,371,0,16852,2022-05-11 09:04:22.763,null
1778,332,365344,울산,1258,1258,0,16851,2022-05-11 09:04:22.762,null
1779,657,495138,대전,1431,1430,1,16850,2022-05-11 09:04:22.762,null
1780,542,517677,광주,1678,1675,3,16849,2022-05-11 09:04:22.762,null
1781,1361,1052463,인천,2175,2162,13,16848,2022-05-11 09:04:22.762,null
1782,1292,732404,대구,2223,2223,0,16847,2022-05-11 09:04:22.761,null
1783,2092,1071453,부산,1997,1997,0,16846,2022-05-11 09:04:22.761,null
1784,4708,3545685,서울,6208,6207,1,16845,2022-05-11 09:04:22.761,null
1785,23491,17658794,합계,43925,43888,37,16844,2022-05-11 09:04:22.76,null
1786,16,11069,검역,2,0,2,16843,2022-05-10 09:03:15.975,null
1787,171,227524,제주,405,405,0,16842,2022-05-10 09:03:15.975,null
1788,1198,1057078,경남,3319,3318,1,16841,2022-05-10 09:03:15.975,null
1789,1300,740115,경북,2835,2833,2,16840,2022-05-10 09:03:15.975,null
1790,423,574579,전남,2303,2302,1,16839,2022-05-10 09:03:15.974,null
1791,848,577755,전북,2275,2272,3,16838,2022-05-10 09:03:15.974,null
1792,929,690676,충남,2268,2267,1,16837,2022-05-10 09:03:15.974,null
1793,695,535786,충북,1793,1791,2,16836,2022-05-10 09:03:15.974,null
1794,800,494394,강원,1828,1828,0,16835,2022-05-10 09:03:15.974,null
1795,6071,4808841,경기,11334,11334,0,16834,2022-05-10 09:03:15.973,null
1796,35,133869,세종,466,466,0,16833,2022-05-10 09:03:15.973,null
1797,332,364086,울산,1321,1321,0,16832,2022-05-10 09:03:15.973,null
1798,657,493707,대전,1547,1541,6,16831,2022-05-10 09:03:15.972,null
1799,541,515999,광주,1523,1523,0,16830,2022-05-10 09:03:15.972,null
1800,1361,1050289,인천,2555,2550,5,16829,2022-05-10 09:03:15.972,null
1801,1292,730186,대구,3245,3245,0,16828,2022-05-10 09:03:15.972,null
1802,2089,1069459,부산,2772,2772,0,16827,2022-05-10 09:03:15.971,null
1803,4704,3539483,서울,8142,8142,0,16826,2022-05-10 09:03:15.971,null
1804,23462,17614895,합계,49933,49910,23,16825,2022-05-10 09:03:15.971,null
1805,16,11067,검역,8,0,8,16824,2022-05-09 09:06:49.181,null
1806,170,227120,제주,429,429,0,16823,2022-05-09 09:06:49.181,null
1807,1194,1053759,경남,1375,1372,3,16822,2022-05-09 09:06:49.181,null
1808,1297,737282,경북,1555,1554,1,16821,2022-05-09 09:06:49.18,null
1809,422,572276,전남,904,904,0,16820,2022-05-09 09:06:49.18,null
1810,846,575480,전북,787,785,2,16819,2022-05-09 09:06:49.18,null
1811,929,688416,충남,906,906,0,16818,2022-05-09 09:06:49.18,null
1812,693,533996,충북,701,699,2,16817,2022-05-09 09:06:49.179,null
1813,794,492567,강원,808,808,0,16816,2022-05-09 09:06:49.179,null
1814,6053,4797513,경기,5487,5485,2,16815,2022-05-09 09:06:49.179,null
1815,35,133403,세종,152,152,0,16814,2022-05-09 09:06:49.179,null
1816,332,362766,울산,474,474,0,16813,2022-05-09 09:06:49.179,null
1817,652,492160,대전,778,778,0,16812,2022-05-09 09:06:49.178,null
1818,540,514476,광주,912,911,1,16811,2022-05-09 09:06:49.178,null
1819,1359,1047734,인천,922,922,0,16810,2022-05-09 09:06:49.178,null
1820,1289,726941,대구,972,972,0,16809,2022-05-09 09:06:49.178,null
1821,2088,1066692,부산,716,716,0,16808,2022-05-09 09:06:49.177,null
1822,4691,3531351,서울,2715,2715,0,16807,2022-05-09 09:06:49.177,null
1823,23400,17564999,합계,20601,20582,19,16806,2022-05-09 09:06:49.177,null
1824,16,11059,검역,4,0,4,16805,2022-05-08 09:03:00.809,null
1825,170,226691,제주,697,696,1,16804,2022-05-08 09:03:00.809,null
1826,1191,1052384,경남,2782,2782,0,16803,2022-05-08 09:03:00.808,null
1827,1295,735727,경북,2964,2961,3,16802,2022-05-08 09:03:00.808,null
1828,421,571372,전남,1900,1900,0,16801,2022-05-08 09:03:00.808,null
1829,845,574693,전북,2006,2003,3,16800,2022-05-08 09:03:00.808,null
1830,928,687510,충남,1747,1747,0,16799,2022-05-08 09:03:00.807,null
1831,692,533295,충북,1596,1596,0,16798,2022-05-08 09:03:00.807,null
1832,793,491759,강원,1431,1431,0,16797,2022-05-08 09:03:00.807,null
1833,6034,4792026,경기,8553,8553,0,16796,2022-05-08 09:03:00.807,null
1834,35,133251,세종,307,307,0,16795,2022-05-08 09:03:00.807,null
1835,332,362292,울산,1118,1118,0,16794,2022-05-08 09:03:00.806,null
1836,650,491382,대전,1449,1445,4,16793,2022-05-08 09:03:00.806,null
1837,540,513564,광주,1597,1596,1,16792,2022-05-08 09:03:00.806,null
1838,1357,1046812,인천,1708,1708,0,16791,2022-05-08 09:03:00.806,null
1839,1289,725969,대구,2421,2421,0,16790,2022-05-08 09:03:00.805,null
1840,2083,1065976,부산,1805,1805,0,16789,2022-05-08 09:03:00.805,null
1841,4689,3528636,서울,5979,5979,0,16788,2022-05-08 09:03:00.805,null
1842,23360,17544398,합계,40064,40048,16,16787,2022-05-08 09:03:00.805,null
1843,16,11055,검역,6,0,6,16786,2022-05-07 09:21:47.86,null
1844,170,225994,제주,339,339,0,16785,2022-05-07 09:21:47.86,null
1845,1191,1049602,경남,2517,2516,1,16784,2022-05-07 09:21:47.86,null
1846,1293,732763,경북,2454,2450,4,16783,2022-05-07 09:21:47.86,null
1847,419,569472,전남,1914,1914,0,16782,2022-05-07 09:21:47.86,null
1848,844,572687,전북,1583,1582,1,16781,2022-05-07 09:21:47.859,null
1849,925,685763,충남,1772,1771,1,16780,2022-05-07 09:21:47.859,null
1850,690,531699,충북,1357,1357,0,16779,2022-05-07 09:21:47.859,null
1851,793,490328,강원,1487,1486,1,16778,2022-05-07 09:21:47.859,null
1852,5998,4783473,경기,9444,9444,0,16777,2022-05-07 09:21:47.858,null
1853,34,132944,세종,297,297,0,16776,2022-05-07 09:21:47.858,null
1854,332,361174,울산,879,879,0,16775,2022-05-07 09:21:47.858,null
1855,649,489933,대전,1309,1309,0,16774,2022-05-07 09:21:47.858,null
1856,539,511967,광주,988,988,0,16773,2022-05-07 09:21:47.858,null
1857,1355,1045104,인천,2021,2011,10,16772,2022-05-07 09:21:47.857,null
1858,1289,723548,대구,2314,2314,0,16771,2022-05-07 09:21:47.857,null
1859,2076,1064171,부산,2278,2278,0,16770,2022-05-07 09:21:47.857,null
1860,4676,3522657,서울,6641,6639,2,16769,2022-05-07 09:21:47.857,null
1861,23289,17504334,합계,39600,39574,26,16768,2022-05-07 09:21:47.856,null
1862,16,11049,검역,2,0,2,16767,2022-05-06 08:08:23.9,null
1863,170,225685,제주,571,571,0,16766,2022-05-06 08:08:23.899,null
1864,1189,1047085,경남,1653,1653,0,16765,2022-05-06 08:08:23.899,null
1865,1282,730310,경북,2397,2393,4,16764,2022-05-06 08:08:23.899,null
1866,415,567561,전남,1298,1298,0,16763,2022-05-06 08:08:23.899,null
1867,843,571104,전북,1191,1189,2,16762,2022-05-06 08:08:23.898,null
1868,923,683992,충남,1195,1195,0,16761,2022-05-06 08:08:23.898,null
1869,689,530344,충북,1127,1120,7,16760,2022-05-06 08:08:23.898,null
1870,786,488842,강원,959,959,0,16759,2022-05-06 08:08:23.898,null
1871,5979,4774034,경기,6168,6168,0,16758,2022-05-06 08:08:23.897,null
1872,34,132648,세종,221,221,0,16757,2022-05-06 08:08:23.897,null
1873,332,360295,울산,700,700,0,16756,2022-05-06 08:08:23.897,null
1874,646,488624,대전,1073,1072,1,16755,2022-05-06 08:08:23.897,null
1875,539,510979,광주,1221,1220,1,16754,2022-05-06 08:08:23.897,null
1876,1352,1043084,인천,1164,1153,11,16753,2022-05-06 08:08:23.896,null
1877,1287,721235,대구,1312,1312,0,16752,2022-05-06 08:08:23.896,null
1878,2074,1061894,부산,866,866,0,16751,2022-05-06 08:08:23.896,null
1879,4650,3516017,서울,3596,3596,0,16750,2022-05-06 08:08:23.896,null
1880,23206,17464782,합계,26714,26686,28,16749,2022-05-06 08:08:23.895,null
1881,16,11047,검역,10,0,10,16748,2022-05-05 09:26:44.678,null
1882,170,225114,제주,577,577,0,16747,2022-05-05 09:26:44.678,null
1883,1186,1045432,경남,2607,2606,1,16746,2022-05-05 09:26:44.678,null
1884,1279,727913,경북,2938,2938,0,16745,2022-05-05 09:26:44.678,null
1885,412,566263,전남,1927,1926,1,16744,2022-05-05 09:26:44.678,null
1886,838,569913,전북,1753,1752,1,16743,2022-05-05 09:26:44.677,null
1887,920,682797,충남,1923,1923,0,16742,2022-05-05 09:26:44.677,null
1888,683,529217,충북,1507,1505,2,16741,2022-05-05 09:26:44.677,null
1889,781,487883,강원,1626,1622,4,16740,2022-05-05 09:26:44.677,null
1890,5973,4767866,경기,10242,10242,0,16739,2022-05-05 09:26:44.677,null
1891,34,132427,세종,356,356,0,16738,2022-05-05 09:26:44.676,null
1892,332,359595,울산,1043,1043,0,16737,2022-05-05 09:26:44.676,null
1893,646,487551,대전,1462,1462,0,16736,2022-05-05 09:26:44.676,null
1894,539,509758,광주,1450,1449,1,16735,2022-05-05 09:26:44.676,null
1895,1351,1041920,인천,2017,2015,2,16734,2022-05-05 09:26:44.676,null
1896,1285,719923,대구,2166,2165,1,16733,2022-05-05 09:26:44.675,null
1897,2070,1061028,부산,2047,2047,0,16732,2022-05-05 09:26:44.675,null
1898,4643,3512421,서울,6645,6645,0,16731,2022-05-05 09:26:44.675,null
1899,23158,17438068,합계,42296,42273,23,16730,2022-05-05 09:26:44.675,null
1900,16,11037,검역,6,0,6,16729,2022-05-04 09:14:45.581,null
1901,168,224538,제주,729,728,1,16728,2022-05-04 09:14:45.581,null
1902,1183,1042825,경남,3094,3092,2,16727,2022-05-04 09:14:45.58,null
1903,1271,724977,경북,3794,3794,0,16726,2022-05-04 09:14:45.58,null
1904,410,564337,전남,2348,2346,2,16725,2022-05-04 09:14:45.58,null
1905,834,568160,전북,2074,2069,5,16724,2022-05-04 09:14:45.58,null
1906,916,680874,충남,2261,2261,0,16723,2022-05-04 09:14:45.58,null
1907,680,527710,충북,1880,1874,6,16722,2022-05-04 09:14:45.579,null
1908,779,486257,강원,1861,1860,1,16721,2022-05-04 09:14:45.579,null
1909,5955,4757630,경기,11671,11670,1,16720,2022-05-04 09:14:45.579,null
1910,34,132071,세종,412,412,0,16719,2022-05-04 09:14:45.579,null
1911,330,358552,울산,1119,1119,0,16718,2022-05-04 09:14:45.578,null
1912,646,486089,대전,1714,1714,0,16717,2022-05-04 09:14:45.578,null
1913,538,508308,광주,1843,1839,4,16716,2022-05-04 09:14:45.578,null
1914,1347,1039906,인천,2167,2166,1,16715,2022-05-04 09:14:45.578,null
1915,1282,717758,대구,2484,2484,0,16714,2022-05-04 09:14:45.578,null
1916,2064,1058982,부산,2171,2171,0,16713,2022-05-04 09:14:45.577,null
1917,4626,3505780,서울,7436,7436,0,16712,2022-05-04 09:14:45.577,null
1918,23079,17395791,합계,49064,49035,29,16711,2022-05-04 09:14:45.577,null
1919,16,11032,검역,11,0,11,16710,2022-05-03 09:11:59.196,null
1920,166,223809,제주,391,391,0,16709,2022-05-03 09:11:59.196,null
1921,1181,1039734,경남,3620,3619,1,16708,2022-05-03 09:11:59.195,null
1922,1268,721187,경북,2821,2820,1,16707,2022-05-03 09:11:59.195,null
1923,409,561989,전남,2550,2550,0,16706,2022-05-03 09:11:59.195,null
1924,832,566088,전북,1941,1939,2,16705,2022-05-03 09:11:59.195,null
1925,914,678613,충남,2411,2411,0,16704,2022-05-03 09:11:59.194,null
1926,677,525834,충북,1764,1764,0,16703,2022-05-03 09:11:59.194,null
1927,772,484398,강원,1781,1780,1,16702,2022-05-03 09:11:59.194,null
1928,5934,4745966,경기,11740,11737,3,16701,2022-05-03 09:11:59.194,null
1929,34,131659,세종,370,370,0,16700,2022-05-03 09:11:59.193,null
1930,327,357433,울산,1195,1195,0,16699,2022-05-03 09:11:59.193,null
1931,643,484375,대전,1666,1663,3,16698,2022-05-03 09:11:59.193,null
1932,534,506466,광주,1437,1435,2,16697,2022-05-03 09:11:59.193,null
1933,1346,1037739,인천,2608,2587,21,16696,2022-05-03 09:11:59.193,null
1934,1277,715274,대구,3246,3246,0,16695,2022-05-03 09:11:59.192,null
1935,2063,1056811,부산,2870,2870,0,16694,2022-05-03 09:11:59.192,null
1936,4614,3498346,서울,8709,8709,0,16693,2022-05-03 09:11:59.192,null
1937,23007,17346753,합계,51131,51086,45,16692,2022-05-03 09:11:59.191,null
1938,16,11021,검역,7,0,7,16691,2022-05-02 09:01:56.401,null
1939,166,223419,제주,433,432,1,16690,2022-05-02 09:01:56.401,null
1940,1177,1036114,경남,1185,1185,0,16689,2022-05-02 09:01:56.401,null
1941,1266,718368,경북,1514,1513,1,16688,2022-05-02 09:01:56.4,null
1942,408,559441,전남,995,995,0,16687,2022-05-02 09:01:56.4,null
1943,831,564148,전북,926,919,7,16686,2022-05-02 09:01:56.4,null
1944,911,676205,충남,878,878,0,16685,2022-05-02 09:01:56.4,null
1945,675,524071,충북,705,701,4,16684,2022-05-02 09:01:56.399,null
1946,771,482619,강원,753,752,1,16683,2022-05-02 09:01:56.399,null
1947,5916,4734258,경기,5341,5341,0,16682,2022-05-02 09:01:56.398,null
1948,34,131289,세종,254,254,0,16681,2022-05-02 09:01:56.398,null
1949,327,356239,울산,411,411,0,16680,2022-05-02 09:01:56.397,null
1950,641,482709,대전,675,674,1,16679,2022-05-02 09:01:56.397,null
1951,533,505029,광주,886,886,0,16678,2022-05-02 09:01:56.397,null
1952,1344,1035133,인천,911,908,3,16677,2022-05-02 09:01:56.397,null
1953,1272,712031,대구,864,863,1,16676,2022-05-02 09:01:56.396,null
1954,2059,1053943,부산,693,693,0,16675,2022-05-02 09:01:56.396,null
1955,4611,3489696,서울,2653,2653,0,16674,2022-05-02 09:01:56.396,null
1956,22958,17295733,합계,20084,20058,26,16673,2022-05-02 09:01:56.396,null
1957,16,11014,검역,5,0,5,16672,2022-05-01 09:15:43.207,null
1958,165,222986,제주,577,577,0,16671,2022-05-01 09:15:43.207,null
1959,1173,1034929,경남,2486,2482,4,16670,2022-05-01 09:15:43.206,null
1960,1249,716854,경북,2671,2663,8,16669,2022-05-01 09:15:43.206,null
1961,405,558446,전남,1962,1961,1,16668,2022-05-01 09:15:43.206,null
1962,827,563222,전북,1742,1739,3,16667,2022-05-01 09:15:43.206,null
1963,910,675327,충남,1821,1821,0,16666,2022-05-01 09:15:43.205,null
1964,675,523366,충북,1592,1591,1,16665,2022-05-01 09:15:43.205,null
1965,766,481866,강원,1401,1401,0,16664,2022-05-01 09:15:43.205,null
1966,5897,4728917,경기,8575,8575,0,16663,2022-05-01 09:15:43.205,null
1967,34,131035,세종,360,360,0,16662,2022-05-01 09:15:43.205,null
1968,326,355828,울산,1050,1050,0,16661,2022-05-01 09:15:43.204,null
1969,635,482034,대전,1337,1337,0,16660,2022-05-01 09:15:43.204,null
1970,531,504143,광주,1300,1293,7,16659,2022-05-01 09:15:43.204,null
1971,1338,1034222,인천,1760,1759,1,16658,2022-05-01 09:15:43.204,null
1972,1272,711167,대구,2035,2035,0,16657,2022-05-01 09:15:43.203,null
1973,2054,1053250,부산,1635,1635,0,16656,2022-05-01 09:15:43.203,null
1974,4602,3487043,서울,5462,5462,0,16655,2022-05-01 09:15:43.203,null
1975,22875,17275649,합계,37771,37741,30,16654,2022-05-01 09:15:43.203,null
1976,16,11009,검역,4,0,4,16653,2022-04-30 09:18:30.802,null
1977,164,222409,제주,783,783,0,16652,2022-04-30 09:18:30.802,null
1978,1171,1032443,경남,2717,2715,2,16651,2022-04-30 09:18:30.802,null
1979,1242,714183,경북,2868,2865,3,16650,2022-04-30 09:18:30.802,null
1980,402,556484,전남,2263,2262,1,16649,2022-04-30 09:18:30.801,null
1981,822,561480,전북,1998,1998,0,16648,2022-04-30 09:18:30.801,null
1982,901,673506,충남,1943,1943,0,16647,2022-04-30 09:18:30.801,null
1983,673,521774,충북,1471,1471,0,16646,2022-04-30 09:18:30.801,null
1984,765,480465,강원,1644,1644,0,16645,2022-04-30 09:18:30.801,null
1985,5877,4720342,경기,10343,10342,1,16644,2022-04-30 09:18:30.8,null
1986,34,130675,세종,382,382,0,16643,2022-04-30 09:18:30.8,null
1987,325,354778,울산,995,995,0,16642,2022-04-30 09:18:30.8,null
1988,631,480697,대전,1458,1457,1,16641,2022-04-30 09:18:30.8,null
1989,530,502843,광주,1655,1655,0,16640,2022-04-30 09:18:30.799,null
1990,1333,1032462,인천,1960,1960,0,16639,2022-04-30 09:18:30.799,null
1991,1271,709132,대구,2316,2316,0,16638,2022-04-30 09:18:30.799,null
1992,2051,1051615,부산,2031,2031,0,16637,2022-04-30 09:18:30.799,null
1993,4586,3481581,서울,6455,6455,0,16636,2022-04-30 09:18:30.798,null
1994,22794,17237878,합계,43286,43274,12,16635,2022-04-30 09:18:30.798,null
1995,16,11005,검역,4,0,4,16634,2022-04-29 09:07:01.224,null
1996,163,221628,제주,752,752,0,16633,2022-04-29 09:07:01.224,null
1997,1167,1029726,경남,3240,3240,0,16632,2022-04-29 09:07:01.223,null
1998,1240,711315,경북,3552,3545,7,16631,2022-04-29 09:07:01.223,null
1999,400,554221,전남,2565,2565,0,16630,2022-04-29 09:07:01.223,null
2000,820,559483,전북,2412,2411,1,16629,2022-04-29 09:07:01.223,null
2001,894,671565,충남,2325,2325,0,16628,2022-04-29 09:07:01.223,null
2002,672,520303,충북,1974,1974,0,16627,2022-04-29 09:07:01.222,null
2003,762,478821,강원,1840,1838,2,16626,2022-04-29 09:07:01.222,null
2004,5860,4710003,경기,12046,12045,1,16625,2022-04-29 09:07:01.222,null
2005,34,130293,세종,343,343,0,16624,2022-04-29 09:07:01.222,null
2006,324,353783,울산,1141,1141,0,16623,2022-04-29 09:07:01.222,null
2007,625,479245,대전,1733,1730,3,16622,2022-04-29 09:07:01.221,null
2008,530,501190,광주,1900,1898,2,16621,2022-04-29 09:07:01.221,null
2009,1329,1030503,인천,2254,2246,8,16620,2022-04-29 09:07:01.221,null
2010,1268,706817,대구,2507,2507,0,16619,2022-04-29 09:07:01.22,null
2011,2046,1049589,부산,2254,2254,0,16618,2022-04-29 09:07:01.22,null
2012,4574,3475126,서울,7726,7724,2,16617,2022-04-29 09:07:01.22,null
2013,22724,17194616,합계,50568,50538,30,16616,2022-04-29 09:07:01.22,null
2014,16,11001,검역,15,0,15,16615,2022-04-28 09:05:48.858,null
2015,160,220876,제주,846,846,0,16614,2022-04-28 09:05:48.858,null
2016,1159,1026487,경남,3728,3726,2,16613,2022-04-28 09:05:48.857,null
2017,1232,707764,경북,3979,3979,0,16612,2022-04-28 09:05:48.857,null
2018,395,551656,전남,2571,2571,0,16611,2022-04-28 09:05:48.857,null
2019,815,557072,전북,2654,2654,0,16610,2022-04-28 09:05:48.857,null
2020,881,669240,충남,2672,2672,0,16609,2022-04-28 09:05:48.856,null
2021,668,518330,충북,2025,2022,3,16608,2022-04-28 09:05:48.856,null
2022,760,476981,강원,2196,2196,0,16607,2022-04-28 09:05:48.856,null
2023,5820,4697965,경기,13657,13657,0,16606,2022-04-28 09:05:48.856,null
2024,34,129950,세종,425,425,0,16605,2022-04-28 09:05:48.855,null
2025,323,352643,울산,1389,1389,0,16604,2022-04-28 09:05:48.855,null
2026,622,477512,대전,1999,1999,0,16603,2022-04-28 09:05:48.855,null
2027,526,499290,광주,2071,2070,1,16602,2022-04-28 09:05:48.855,null
2028,1320,1028249,인천,2845,2845,0,16601,2022-04-28 09:05:48.854,null
2029,1266,704311,대구,2838,2838,0,16600,2022-04-28 09:05:48.854,null
2030,2038,1047336,부산,2445,2445,0,16599,2022-04-28 09:05:48.854,null
2031,4553,3467402,서울,9109,9109,0,16598,2022-04-28 09:05:48.854,null
2032,22588,17144065,합계,57464,57443,21,16597,2022-04-28 09:05:48.853,null
2033,16,10986,검역,10,0,10,16596,2022-04-27 09:04:04.213,null
2034,160,220031,제주,1237,1237,0,16595,2022-04-27 09:04:04.212,null
2035,1148,1022759,경남,4653,4649,4,16594,2022-04-27 09:04:04.212,null
2036,1225,703785,경북,5418,5413,5,16593,2022-04-27 09:04:04.212,null
2037,390,549086,전남,3635,3634,1,16592,2022-04-27 09:04:04.212,null
2038,809,554418,전북,3935,3932,3,16591,2022-04-27 09:04:04.211,null
2039,876,666569,충남,3692,3692,0,16590,2022-04-27 09:04:04.211,null
2040,666,516306,충북,2926,2924,2,16589,2022-04-27 09:04:04.211,null
2041,756,474786,강원,2956,2955,1,16588,2022-04-27 09:04:04.211,null
2042,5785,4684310,경기,18424,18415,9,16587,2022-04-27 09:04:04.21,null
2043,34,129525,세종,589,589,0,16586,2022-04-27 09:04:04.21,null
2044,323,351254,울산,1772,1772,0,16585,2022-04-27 09:04:04.21,null
2045,618,475513,대전,2720,2719,1,16584,2022-04-27 09:04:04.21,null
2046,526,497219,광주,3054,3053,1,16583,2022-04-27 09:04:04.21,null
2047,1316,1025404,인천,3624,3624,0,16582,2022-04-27 09:04:04.209,null
2048,1254,701476,대구,3598,3598,0,16581,2022-04-27 09:04:04.209,null
2049,2030,1044893,부산,3027,3027,0,16580,2022-04-27 09:04:04.209,null
2050,4534,3458306,서울,11517,11517,0,16579,2022-04-27 09:04:04.208,null
2051,22466,17086626,합계,76787,76750,37,16578,2022-04-27 09:04:04.208,null
2052,16,10976,검역,8,0,8,16577,2022-04-26 16:03:02.252,null
2053,159,218794,제주,746,746,0,16576,2022-04-26 16:03:02.252,null
2054,1138,1018107,경남,5180,5179,1,16575,2022-04-26 16:03:02.251,null
2055,1211,698372,경북,4348,4347,1,16574,2022-04-26 16:03:02.251,null
2056,380,545451,전남,3836,3836,0,16573,2022-04-26 16:03:02.251,null
2057,805,550483,전북,3515,3514,1,16572,2022-04-26 16:03:02.251,null
2058,865,662877,충남,3738,3738,0,16571,2022-04-26 16:03:02.251,null
2059,661,513381,충북,2768,2767,1,16570,2022-04-26 16:03:02.25,null
2060,749,471830,강원,3015,3014,1,16569,2022-04-26 16:03:02.25,null
2061,5757,4665892,경기,19363,19362,1,16568,2022-04-26 16:03:02.25,null
2062,34,128936,세종,666,666,0,16567,2022-04-26 16:03:02.25,null
2063,322,349482,울산,1753,1753,0,16566,2022-04-26 16:03:02.25,null
2064,612,472793,대전,2478,2477,1,16565,2022-04-26 16:03:02.249,null
2065,523,494167,광주,2197,2197,0,16564,2022-04-26 16:03:02.249,null
2066,1313,1021782,인천,4282,4282,0,16563,2022-04-26 16:03:02.249,null
2067,1248,697880,대구,4904,4904,0,16562,2022-04-26 16:03:02.249,null
2068,2012,1041873,부산,4004,4004,0,16561,2022-04-26 16:03:02.248,null
2069,4520,3446789,서울,13560,13559,1,16560,2022-04-26 16:03:02.248,null
2070,22325,17009865,합계,80361,80345,16,16559,2022-04-26 16:03:02.248,null
2071,16,10968,검역,10,0,10,16539,2022-04-25 09:01:16.445,null
2072,158,218048,제주,734,734,0,16538,2022-04-25 09:01:16.444,null
2073,1134,1012927,경남,1973,1965,8,16537,2022-04-25 09:01:16.444,null
2074,1203,694024,경북,2245,2242,3,16536,2022-04-25 09:01:16.444,null
2075,379,541617,전남,1788,1787,1,16535,2022-04-25 09:01:16.444,null
2076,803,546970,전북,1427,1427,0,16534,2022-04-25 09:01:16.443,null
2077,859,659146,충남,1534,1534,0,16533,2022-04-25 09:01:16.443,null
2078,660,510618,충북,1202,1196,6,16532,2022-04-25 09:01:16.443,null
2079,746,468815,강원,1280,1280,0,16531,2022-04-25 09:01:16.443,null
2080,5736,4646551,경기,9058,9058,0,16530,2022-04-25 09:01:16.442,null
2081,34,128271,세종,416,416,0,16529,2022-04-25 09:01:16.442,null
2082,322,347729,울산,689,689,0,16528,2022-04-25 09:01:16.442,null
2083,612,470315,대전,1424,1424,0,16527,2022-04-25 09:01:16.442,null
2084,520,491970,광주,1677,1676,1,16526,2022-04-25 09:01:16.442,null
2085,1312,1017506,인천,1656,1654,2,16525,2022-04-25 09:01:16.441,null
2086,1243,692977,대구,1422,1422,0,16524,2022-04-25 09:01:16.441,null
2087,2002,1037874,부산,1072,1072,0,16523,2022-04-25 09:01:16.441,null
2088,4504,3433238,서울,4763,4763,0,16522,2022-04-25 09:01:16.441,null
2089,22243,16929564,합계,34370,34339,31,16521,2022-04-25 09:01:16.44,null
2090,16,10958,검역,6,0,6,16520,2022-04-24 08:44:37.037,null
2091,157,217314,제주,994,994,0,16519,2022-04-24 08:44:37.036,null
2092,1130,1010954,경남,3867,3862,5,16518,2022-04-24 08:44:37.036,null
2093,1199,691779,경북,4047,4039,8,16517,2022-04-24 08:44:37.036,null
2094,375,539829,전남,3171,3171,0,16516,2022-04-24 08:44:37.036,null
2095,795,545543,전북,2975,2974,1,16515,2022-04-24 08:44:37.036,null
2096,852,657612,충남,3009,3009,0,16514,2022-04-24 08:44:37.035,null
2097,656,509416,충북,2623,2619,4,16513,2022-04-24 08:44:37.035,null
2098,740,467535,강원,2265,2265,0,16512,2022-04-24 08:44:37.035,null
2099,5706,4637493,경기,15249,15249,0,16511,2022-04-24 08:44:37.035,null
2100,34,127855,세종,386,386,0,16510,2022-04-24 08:44:37.034,null
2101,322,347040,울산,1689,1689,0,16509,2022-04-24 08:44:37.034,null
2102,609,468891,대전,2297,2292,5,16508,2022-04-24 08:44:37.034,null
2103,518,490293,광주,2373,2371,2,16507,2022-04-24 08:44:37.034,null
2104,1306,1015850,인천,3319,3316,3,16506,2022-04-24 08:44:37.033,null
2105,1236,691555,대구,3399,3399,0,16505,2022-04-24 08:44:37.033,null
2106,1994,1036802,부산,2679,2679,0,16504,2022-04-24 08:44:37.033,null
2107,4488,3428475,서울,10377,10375,2,16503,2022-04-24 08:44:37.033,null
2108,22133,16895194,합계,64725,64689,36,16502,2022-04-24 08:44:37.033,null
2109,16,10952,검역,12,0,12,16501,2022-04-23 08:56:30.109,null
2110,157,216320,제주,1022,1022,0,16500,2022-04-23 08:56:30.109,null
2111,1125,1007087,경남,4310,4305,5,16499,2022-04-23 08:56:30.109,null
2112,1188,687732,경북,4433,4430,3,16498,2022-04-23 08:56:30.109,null
2113,370,536658,전남,3558,3557,1,16497,2022-04-23 08:56:30.108,null
2114,794,542568,전북,3297,3297,0,16496,2022-04-23 08:56:30.108,null
2115,850,654603,충남,3875,3874,1,16495,2022-04-23 08:56:30.108,null
2116,652,506793,충북,2732,2728,4,16494,2022-04-23 08:56:30.108,null
2117,733,465270,강원,2797,2797,0,16493,2022-04-23 08:56:30.108,null
2118,5673,4622244,경기,18441,18441,0,16492,2022-04-23 08:56:30.107,null
2119,34,127469,세종,626,626,0,16491,2022-04-23 08:56:30.107,null
2120,320,345351,울산,1740,1740,0,16490,2022-04-23 08:56:30.107,null
2121,604,466594,대전,2665,2665,0,16489,2022-04-23 08:56:30.107,null
2122,516,487920,광주,2826,2823,3,16488,2022-04-23 08:56:30.107,null
2123,1300,1012531,인천,3674,3674,0,16487,2022-04-23 08:56:30.106,null
2124,1231,688156,대구,3966,3966,0,16486,2022-04-23 08:56:30.106,null
2125,1991,1034123,부산,3123,3123,0,16485,2022-04-23 08:56:30.106,null
2126,4470,3418098,서울,12352,12352,0,16484,2022-04-23 08:56:30.106,null
2127,22024,16830469,합계,75449,75420,29,16483,2022-04-23 08:56:30.105,null
2128,16,10940,검역,4,0,4,16482,2022-04-22 09:07:01.351,null
2129,156,215298,제주,1189,1189,0,16481,2022-04-22 09:07:01.351,null
2130,1121,1002777,경남,4625,4625,0,16480,2022-04-22 09:07:01.35,null
2131,1173,683299,경북,5022,5021,1,16479,2022-04-22 09:07:01.35,null
2132,365,533102,전남,3828,3826,2,16478,2022-04-22 09:07:01.35,null
2133,785,539271,전북,3349,3347,2,16477,2022-04-22 09:07:01.35,null
2134,841,650730,충남,3845,3845,0,16476,2022-04-22 09:07:01.35,null
2135,648,504063,충북,3059,3054,5,16475,2022-04-22 09:07:01.349,null
2136,722,462475,강원,3169,3169,0,16474,2022-04-22 09:07:01.349,null
2137,5636,4603813,경기,20431,20431,0,16473,2022-04-22 09:07:01.349,null
2138,34,126843,세종,570,570,0,16472,2022-04-22 09:07:01.349,null
2139,320,343611,울산,1852,1852,0,16471,2022-04-22 09:07:01.348,null
2140,598,463936,대전,2859,2859,0,16470,2022-04-22 09:07:01.348,null
2141,510,485096,광주,2807,2806,1,16469,2022-04-22 09:07:01.348,null
2142,1285,1008857,인천,4098,4098,0,16468,2022-04-22 09:07:01.348,null
2143,1221,684190,대구,4030,4030,0,16467,2022-04-22 09:07:01.348,null
2144,1988,1031003,부산,3130,3130,0,16466,2022-04-22 09:07:01.347,null
2145,4454,3405751,서울,13191,13191,0,16465,2022-04-22 09:07:01.347,null
2146,21873,16755055,합계,81058,81043,15,16464,2022-04-22 09:07:01.347,null
2147,16,10936,검역,23,0,23,16463,2022-04-21 09:06:18.622,null
2148,155,214110,제주,1285,1285,0,16462,2022-04-21 09:06:18.622,null
2149,1109,998152,경남,5573,5573,0,16461,2022-04-21 09:06:18.622,null
2150,1160,678277,경북,5661,5660,1,16460,2022-04-21 09:06:18.621,null
2151,358,529274,전남,3975,3974,1,16459,2022-04-21 09:06:18.621,null
2152,779,535925,전북,3900,3898,2,16458,2022-04-21 09:06:18.621,null
2153,831,646885,충남,4378,4378,0,16457,2022-04-21 09:06:18.621,null
2154,645,501007,충북,3509,3507,2,16456,2022-04-21 09:06:18.621,null
2155,713,459309,강원,3420,3420,0,16455,2022-04-21 09:06:18.62,null
2156,5571,4583391,경기,22620,22620,0,16454,2022-04-21 09:06:18.62,null
2157,34,126273,세종,795,795,0,16453,2022-04-21 09:06:18.62,null
2158,319,341763,울산,1946,1945,1,16452,2022-04-21 09:06:18.62,null
2159,594,461077,대전,3005,3004,1,16451,2022-04-21 09:06:18.619,null
2160,510,482289,광주,3176,3176,0,16450,2022-04-21 09:06:18.619,null
2161,1271,1004759,인천,4667,4667,0,16449,2022-04-21 09:06:18.619,null
2162,1211,680160,대구,4203,4203,0,16448,2022-04-21 09:06:18.619,null
2163,1969,1027875,부산,3539,3539,0,16447,2022-04-21 09:06:18.618,null
2164,4422,3392583,서울,15192,15192,0,16446,2022-04-21 09:06:18.618,null
2165,21667,16674045,합계,90867,90836,31,16445,2022-04-21 09:06:18.618,null
2166,16,10913,검역,2,0,2,16444,2022-04-20 09:08:34.429,null
2167,153,212825,제주,1398,1398,0,16443,2022-04-20 09:08:34.428,null
2168,1096,992582,경남,6335,6334,1,16442,2022-04-20 09:08:34.428,null
2169,1150,672616,경북,7190,7187,3,16441,2022-04-20 09:08:34.428,null
2170,354,525300,전남,4932,4932,0,16440,2022-04-20 09:08:34.428,null
2171,776,532030,전북,4833,4831,2,16439,2022-04-20 09:08:34.427,null
2172,826,642509,충남,5244,5244,0,16438,2022-04-20 09:08:34.427,null
2173,639,497500,충북,4273,4268,5,16437,2022-04-20 09:08:34.427,null
2174,700,455890,강원,4498,4498,0,16436,2022-04-20 09:08:34.427,null
2175,5544,4560783,경기,28560,28557,3,16435,2022-04-20 09:08:34.426,null
2176,34,125478,세종,1069,1069,0,16434,2022-04-20 09:08:34.426,null
2177,317,339820,울산,2501,2501,0,16433,2022-04-20 09:08:34.426,null
2178,590,458072,대전,3891,3891,0,16432,2022-04-20 09:08:34.425,null
2179,507,479113,광주,4071,4070,1,16431,2022-04-20 09:08:34.425,null
2180,1267,1000093,인천,5435,5435,0,16430,2022-04-20 09:08:34.425,null
2181,1203,675960,대구,5014,5014,0,16429,2022-04-20 09:08:34.424,null
2182,1950,1024337,부산,3751,3751,0,16428,2022-04-20 09:08:34.424,null
2183,4398,3377399,서울,18322,18322,0,16427,2022-04-20 09:08:34.424,null
2184,21520,16583220,합계,111319,111302,17,16426,2022-04-20 09:08:34.423,null
2185,16,10911,검역,6,0,6,16425,2022-04-19 09:03:42.325,null
2186,153,211427,제주,1213,1213,0,16424,2022-04-19 09:03:42.325,null
2187,1081,986249,경남,7107,7102,5,16423,2022-04-19 09:03:42.324,null
2188,1140,665426,경북,5833,5831,2,16422,2022-04-19 09:03:42.324,null
2189,351,520368,전남,5081,5081,0,16421,2022-04-19 09:03:42.324,null
2190,770,527197,전북,4972,4971,1,16420,2022-04-19 09:03:42.324,null
2191,820,637265,충남,5471,5470,1,16419,2022-04-19 09:03:42.324,null
2192,629,493227,충북,4375,4371,4,16418,2022-04-19 09:03:42.323,null
2193,695,451394,강원,4432,4432,0,16417,2022-04-19 09:03:42.323,null
2194,5497,4532233,경기,29671,29671,0,16416,2022-04-19 09:03:42.323,null
2195,33,124410,세종,1089,1089,0,16415,2022-04-19 09:03:42.322,null
2196,315,337321,울산,2387,2387,0,16414,2022-04-19 09:03:42.322,null
2197,586,454181,대전,3474,3474,0,16413,2022-04-19 09:03:42.322,null
2198,504,475042,광주,3020,3019,1,16412,2022-04-19 09:03:42.322,null
2199,1259,994658,인천,6668,6668,0,16411,2022-04-19 09:03:42.321,null
2200,1194,670946,대구,6502,6502,0,16410,2022-04-19 09:03:42.321,null
2201,1939,1020588,부산,5384,5384,0,16409,2022-04-19 09:03:42.321,null
2202,4372,3359097,서울,21819,21819,0,16408,2022-04-19 09:03:42.321,null
2203,21354,16471940,합계,118504,118484,20,16407,2022-04-19 09:03:42.32,null
2204,16,10905,검역,6,0,6,16406,2022-04-18 08:59:42.685,null
2205,153,210214,제주,853,853,0,16405,2022-04-18 08:59:42.685,null
2206,1073,979142,경남,2364,2363,1,16404,2022-04-18 08:59:42.685,null
2207,1131,659593,경북,2789,2789,0,16403,2022-04-18 08:59:42.684,null
2208,347,515289,전남,2132,2132,0,16402,2022-04-18 08:59:42.684,null
2209,764,522227,전북,2066,2066,0,16401,2022-04-18 08:59:42.684,null
2210,808,631807,충남,2404,2404,0,16400,2022-04-18 08:59:42.684,null
2211,622,488859,충북,1451,1446,5,16399,2022-04-18 08:59:42.684,null
2212,689,446964,강원,1851,1851,0,16398,2022-04-18 08:59:42.683,null
2213,5472,4502575,경기,13926,13926,0,16397,2022-04-18 08:59:42.683,null
2214,31,123321,세종,474,474,0,16396,2022-04-18 08:59:42.683,null
2215,315,334937,울산,932,932,0,16395,2022-04-18 08:59:42.683,null
2216,577,450707,대전,1736,1735,1,16394,2022-04-18 08:59:42.682,null
2217,501,472025,광주,1950,1949,1,16393,2022-04-18 08:59:42.682,null
2218,1253,987990,인천,2487,2487,0,16392,2022-04-18 08:59:42.682,null
2219,1187,664446,대구,1626,1626,0,16391,2022-04-18 08:59:42.682,null
2220,1932,1015212,부산,1351,1351,0,16390,2022-04-18 08:59:42.681,null
2221,4353,3337282,서울,7345,7345,0,16389,2022-04-18 08:59:42.681,null
2222,21224,16353495,합계,47743,47729,14,16388,2022-04-18 08:59:42.681,null
2223,16,10899,검역,10,0,10,16387,2022-04-17 09:23:32.947,null
2224,153,209361,제주,1468,1468,0,16386,2022-04-17 09:23:32.947,null
2225,1067,976778,경남,5516,5516,0,16385,2022-04-17 09:23:32.947,null
2226,1120,656804,경북,5053,5053,0,16384,2022-04-17 09:23:32.947,null
2227,343,513157,전남,4396,4395,1,16383,2022-04-17 09:23:32.947,null
2228,762,520161,전북,4158,4158,0,16382,2022-04-17 09:23:32.946,null
2229,802,629403,충남,5452,5451,1,16381,2022-04-17 09:23:32.946,null
2230,617,487408,충북,3561,3558,3,16380,2022-04-17 09:23:32.946,null
2231,683,445113,강원,3113,3113,0,16379,2022-04-17 09:23:32.946,null
2232,5442,4488649,경기,23118,23117,1,16378,2022-04-17 09:23:32.946,null
2233,31,122847,세종,755,755,0,16377,2022-04-17 09:23:32.945,null
2234,313,334005,울산,2018,2018,0,16376,2022-04-17 09:23:32.945,null
2235,574,448971,대전,3558,3558,0,16375,2022-04-17 09:23:32.945,null
2236,498,470075,광주,3561,3559,2,16374,2022-04-17 09:23:32.945,null
2237,1244,985503,인천,4874,4874,0,16373,2022-04-17 09:23:32.944,null
2238,1176,662820,대구,4210,4210,0,16372,2022-04-17 09:23:32.944,null
2239,1922,1013861,부산,3375,3375,0,16371,2022-04-17 09:23:32.944,null
2240,4329,3329937,서울,14805,14805,0,16370,2022-04-17 09:23:32.944,null
2241,21092,16305752,합계,93001,92983,18,16369,2022-04-17 09:23:32.943,null
2242,16,10889,검역,8,0,8,16368,2022-04-16 09:26:45.3,null
2243,150,207893,제주,1619,1619,0,16367,2022-04-16 09:26:45.3,null
2244,1058,971262,경남,6354,6351,3,16366,2022-04-16 09:26:45.3,null
2245,1105,651751,경북,6158,6152,6,16365,2022-04-16 09:26:45.299,null
2246,332,508761,전남,4971,4968,3,16364,2022-04-16 09:26:45.299,null
2247,740,516003,전북,4572,4569,3,16363,2022-04-16 09:26:45.299,null
2248,797,623951,충남,5274,5274,0,16362,2022-04-16 09:26:45.299,null
2249,612,483847,충북,4151,4149,2,16361,2022-04-16 09:26:45.299,null
2250,665,442000,강원,3964,3963,1,16360,2022-04-16 09:26:45.298,null
2251,5401,4465531,경기,27481,27480,1,16359,2022-04-16 09:26:45.298,null
2252,31,122092,세종,946,946,0,16358,2022-04-16 09:26:45.298,null
2253,313,331987,울산,2147,2147,0,16357,2022-04-16 09:26:45.298,null
2254,564,445413,대전,3836,3836,0,16356,2022-04-16 09:26:45.297,null
2255,493,466514,광주,4095,4092,3,16355,2022-04-16 09:26:45.297,null
2256,1238,980629,인천,5606,5606,0,16354,2022-04-16 09:26:45.297,null
2257,1165,658610,대구,4703,4703,0,16353,2022-04-16 09:26:45.297,null
2258,1902,1010486,부산,3913,3913,0,16352,2022-04-16 09:26:45.296,null
2259,4307,3315132,서울,18118,18118,0,16351,2022-04-16 09:26:45.296,null
2260,20889,16212751,합계,107916,107886,30,16350,2022-04-16 09:26:45.296,null
2261,16,10882,검역,4,0,4,16349,2022-04-15 08:59:06.37,null
2262,149,206274,제주,1803,1803,0,16348,2022-04-15 08:59:06.37,null
2263,1042,964908,경남,7112,7108,4,16347,2022-04-15 08:59:06.37,null
2264,1087,645593,경북,6713,6712,1,16346,2022-04-15 08:59:06.37,null
2265,318,503795,전남,5721,5721,0,16345,2022-04-15 08:59:06.369,null
2266,725,511431,전북,5344,5343,1,16344,2022-04-15 08:59:06.369,null
2267,783,618683,충남,5982,5981,1,16343,2022-04-15 08:59:06.369,null
2268,605,479696,충북,4637,4637,0,16342,2022-04-15 08:59:06.369,null
2269,652,438036,강원,4561,4560,1,16341,2022-04-15 08:59:06.369,null
2270,5340,4438056,경기,32584,32584,0,16340,2022-04-15 08:59:06.368,null
2271,31,121148,세종,1195,1195,0,16339,2022-04-15 08:59:06.368,null
2272,310,329843,울산,2713,2713,0,16338,2022-04-15 08:59:06.368,null
2273,548,441577,대전,4503,4501,2,16337,2022-04-15 08:59:06.368,null
2274,483,462419,광주,4725,4725,0,16336,2022-04-15 08:59:06.367,null
2275,1226,975023,인천,6690,6690,0,16335,2022-04-15 08:59:06.367,null
2276,1149,653908,대구,5522,5522,0,16334,2022-04-15 08:59:06.367,null
2277,1882,1006577,부산,4587,4587,0,16333,2022-04-15 08:59:06.367,null
2278,4270,3297020,서울,21450,21450,0,16332,2022-04-15 08:59:06.367,null
2279,20616,16104869,합계,125846,125832,14,16331,2022-04-15 08:59:06.366,null
2280,16,10878,검역,19,0,19,16330,2022-04-14 09:07:17.229,null
2281,147,204471,제주,2185,2185,0,16329,2022-04-14 09:07:17.228,null
2282,1027,957801,경남,8764,8763,1,16328,2022-04-14 09:07:17.228,null
2283,1063,638886,경북,8042,8039,3,16327,2022-04-14 09:07:17.227,null
2284,310,498075,전남,6912,6909,3,16326,2022-04-14 09:07:17.227,null
2285,713,506089,전북,6532,6529,3,16325,2022-04-14 09:07:17.226,null
2286,777,612701,충남,6805,6805,0,16324,2022-04-14 09:07:17.226,null
2287,597,475061,충북,5538,5536,2,16323,2022-04-14 09:07:17.225,null
2288,639,433476,강원,5428,5427,1,16322,2022-04-14 09:07:17.225,null
2289,5283,4405483,경기,37996,37994,2,16321,2022-04-14 09:07:17.224,null
2290,31,119954,세종,1722,1722,0,16320,2022-04-14 09:07:17.224,null
2291,307,327130,울산,3043,3043,0,16319,2022-04-14 09:07:17.223,null
2292,539,437074,대전,5160,5160,0,16318,2022-04-14 09:07:17.223,null
2293,471,457694,광주,5661,5660,1,16317,2022-04-14 09:07:17.222,null
2294,1213,968335,인천,7631,7631,0,16316,2022-04-14 09:07:17.221,null
2295,1136,648388,대구,6635,6635,0,16315,2022-04-14 09:07:17.221,null
2296,1853,1001991,부산,5394,5394,0,16314,2022-04-14 09:07:17.22,null
2297,4230,3275574,서울,24976,24976,0,16313,2022-04-14 09:07:17.22,null
2298,20352,15979061,합계,148443,148408,35,16312,2022-04-14 09:07:17.219,null
2299,16,10859,검역,17,0,17,16311,2022-04-13 09:05:51.674,null
2300,146,202286,제주,3023,3023,0,16310,2022-04-13 09:05:51.674,null
2301,1010,949038,경남,11340,11336,4,16309,2022-04-13 09:05:51.674,null
2302,1036,630845,경북,12063,12060,3,16308,2022-04-13 09:05:51.674,null
2303,294,491166,전남,8447,8446,1,16307,2022-04-13 09:05:51.673,null
2304,700,499558,전북,8005,8002,3,16306,2022-04-13 09:05:51.673,null
2305,760,605896,충남,9245,9245,0,16305,2022-04-13 09:05:51.673,null
2306,589,469524,충북,7407,7407,0,16304,2022-04-13 09:05:51.673,null
2307,622,428048,강원,7243,7243,0,16303,2022-04-13 09:05:51.673,null
2308,5214,4367498,경기,51796,51796,0,16302,2022-04-13 09:05:51.672,null
2309,31,118232,세종,1389,1389,0,16301,2022-04-13 09:05:51.672,null
2310,302,324087,울산,4051,4051,0,16300,2022-04-13 09:05:51.672,null
2311,523,431914,대전,6516,6512,4,16299,2022-04-13 09:05:51.672,null
2312,463,452033,광주,7408,7403,5,16298,2022-04-13 09:05:51.671,null
2313,1194,960706,인천,9667,9667,0,16297,2022-04-13 09:05:51.671,null
2314,1124,641753,대구,8357,8357,0,16296,2022-04-13 09:05:51.671,null
2315,1834,996598,부산,6369,6369,0,16295,2022-04-13 09:05:51.671,null
2316,4176,3250603,서울,33076,33076,0,16294,2022-04-13 09:05:51.671,null
2317,20034,15830644,합계,195419,195382,37,16293,2022-04-13 09:05:51.67,null
2318,16,10842,검역,14,0,14,16292,2022-04-12 09:05:39.073,null
2319,145,199263,제주,1545,1545,0,16291,2022-04-12 09:05:39.073,null
2320,998,937699,경남,12563,12561,2,16290,2022-04-12 09:05:39.073,null
2321,1024,618782,경북,8882,8872,10,16289,2022-04-12 09:05:39.073,null
2322,291,482723,전남,9089,9087,2,16288,2022-04-12 09:05:39.072,null
2323,695,491554,전북,8139,8139,0,16287,2022-04-12 09:05:39.072,null
2324,736,596651,충남,10072,10072,0,16286,2022-04-12 09:05:39.072,null
2325,583,462118,충북,7814,7810,4,16285,2022-04-12 09:05:39.072,null
2326,609,420806,강원,6840,6839,1,16284,2022-04-12 09:05:39.071,null
2327,5175,4315720,경기,54191,54191,0,16283,2022-04-12 09:05:39.071,null
2328,31,116847,세종,1796,1796,0,16282,2022-04-12 09:05:39.071,null
2329,301,320038,울산,4192,4192,0,16281,2022-04-12 09:05:39.07,null
2330,517,425398,대전,6816,6816,0,16280,2022-04-12 09:05:39.07,null
2331,456,444628,광주,6659,6659,0,16279,2022-04-12 09:05:39.07,null
2332,1186,951039,인천,11648,11648,0,16278,2022-04-12 09:05:39.07,null
2333,1114,633398,대구,11367,11367,0,16277,2022-04-12 09:05:39.069,null
2334,1821,990236,부산,9610,9610,0,16276,2022-04-12 09:05:39.069,null
2335,4152,3217532,서울,39518,39518,0,16275,2022-04-12 09:05:39.069,null
2336,19850,15635274,합계,210755,210722,33,16274,2022-04-12 09:05:39.069,null
2337,16,10828,검역,7,0,7,16273,2022-04-11 09:06:16.944,null
2338,143,197718,제주,1711,1711,0,16272,2022-04-11 09:06:16.944,null
2339,984,925139,경남,5082,5079,3,16271,2022-04-11 09:06:16.944,null
2340,1007,609902,경북,5068,5062,6,16270,2022-04-11 09:06:16.944,null
2341,290,473635,전남,4450,4450,0,16269,2022-04-11 09:06:16.944,null
2342,691,483420,전북,3762,3759,3,16268,2022-04-11 09:06:16.943,null
2343,726,586582,충남,4222,4222,0,16267,2022-04-11 09:06:16.943,null
2344,580,454309,충북,2803,2802,1,16266,2022-04-11 09:06:16.943,null
2345,600,413967,강원,3377,3377,0,16265,2022-04-11 09:06:16.943,null
2346,5145,4261542,경기,25775,25775,0,16264,2022-04-11 09:06:16.942,null
2347,31,115052,세종,1102,1102,0,16263,2022-04-11 09:06:16.942,null
2348,300,315850,울산,1782,1782,0,16262,2022-04-11 09:06:16.942,null
2349,507,418582,대전,3677,3677,0,16261,2022-04-11 09:06:16.942,null
2350,454,437969,광주,3979,3978,1,16260,2022-04-11 09:06:16.942,null
2351,1179,939395,인천,4385,4385,0,16259,2022-04-11 09:06:16.941,null
2352,1098,622037,대구,2992,2992,0,16258,2022-04-11 09:06:16.941,null
2353,1812,980634,부산,2507,2507,0,16257,2022-04-11 09:06:16.941,null
2354,4116,3178037,서울,14247,14247,0,16256,2022-04-11 09:06:16.941,null
2355,19679,15424598,합계,90928,90907,21,16255,2022-04-11 09:06:16.94,null
2356,16,10821,검역,11,0,11,16254,2022-04-10 08:59:25.177,null
2357,141,196007,제주,2553,2553,0,16253,2022-04-10 08:59:25.177,null
2358,965,920057,경남,10180,10176,4,16252,2022-04-10 08:59:25.176,null
2359,992,604834,경북,8400,8399,1,16251,2022-04-10 08:59:25.176,null
2360,286,469185,전남,7802,7802,0,16250,2022-04-10 08:59:25.176,null
2361,678,479658,전북,6728,6728,0,16249,2022-04-10 08:59:25.176,null
2362,721,582360,충남,7998,7998,0,16248,2022-04-10 08:59:25.175,null
2363,574,451506,충북,6319,6314,5,16247,2022-04-10 08:59:25.175,null
2364,587,410590,강원,5662,5662,0,16246,2022-04-10 08:59:25.175,null
2365,5079,4235767,경기,42356,42353,3,16245,2022-04-10 08:59:25.175,null
2366,31,113950,세종,1353,1353,0,16244,2022-04-10 08:59:25.175,null
2367,296,314068,울산,3832,3832,0,16243,2022-04-10 08:59:25.174,null
2368,505,414905,대전,5403,5403,0,16242,2022-04-10 08:59:25.174,null
2369,426,433990,광주,5335,5332,3,16241,2022-04-10 08:59:25.174,null
2370,1171,935010,인천,8594,8594,0,16240,2022-04-10 08:59:25.174,null
2371,1091,619045,대구,7069,7069,0,16239,2022-04-10 08:59:25.173,null
2372,1792,978127,부산,5985,5985,0,16238,2022-04-10 08:59:25.173,null
2373,4070,3163790,서울,28901,28901,0,16237,2022-04-10 08:59:25.173,null
2374,19421,15333670,합계,164481,164454,27,16236,2022-04-10 08:59:25.173,null
2375,16,10810,검역,19,0,19,16235,2022-04-09 09:20:31.827,null
2376,139,193454,제주,2739,2739,0,16234,2022-04-09 09:20:31.827,null
2377,952,909877,경남,10858,10852,6,16233,2022-04-09 09:20:31.827,null
2378,960,596434,경북,10443,10437,6,16232,2022-04-09 09:20:31.826,null
2379,280,461383,전남,8437,8436,1,16231,2022-04-09 09:20:31.826,null
2380,669,472930,전북,7185,7182,3,16230,2022-04-09 09:20:31.826,null
2381,709,574362,충남,8804,8804,0,16229,2022-04-09 09:20:31.826,null
2382,559,445187,충북,6749,6747,2,16228,2022-04-09 09:20:31.826,null
2383,578,404928,강원,6620,6620,0,16227,2022-04-09 09:20:31.825,null
2384,4976,4193411,경기,48198,48198,0,16226,2022-04-09 09:20:31.825,null
2385,30,112597,세종,1494,1494,0,16225,2022-04-09 09:20:31.825,null
2386,290,310236,울산,3756,3756,0,16224,2022-04-09 09:20:31.825,null
2387,502,409502,대전,7005,7005,0,16223,2022-04-09 09:20:31.825,null
2388,426,428655,광주,6487,6484,3,16222,2022-04-09 09:20:31.824,null
2389,1155,926416,인천,9759,9759,0,16221,2022-04-09 09:20:31.824,null
2390,1077,611976,대구,7683,7683,0,16220,2022-04-09 09:20:31.824,null
2391,1772,972142,부산,7010,7010,0,16219,2022-04-09 09:20:31.824,null
2392,4002,3134889,서울,32320,32320,0,16218,2022-04-09 09:20:31.823,null
2393,19092,15169189,합계,185566,185526,40,16217,2022-04-09 09:20:31.823,null
2394,16,10792,검역,8,0,8,16216,2022-04-08 09:09:28.603,null
2395,133,190715,제주,2855,2855,0,16215,2022-04-08 09:09:28.603,null
2396,925,899024,경남,12192,12191,1,16214,2022-04-08 09:09:28.603,null
2397,936,585993,경북,10385,10382,3,16213,2022-04-08 09:09:28.602,null
2398,273,452946,전남,8672,8671,1,16212,2022-04-08 09:09:28.602,null
2399,661,465748,전북,8257,8253,4,16211,2022-04-08 09:09:28.602,null
2400,690,565566,충남,9509,9509,0,16210,2022-04-08 09:09:28.602,null
2401,543,438455,충북,7357,7357,0,16209,2022-04-08 09:09:28.602,null
2402,569,398309,강원,7433,7425,8,16208,2022-04-08 09:09:28.601,null
2403,4888,4145220,경기,54814,54811,3,16207,2022-04-08 09:09:28.601,null
2404,30,111103,세종,1891,1891,0,16206,2022-04-08 09:09:28.601,null
2405,288,306481,울산,4244,4244,0,16205,2022-04-08 09:09:28.601,null
2406,489,402509,대전,6927,6927,0,16204,2022-04-08 09:09:28.6,null
2407,420,422170,광주,7318,7315,3,16203,2022-04-08 09:09:28.6,null
2408,1142,916658,인천,10559,10559,0,16202,2022-04-08 09:09:28.6,null
2409,1064,604294,대구,9224,9224,0,16201,2022-04-08 09:09:28.6,null
2410,1743,965134,부산,7476,7476,0,16200,2022-04-08 09:09:28.6,null
2411,3944,3102577,서울,36212,36212,0,16199,2022-04-08 09:09:28.599,null
2412,18754,14983694,합계,205333,205302,31,16198,2022-04-08 09:09:28.599,null
2413,16,10784,검역,10,0,10,16197,2022-04-07 09:09:32.062,null
2414,130,187860,제주,3215,3215,0,16196,2022-04-07 09:09:32.062,null
2415,909,886836,경남,13466,13464,2,16195,2022-04-07 09:09:32.062,null
2416,918,575608,경북,11312,11308,4,16194,2022-04-07 09:09:32.062,null
2417,260,444275,전남,9908,9905,3,16193,2022-04-07 09:09:32.061,null
2418,636,457491,전북,8280,8271,9,16192,2022-04-07 09:09:32.061,null
2419,674,556057,충남,10340,10340,0,16191,2022-04-07 09:09:32.061,null
2420,520,431107,충북,8222,8220,2,16190,2022-04-07 09:09:32.061,null
2421,555,390879,강원,7633,7628,5,16189,2022-04-07 09:09:32.061,null
2422,4803,4090410,경기,60256,60255,1,16188,2022-04-07 09:09:32.06,null
2423,30,109212,세종,2630,2630,0,16187,2022-04-07 09:09:32.06,null
2424,280,302242,울산,4648,4648,0,16186,2022-04-07 09:09:32.06,null
2425,481,395582,대전,7399,7399,0,16185,2022-04-07 09:09:32.06,null
2426,407,414852,광주,8136,8132,4,16184,2022-04-07 09:09:32.059,null
2427,1134,906099,인천,11271,11271,0,16183,2022-04-07 09:09:32.059,null
2428,1034,595072,대구,9752,9752,0,16182,2022-04-07 09:09:32.059,null
2429,1714,957663,부산,8454,8454,0,16181,2022-04-07 09:09:32.059,null
2430,3880,3066376,서울,39888,39888,0,16180,2022-04-07 09:09:32.058,null
2431,18381,14778405,합계,224820,224780,40,16179,2022-04-07 09:09:32.058,null
2432,16,10774,검역,6,0,6,16178,2022-04-06 09:08:25.574,null
2433,123,184645,제주,4159,4159,0,16177,2022-04-06 09:08:25.573,null
2434,875,873370,경남,17182,17178,4,16176,2022-04-06 09:08:25.573,null
2435,882,564300,경북,14773,14769,4,16175,2022-04-06 09:08:25.573,null
2436,251,434370,전남,12387,12386,1,16174,2022-04-06 09:08:25.573,null
2437,625,449213,전북,10482,10482,0,16173,2022-04-06 09:08:25.573,null
2438,648,545720,충남,13575,13575,0,16172,2022-04-06 09:08:25.572,null
2439,509,422885,충북,10267,10264,3,16171,2022-04-06 09:08:25.572,null
2440,542,383250,강원,10012,10012,0,16170,2022-04-06 09:08:25.572,null
2441,4724,4030170,경기,76900,76899,1,16169,2022-04-06 09:08:25.572,null
2442,30,106585,세종,2175,2175,0,16168,2022-04-06 09:08:25.571,null
2443,277,297594,울산,6287,6287,0,16167,2022-04-06 09:08:25.571,null
2444,470,388183,대전,9072,9072,0,16166,2022-04-06 09:08:25.571,null
2445,401,406716,광주,9154,9152,2,16165,2022-04-06 09:08:25.571,null
2446,1122,894831,인천,14845,14844,1,16164,2022-04-06 09:08:25.57,null
2447,1015,585322,대구,12103,12103,0,16163,2022-04-06 09:08:25.57,null
2448,1688,949213,부산,10485,10485,0,16162,2022-04-06 09:08:25.57,null
2449,3835,3026503,서울,52430,52430,0,16161,2022-04-06 09:08:25.57,null
2450,18033,14553644,합계,286294,286272,22,16160,2022-04-06 09:08:25.569,null
2451,16,10768,검역,10,0,10,16159,2022-04-05 09:08:14.444,null
2452,117,180486,제주,2711,2711,0,16158,2022-04-05 09:08:14.444,null
2453,849,856190,경남,16187,16183,4,16157,2022-04-05 09:08:14.444,null
2454,851,549528,경북,11311,11310,1,16156,2022-04-05 09:08:14.444,null
2455,243,421985,전남,10990,10989,1,16155,2022-04-05 09:08:14.443,null
2456,600,438733,전북,10253,10246,7,16154,2022-04-05 09:08:14.443,null
2457,634,532145,충남,12014,12013,1,16153,2022-04-05 09:08:14.443,null
2458,500,412619,충북,9424,9424,0,16152,2022-04-05 09:08:14.443,null
2459,528,373238,강원,8256,8256,0,16151,2022-04-05 09:08:14.442,null
2460,4638,3953289,경기,69364,69362,2,16150,2022-04-05 09:08:14.442,null
2461,29,104410,세종,2246,2246,0,16149,2022-04-05 09:08:14.442,null
2462,272,291312,울산,5459,5459,0,16148,2022-04-05 09:08:14.442,null
2463,455,379111,대전,7779,7779,0,16147,2022-04-05 09:08:14.442,null
2464,393,397566,광주,7471,7470,1,16146,2022-04-05 09:08:14.441,null
2465,1103,879987,인천,15354,15354,0,16145,2022-04-05 09:08:14.441,null
2466,1001,573220,대구,13540,13540,0,16144,2022-04-05 09:08:14.441,null
2467,1662,938730,부산,12266,12266,0,16143,2022-04-05 09:08:14.441,null
2468,3771,2974084,서울,51500,51500,0,16142,2022-04-05 09:08:14.44,null
2469,17662,14267401,합계,266135,266108,27,16141,2022-04-05 09:08:14.44,null
2470,16,10762,검역,6,0,6,16140,2022-04-04 09:08:29.048,null
2471,114,177775,제주,2261,2261,0,16139,2022-04-04 09:08:29.048,null
2472,830,840006,경남,7385,7383,2,16138,2022-04-04 09:08:29.048,null
2473,831,538220,경북,6270,6266,4,16137,2022-04-04 09:08:29.048,null
2474,239,410998,전남,5959,5959,0,16136,2022-04-04 09:08:29.047,null
2475,595,428485,전북,5088,5086,2,16135,2022-04-04 09:08:29.047,null
2476,626,520140,충남,5642,5642,0,16134,2022-04-04 09:08:29.047,null
2477,496,403201,충북,3956,3956,0,16133,2022-04-04 09:08:29.047,null
2478,515,364982,강원,5217,5216,1,16132,2022-04-04 09:08:29.047,null
2479,4588,3883961,경기,36937,36937,0,16131,2022-04-04 09:08:29.046,null
2480,29,102167,세종,1630,1630,0,16130,2022-04-04 09:08:29.046,null
2481,268,285853,울산,2481,2481,0,16129,2022-04-04 09:08:29.046,null
2482,447,371332,대전,4586,4586,0,16128,2022-04-04 09:08:29.046,null
2483,386,390095,광주,5801,5801,0,16127,2022-04-04 09:08:29.046,null
2484,1094,864639,인천,5545,5545,0,16126,2022-04-04 09:08:29.045,null
2485,991,559685,대구,3452,3452,0,16125,2022-04-04 09:08:29.045,null
2486,1646,926469,부산,4080,4080,0,16124,2022-04-04 09:08:29.045,null
2487,3742,2922636,서울,20894,20894,0,16123,2022-04-04 09:08:29.045,null
2488,17453,14001406,합계,127190,127175,15,16122,2022-04-04 09:08:29.044,null
2489,16,10756,검역,8,0,8,16102,2022-04-03 09:12:53.23,null
2490,112,175514,제주,3581,3581,0,16101,2022-04-03 09:12:53.23,null
2491,808,832621,경남,15122,15119,3,16100,2022-04-03 09:12:53.23,null
2492,816,531950,경북,11752,11749,3,16099,2022-04-03 09:12:53.23,null
2493,233,405039,전남,10438,10437,1,16098,2022-04-03 09:12:53.229,null
2494,589,423397,전북,8514,8512,2,16097,2022-04-03 09:12:53.229,null
2495,613,514498,충남,11168,11168,0,16096,2022-04-03 09:12:53.229,null
2496,492,399245,충북,8777,8776,1,16095,2022-04-03 09:12:53.229,null
2497,506,359765,강원,7496,7496,0,16094,2022-04-03 09:12:53.229,null
2498,4540,3847024,경기,62143,62143,0,16093,2022-04-03 09:12:53.228,null
2499,29,100537,세종,1961,1961,0,16092,2022-04-03 09:12:53.228,null
2500,262,283372,울산,5049,5049,0,16091,2022-04-03 09:12:53.228,null
2501,445,366746,대전,6972,6972,0,16090,2022-04-03 09:12:53.228,null
2502,377,384294,광주,7001,6998,3,16089,2022-04-03 09:12:53.228,null
2503,1085,859094,인천,13395,13395,0,16088,2022-04-03 09:12:53.227,null
2504,978,556233,대구,9697,9697,0,16087,2022-04-03 09:12:53.227,null
2505,1621,922389,부산,9118,9117,1,16086,2022-04-03 09:12:53.227,null
2506,3713,2901742,서울,42109,42109,0,16085,2022-04-03 09:12:53.227,null
2507,17235,13874216,합계,234301,234279,22,16084,2022-04-03 09:12:53.226,null
2508,16,10748,검역,45,0,45,16083,2022-04-02 09:31:48.305,null
2509,111,171933,제주,3771,3771,0,16082,2022-04-02 09:31:48.304,null
2510,787,817499,경남,15942,15938,4,16081,2022-04-02 09:31:48.304,null
2511,798,520198,경북,13070,13066,4,16080,2022-04-02 09:31:48.303,null
2512,216,394601,전남,11160,11155,5,16079,2022-04-02 09:31:48.303,null
2513,579,414883,전북,9462,9462,0,16078,2022-04-02 09:31:48.302,null
2514,592,503330,충남,11904,11903,1,16077,2022-04-02 09:31:48.302,null
2515,480,390468,충북,9326,9324,2,16076,2022-04-02 09:31:48.301,null
2516,498,352269,강원,9056,9053,3,16075,2022-04-02 09:31:48.301,null
2517,4472,3784881,경기,71525,71525,0,16074,2022-04-02 09:31:48.3,null
2518,27,98576,세종,2370,2370,0,16073,2022-04-02 09:31:48.3,null
2519,256,278323,울산,5594,5594,0,16072,2022-04-02 09:31:48.299,null
2520,438,359774,대전,7989,7989,0,16071,2022-04-02 09:31:48.299,null
2521,370,377293,광주,8033,8032,1,16070,2022-04-02 09:31:48.298,null
2522,1069,845699,인천,14284,14281,3,16069,2022-04-02 09:31:48.298,null
2523,960,546536,대구,11276,11276,0,16068,2022-04-02 09:31:48.297,null
2524,1594,913271,부산,10691,10691,0,16067,2022-04-02 09:31:48.297,null
2525,3666,2859633,서울,48673,48673,0,16066,2022-04-02 09:31:48.296,null
2526,16929,13639915,합계,264171,264103,68,16065,2022-04-02 09:31:48.295,null
2527,16,10703,검역,33,0,33,16064,2022-04-01 09:07:59.622,null
2528,104,168162,제주,3873,3873,0,16063,2022-04-01 09:07:59.622,null
2529,758,801564,경남,17255,17250,5,16062,2022-04-01 09:07:59.622,null
2530,776,507130,경북,12974,12972,2,16061,2022-04-01 09:07:59.621,null
2531,209,383445,전남,11826,11824,2,16060,2022-04-01 09:07:59.621,null
2532,572,405421,전북,10640,10640,0,16059,2022-04-01 09:07:59.621,null
2533,584,491428,충남,13145,13145,0,16058,2022-04-01 09:07:59.621,null
2534,468,381142,충북,10164,10159,5,16057,2022-04-01 09:07:59.621,null
2535,484,343213,강원,9064,9064,0,16056,2022-04-01 09:07:59.62,null
2536,4400,3713377,경기,75627,75626,1,16055,2022-04-01 09:07:59.62,null
2537,26,96207,세종,2729,2729,0,16054,2022-04-01 09:07:59.62,null
2538,251,272729,울산,5813,5813,0,16053,2022-04-01 09:07:59.62,null
2539,430,351789,대전,8093,8093,0,16052,2022-04-01 09:07:59.619,null
2540,358,369269,광주,9286,9286,0,16051,2022-04-01 09:07:59.619,null
2541,1048,831419,인천,14797,14797,0,16050,2022-04-01 09:07:59.619,null
2542,944,535262,대구,11382,11382,0,16049,2022-04-01 09:07:59.619,null
2543,1554,902585,부산,11855,11855,0,16048,2022-04-01 09:07:59.619,null
2544,3608,2810973,서울,51717,51717,0,16047,2022-04-01 09:07:59.618,null
2545,16590,13375818,합계,280273,280225,48,16046,2022-04-01 09:07:59.618,null
2546,16,10670,검역,10,0,10,16045,2022-03-31 09:08:16.599,null
2547,102,164289,제주,5074,5074,0,16044,2022-03-31 09:08:16.598,null
2548,732,784309,경남,19315,19314,1,16043,2022-03-31 09:08:16.598,null
2549,751,494158,경북,14691,14681,10,16042,2022-03-31 09:08:16.598,null
2550,199,371620,전남,13707,13706,1,16041,2022-03-31 09:08:16.597,null
2551,558,394784,전북,11295,11294,1,16040,2022-03-31 09:08:16.597,null
2552,572,478287,충남,14364,14364,0,16039,2022-03-31 09:08:16.597,null
2553,445,370985,충북,11322,11322,0,16038,2022-03-31 09:08:16.596,null
2554,473,334151,강원,10665,10665,0,16037,2022-03-31 09:08:16.596,null
2555,4333,3637764,경기,84657,84657,0,16036,2022-03-31 09:08:16.596,null
2556,23,93479,세종,3892,3892,0,16035,2022-03-31 09:08:16.595,null
2557,236,266917,울산,6307,6307,0,16034,2022-03-31 09:08:16.595,null
2558,418,343696,대전,10058,10058,0,16033,2022-03-31 09:08:16.594,null
2559,341,359985,광주,11362,11361,1,16032,2022-03-31 09:08:16.593,null
2560,1017,816626,인천,18128,18128,0,16031,2022-03-31 09:08:16.593,null
2561,929,523883,대구,12712,12712,0,16030,2022-03-31 09:08:16.593,null
2562,1522,890734,부산,13053,13053,0,16029,2022-03-31 09:08:16.592,null
2563,3563,2759294,서울,60131,60131,0,16028,2022-03-31 09:08:16.592,null
2564,16230,13095631,합계,320743,320719,24,16027,2022-03-31 09:08:16.592,null
2565,16,10660,검역,20,0,20,16026,2022-03-30 09:17:59.076,null
2566,88,159215,제주,5744,5744,0,16025,2022-03-30 09:17:59.076,null
2567,689,764996,경남,27038,27037,1,16024,2022-03-30 09:17:59.076,null
2568,725,479469,경북,20165,20161,4,16023,2022-03-30 09:17:59.076,null
2569,191,357916,전남,17462,17462,0,16022,2022-03-30 09:17:59.076,null
2570,536,383493,전북,13253,13248,5,16021,2022-03-30 09:17:59.075,null
2571,560,463926,충남,18969,18969,0,16020,2022-03-30 09:17:59.075,null
2572,429,359663,충북,15579,15579,0,16019,2022-03-30 09:17:59.075,null
2573,461,323486,강원,13113,13113,0,16018,2022-03-30 09:17:59.075,null
2574,4256,3553139,경기,117029,117029,0,16017,2022-03-30 09:17:59.074,null
2575,21,89587,세종,4248,4248,0,16016,2022-03-30 09:17:59.074,null
2576,236,260612,울산,9094,9094,0,16015,2022-03-30 09:17:59.074,null
2577,409,333638,대전,11252,11252,0,16014,2022-03-30 09:17:59.074,null
2578,332,348623,광주,12301,12299,2,16013,2022-03-30 09:17:59.074,null
2579,1001,798508,인천,23261,23261,0,16012,2022-03-30 09:17:59.073,null
2580,912,511173,대구,17842,17842,0,16011,2022-03-30 09:17:59.073,null
2581,1479,877689,부산,16447,16447,0,16010,2022-03-30 09:17:59.073,null
2582,3514,2699163,서울,81824,81824,0,16009,2022-03-30 09:17:59.073,null
2583,15855,12774956,합계,424641,424609,32,16008,2022-03-30 09:17:59.072,null
2584,16,10640,검역,20,0,20,15988,2022-03-29 09:13:04.177,null
2585,88,153473,제주,3329,3329,0,15987,2022-03-29 09:13:04.177,null
2586,659,737964,경남,22498,22496,2,15986,2022-03-29 09:13:04.176,null
2587,700,459307,경북,14911,14910,1,15985,2022-03-29 09:13:04.176,null
2588,185,340454,전남,13632,13632,0,15984,2022-03-29 09:13:04.176,null
2589,509,370244,전북,15098,15092,6,15983,2022-03-29 09:13:04.176,null
2590,540,444965,충남,13997,13997,0,15982,2022-03-29 09:13:04.176,null
2591,415,344094,충북,13075,13073,2,15981,2022-03-29 09:13:04.175,null
2592,446,310379,강원,10508,10508,0,15980,2022-03-29 09:13:04.175,null
2593,4147,3436151,경기,88702,88695,7,15979,2022-03-29 09:13:04.175,null
2594,21,85341,세종,2476,2476,0,15978,2022-03-29 09:13:04.175,null
2595,226,251519,울산,7573,7573,0,15977,2022-03-29 09:13:04.174,null
2596,395,322386,대전,11124,11124,0,15976,2022-03-29 09:13:04.174,null
2597,323,336322,광주,7920,7918,2,15975,2022-03-29 09:13:04.174,null
2598,982,775252,인천,18826,18826,0,15974,2022-03-29 09:13:04.173,null
2599,882,493331,대구,17817,17817,0,15973,2022-03-29 09:13:04.173,null
2600,1435,861246,부산,19969,19969,0,15972,2022-03-29 09:13:04.173,null
2601,3454,2617360,서울,66079,66078,1,15971,2022-03-29 09:13:04.172,null
2602,15423,12350428,합계,347554,347513,41,15970,2022-03-29 09:13:04.172,null
2603,16,10620,검역,15,0,15,15969,2022-03-28 09:07:47.395,null
2604,88,150144,제주,3000,3000,0,15968,2022-03-28 09:07:47.394,null
2605,637,715474,경남,11623,11622,1,15967,2022-03-28 09:07:47.394,null
2606,676,444400,경북,9401,9400,1,15966,2022-03-28 09:07:47.393,null
2607,183,326825,전남,8398,8397,1,15965,2022-03-28 09:07:47.393,null
2608,495,355147,전북,6942,6942,0,15964,2022-03-28 09:07:47.392,null
2609,532,430974,충남,7956,7956,0,15963,2022-03-28 09:07:47.392,null
2610,405,331028,충북,5835,5834,1,15962,2022-03-28 09:07:47.391,null
2611,432,299871,강원,6935,6931,4,15961,2022-03-28 09:07:47.391,null
2612,4100,3347478,경기,50574,50574,0,15960,2022-03-28 09:07:47.39,null
2613,21,82866,세종,2218,2218,0,15959,2022-03-28 09:07:47.39,null
2614,223,243949,울산,3759,3759,0,15958,2022-03-28 09:07:47.389,null
2615,391,311280,대전,5281,5281,0,15957,2022-03-28 09:07:47.389,null
2616,315,328402,광주,7481,7481,0,15956,2022-03-28 09:07:47.388,null
2617,972,756426,인천,11727,11726,1,15955,2022-03-28 09:07:47.388,null
2618,874,475520,대구,5232,5232,0,15954,2022-03-28 09:07:47.387,null
2619,1414,841323,부산,6646,6646,0,15953,2022-03-28 09:07:47.387,null
2620,3412,2551327,서울,34190,34189,1,15952,2022-03-28 09:07:47.386,null
2621,15186,12003054,합계,187213,187188,25,15951,2022-03-28 09:07:47.386,null
2622,16,10605,검역,16,0,16,15950,2022-03-27 08:53:44.073,null
2623,84,147144,제주,5010,5010,0,15949,2022-03-27 08:53:44.073,null
2624,620,703851,경남,20553,20550,3,15948,2022-03-27 08:53:44.073,null
2625,654,434999,경북,14675,14672,3,15947,2022-03-27 08:53:44.073,null
2626,179,318427,전남,12294,12292,2,15946,2022-03-27 08:53:44.073,null
2627,481,348205,전북,10848,10848,0,15945,2022-03-27 08:53:44.072,null
2628,519,423018,충남,13791,13791,0,15944,2022-03-27 08:53:44.072,null
2629,397,325193,충북,10807,10807,0,15943,2022-03-27 08:53:44.072,null
2630,427,292936,강원,9260,9256,4,15942,2022-03-27 08:53:44.072,null
2631,4032,3296904,경기,85382,85377,5,15941,2022-03-27 08:53:44.071,null
2632,20,80648,세종,2344,2344,0,15940,2022-03-27 08:53:44.071,null
2633,216,240190,울산,6861,6861,0,15939,2022-03-27 08:53:44.071,null
2634,388,305999,대전,8963,8963,0,15938,2022-03-27 08:53:44.071,null
2635,307,320921,광주,8933,8932,1,15937,2022-03-27 08:53:44.071,null
2636,954,744699,인천,21570,21561,9,15936,2022-03-27 08:53:44.07,null
2637,851,470288,대구,13218,13218,0,15935,2022-03-27 08:53:44.07,null
2638,1382,834677,부산,14454,14454,0,15934,2022-03-27 08:53:44.07,null
2639,3372,2517137,서울,59151,59151,0,15933,2022-03-27 08:53:44.07,null
2640,14899,11815841,합계,318130,318087,43,15932,2022-03-27 08:53:44.069,null
2641,16,10589,검역,36,0,36,15931,2022-03-26 08:59:54.173,null
2642,76,142134,제주,4082,4082,0,15930,2022-03-26 08:59:54.173,null
2643,602,683298,경남,22679,22676,3,15929,2022-03-26 08:59:54.173,null
2644,641,420324,경북,15173,15173,0,15928,2022-03-26 08:59:54.173,null
2645,176,306133,전남,12849,12848,1,15927,2022-03-26 08:59:54.172,null
2646,468,337357,전북,12202,12200,2,15926,2022-03-26 08:59:54.172,null
2647,510,409227,충남,13167,13167,0,15925,2022-03-26 08:59:54.172,null
2648,385,314386,충북,11616,11614,2,15924,2022-03-26 08:59:54.172,null
2649,409,283676,강원,10043,10041,2,15923,2022-03-26 08:59:54.172,null
2650,3966,3211522,경기,90775,90775,0,15922,2022-03-26 08:59:54.171,null
2651,19,78304,세종,3007,3007,0,15921,2022-03-26 08:59:54.171,null
2652,212,233329,울산,7450,7450,0,15920,2022-03-26 08:59:54.171,null
2653,376,297036,대전,11202,11202,0,15919,2022-03-26 08:59:54.171,null
2654,303,311988,광주,9909,9907,2,15918,2022-03-26 08:59:54.17,null
2655,933,723129,인천,16785,16785,0,15917,2022-03-26 08:59:54.17,null
2656,848,457070,대구,14217,14217,0,15916,2022-03-26 08:59:54.17,null
2657,1334,820223,부산,16362,16362,0,15915,2022-03-26 08:59:54.17,null
2658,3343,2457986,서울,64026,64025,1,15914,2022-03-26 08:59:54.169,null
2659,14617,11497711,합계,335580,335531,49,15913,2022-03-26 08:59:54.169,null
2660,16,10553,검역,13,0,13,15912,2022-03-25 10:29:02.901,null
2661,75,138052,제주,4789,4789,0,15911,2022-03-25 10:29:02.901,null
2662,579,660619,경남,21666,21664,2,15910,2022-03-25 10:29:02.901,null
2663,620,405151,경북,15061,15057,4,15909,2022-03-25 10:29:02.901,null
2664,168,293285,전남,12670,12670,0,15908,2022-03-25 10:29:02.9,null
2665,450,325155,전북,12826,12824,2,15907,2022-03-25 10:29:02.9,null
2666,498,396078,충남,13817,13817,0,15906,2022-03-25 10:29:02.9,null
2667,372,302786,충북,11556,11556,0,15905,2022-03-25 10:29:02.9,null
2668,396,273633,강원,10542,10542,0,15904,2022-03-25 10:29:02.9,null
2669,3883,3120770,경기,87705,87703,2,15903,2022-03-25 10:29:02.899,null
2670,18,75297,세종,3486,3486,0,15902,2022-03-25 10:29:02.899,null
2671,210,225881,울산,7433,7433,0,15901,2022-03-25 10:29:02.899,null
2672,372,285834,대전,8258,8258,0,15900,2022-03-25 10:29:02.899,null
2673,297,302079,광주,10263,10259,4,15899,2022-03-25 10:29:02.898,null
2674,903,706346,인천,21773,21773,0,15898,2022-03-25 10:29:02.898,null
2675,827,442857,대구,14008,14008,0,15897,2022-03-25 10:29:02.898,null
2676,1303,803861,부산,16705,16705,0,15896,2022-03-25 10:29:02.898,null
2677,3307,2393995,서울,66943,66941,2,15895,2022-03-25 10:29:02.897,null
2678,14294,11162232,합계,339514,339485,29,15894,2022-03-25 10:29:02.897,null
2679,16,10540,검역,38,0,38,15874,2022-03-24 09:07:07.094,null
2680,73,133263,제주,5030,5030,0,15873,2022-03-24 09:07:07.093,null
2681,543,638957,경남,25067,25066,1,15872,2022-03-24 09:07:07.093,null
2682,604,390093,경북,18101,18090,11,15871,2022-03-24 09:07:07.093,null
2683,164,280617,전남,13691,13690,1,15870,2022-03-24 09:07:07.093,null
2684,420,312335,전북,12916,12914,2,15869,2022-03-24 09:07:07.093,null
2685,486,382261,충남,16432,16432,0,15868,2022-03-24 09:07:07.092,null
2686,358,291231,충북,12587,12586,1,15867,2022-03-24 09:07:07.092,null
2687,376,263091,강원,11527,11521,6,15866,2022-03-24 09:07:07.092,null
2688,3793,3033103,경기,107472,107472,0,15865,2022-03-24 09:07:07.092,null
2689,17,71811,세종,3746,3746,0,15864,2022-03-24 09:07:07.091,null
2690,204,218451,울산,8356,8356,0,15863,2022-03-24 09:07:07.091,null
2691,362,277576,대전,11270,11270,0,15862,2022-03-24 09:07:07.091,null
2692,285,291820,광주,12465,12463,2,15861,2022-03-24 09:07:07.091,null
2693,871,684576,인천,24691,24689,2,15860,2022-03-24 09:07:07.091,null
2694,814,428852,대구,15700,15700,0,15859,2022-03-24 09:07:07.09,null
2695,1268,787179,부산,18739,18738,1,15858,2022-03-24 09:07:07.09,null
2696,3248,2327080,서울,77770,77768,2,15857,2022-03-24 09:07:07.09,null
2697,13902,10822836,합계,395598,395531,67,15856,2022-03-24 09:07:07.089,null
2698,16,10502,검역,27,0,27,15855,2022-03-23 09:21:12.531,null
2699,70,128233,제주,5571,5571,0,15854,2022-03-23 09:21:12.531,null
2700,500,613890,경남,32193,32190,3,15853,2022-03-23 09:21:12.53,null
2701,579,371992,경북,20786,20784,2,15852,2022-03-23 09:21:12.53,null
2702,155,266926,전남,15432,15430,2,15851,2022-03-23 09:21:12.53,null
2703,391,299419,전북,15909,15905,4,15850,2022-03-23 09:21:12.53,null
2704,473,365829,충남,18877,18877,0,15849,2022-03-23 09:21:12.529,null
2705,350,278644,충북,16656,16655,1,15848,2022-03-23 09:21:12.529,null
2706,359,251564,강원,14320,14319,1,15847,2022-03-23 09:21:12.529,null
2707,3679,2925631,경기,136912,136912,0,15846,2022-03-23 09:21:12.529,null
2708,15,68065,세종,3452,3452,0,15845,2022-03-23 09:21:12.529,null
2709,190,210095,울산,11031,11031,0,15844,2022-03-23 09:21:12.528,null
2710,353,266306,대전,14526,14526,0,15843,2022-03-23 09:21:12.528,null
2711,272,279355,광주,12187,12185,2,15842,2022-03-23 09:21:12.528,null
2712,852,659886,인천,24941,24941,0,15841,2022-03-23 09:21:12.528,null
2713,798,413152,대구,20866,20866,0,15840,2022-03-23 09:21:12.527,null
2714,1193,768448,부산,26062,26062,0,15839,2022-03-23 09:21:12.527,null
2715,3187,2249310,서울,101133,101133,0,15838,2022-03-23 09:21:12.527,null
2716,13432,10427247,합계,490881,490839,42,15837,2022-03-23 09:21:12.527,null
2717,16,10475,검역,34,0,34,15836,2022-03-22 11:08:27.651,null
2718,67,122662,제주,3191,3191,0,15835,2022-03-22 11:08:27.651,null
2719,477,581709,경남,24707,24703,4,15834,2022-03-22 11:08:27.651,null
2720,562,351205,경북,14432,14429,3,15833,2022-03-22 11:08:27.651,null
2721,140,251499,전남,12280,12279,1,15832,2022-03-22 11:08:27.65,null
2722,380,283511,전북,12584,12584,0,15831,2022-03-22 11:08:27.65,null
2723,466,346953,충남,15152,15152,0,15830,2022-03-22 11:08:27.65,null
2724,344,262002,충북,11829,11828,1,15829,2022-03-22 11:08:27.65,null
2725,344,237251,강원,10428,10428,0,15828,2022-03-22 11:08:27.649,null
2726,3609,2788761,경기,96257,96256,1,15827,2022-03-22 11:08:27.649,null
2727,14,64613,세종,3334,3334,0,15826,2022-03-22 11:08:27.649,null
2728,188,199065,울산,8224,8224,0,15825,2022-03-22 11:08:27.649,null
2729,340,251780,대전,9873,9873,0,15824,2022-03-22 11:08:27.648,null
2730,271,267168,광주,6986,6985,1,15823,2022-03-22 11:08:27.648,null
2731,838,634945,인천,17569,17568,1,15822,2022-03-22 11:08:27.647,null
2732,783,392298,대구,17360,17360,0,15821,2022-03-22 11:08:27.647,null
2733,1158,742457,부산,24707,24707,0,15820,2022-03-22 11:08:27.646,null
2734,3144,2148186,서울,65033,65033,0,15819,2022-03-22 11:08:27.646,null
2735,13141,9936540,합계,353980,353934,46,15818,2022-03-22 11:08:27.645,null
2736,16,10442,검역,22,0,22,15798,2022-03-21 09:53:01.159,null
2737,62,119471,제주,3292,3292,0,15797,2022-03-21 09:53:01.159,null
2738,438,557019,경남,11970,11968,2,15796,2022-03-21 09:53:01.158,null
2739,545,336778,경북,9776,9768,8,15795,2022-03-21 09:53:01.158,null
2740,128,239233,전남,6857,6857,0,15794,2022-03-21 09:53:01.157,null
2741,366,270954,전북,7899,7898,1,15793,2022-03-21 09:53:01.156,null
2742,444,331801,충남,8727,8727,0,15792,2022-03-21 09:53:01.156,null
2743,334,250183,충북,5375,5374,1,15791,2022-03-21 09:53:01.155,null
2744,327,226823,강원,6610,6607,3,15790,2022-03-21 09:53:01.155,null
2745,3525,2692548,경기,56909,56909,0,15789,2022-03-21 09:53:01.154,null
2746,13,61279,세종,2370,2370,0,15788,2022-03-21 09:53:01.154,null
2747,178,190902,울산,4239,4239,0,15787,2022-03-21 09:53:01.153,null
2748,337,241907,대전,8390,8390,0,15786,2022-03-21 09:53:01.153,null
2749,261,260184,광주,8461,8460,1,15785,2022-03-21 09:53:01.152,null
2750,813,617378,인천,12086,12086,0,15784,2022-03-21 09:53:01.152,null
2751,760,374944,대구,6131,6131,0,15783,2022-03-21 09:53:01.151,null
2752,1112,717781,부산,8977,8977,0,15782,2022-03-21 09:53:01.151,null
2753,3098,2083188,서울,41078,41078,0,15781,2022-03-21 09:53:01.15,null
2754,12757,9582815,합계,209169,209131,38,15780,2022-03-21 09:53:01.15,null
2755,16,10420,검역,15,0,15,15779,2022-03-20 09:23:26.386,null
2756,60,116179,제주,6228,6228,0,15778,2022-03-20 09:23:26.386,null
2757,414,545049,경남,24336,24335,1,15777,2022-03-20 09:23:26.385,null
2758,534,327002,경북,12990,12990,0,15776,2022-03-20 09:23:26.385,null
2759,116,232376,전남,10898,10898,0,15775,2022-03-20 09:23:26.385,null
2760,348,263055,전북,9685,9684,1,15774,2022-03-20 09:23:26.385,null
2761,430,323074,충남,12645,12645,0,15773,2022-03-20 09:23:26.384,null
2762,324,244808,충북,11272,11272,0,15772,2022-03-20 09:23:26.384,null
2763,314,220213,강원,9197,9196,1,15771,2022-03-20 09:23:26.384,null
2764,3454,2635639,경기,88480,88479,1,15770,2022-03-20 09:23:26.384,null
2765,13,58909,세종,1951,1951,0,15769,2022-03-20 09:23:26.384,null
2766,167,186663,울산,7321,7321,0,15768,2022-03-20 09:23:26.383,null
2767,336,233517,대전,11485,11485,0,15767,2022-03-20 09:23:26.383,null
2768,248,251723,광주,10031,10028,3,15766,2022-03-20 09:23:26.383,null
2769,789,605292,인천,19149,19149,0,15765,2022-03-20 09:23:26.383,null
2770,749,368813,대구,13612,13612,0,15764,2022-03-20 09:23:26.382,null
2771,1057,708804,부산,19543,19543,0,15763,2022-03-20 09:23:26.382,null
2772,3059,2042110,서울,65870,65870,0,15762,2022-03-20 09:23:26.382,null
2773,12428,9373646,합계,334708,334686,22,15761,2022-03-20 09:23:26.382,null
2774,16,10405,검역,46,0,46,15760,2022-03-19 09:21:12.968,null
2775,55,109951,제주,6393,6393,0,15759,2022-03-19 09:21:12.968,null
2776,388,520713,경남,22734,22732,2,15758,2022-03-19 09:21:12.967,null
2777,519,314012,경북,14946,14942,4,15757,2022-03-19 09:21:12.967,null
2778,110,221478,전남,10778,10775,3,15756,2022-03-19 09:21:12.967,null
2779,330,253370,전북,9923,9922,1,15755,2022-03-19 09:21:12.967,null
2780,418,310429,충남,15626,15625,1,15754,2022-03-19 09:21:12.967,null
2781,313,233536,충북,11972,11972,0,15753,2022-03-19 09:21:12.966,null
2782,306,211016,강원,10542,10540,2,15752,2022-03-19 09:21:12.966,null
2783,3390,2547159,경기,101526,101523,3,15751,2022-03-19 09:21:12.966,null
2784,12,56958,세종,3121,3121,0,15750,2022-03-19 09:21:12.966,null
2785,147,179342,울산,7853,7853,0,15749,2022-03-19 09:21:12.965,null
2786,331,222032,대전,10854,10854,0,15748,2022-03-19 09:21:12.965,null
2787,238,241692,광주,11566,11565,1,15747,2022-03-19 09:21:12.965,null
2788,762,586143,인천,20838,20838,0,15746,2022-03-19 09:21:12.965,null
2789,734,355201,대구,14845,14845,0,15745,2022-03-19 09:21:12.964,null
2790,1017,689261,부산,25759,25759,0,15744,2022-03-19 09:21:12.964,null
2791,3015,1976240,서울,82132,82132,0,15743,2022-03-19 09:21:12.964,null
2792,12101,9038938,합계,381454,381391,63,15742,2022-03-19 09:21:12.963,null
2793,16,10359,검역,22,0,22,15741,2022-03-18 09:10:32.413,null
2794,50,103558,제주,4412,4412,0,15740,2022-03-18 09:10:32.413,null
2795,373,497988,경남,23737,23731,6,15739,2022-03-18 09:10:32.412,null
2796,507,299071,경북,18032,18029,3,15738,2022-03-18 09:10:32.412,null
2797,105,210710,전남,11364,11363,1,15737,2022-03-18 09:10:32.412,null
2798,320,243447,전북,10889,10888,1,15736,2022-03-18 09:10:32.412,null
2799,401,294803,충남,14242,14242,0,15735,2022-03-18 09:10:32.411,null
2800,293,221613,충북,12172,12170,2,15734,2022-03-18 09:10:32.411,null
2801,295,200476,강원,11401,11401,0,15733,2022-03-18 09:10:32.411,null
2802,3325,2445654,경기,113673,113673,0,15732,2022-03-18 09:10:32.411,null
2803,12,53837,세종,3116,3116,0,15731,2022-03-18 09:10:32.41,null
2804,142,171489,울산,7866,7866,0,15730,2022-03-18 09:10:32.41,null
2805,328,211178,대전,11332,11332,0,15729,2022-03-18 09:10:32.41,null
2806,228,230126,광주,15447,15444,3,15728,2022-03-18 09:10:32.409,null
2807,740,565315,인천,25798,25797,1,15727,2022-03-18 09:10:32.409,null
2808,722,340360,대구,16013,16013,0,15726,2022-03-18 09:10:32.409,null
2809,957,663512,부산,25504,25504,0,15725,2022-03-18 09:10:32.409,null
2810,2968,1894113,서울,81997,81997,0,15724,2022-03-18 09:10:32.408,null
2811,11782,8657609,합계,407017,406978,39,15723,2022-03-18 09:10:32.408,null
2812,16,10337,검역,23,0,23,15722,2022-03-17 09:26:58.427,null
2813,48,99146,제주,4144,4144,0,15721,2022-03-17 09:26:58.427,null
2814,350,474251,경남,44539,44536,3,15720,2022-03-17 09:26:58.426,null
2815,495,281039,경북,19167,19157,10,15719,2022-03-17 09:26:58.426,null
2816,99,199346,전남,18958,18957,1,15718,2022-03-17 09:26:58.426,null
2817,314,232558,전북,18611,18607,4,15717,2022-03-17 09:26:58.426,null
2818,379,280561,충남,22989,22987,2,15716,2022-03-17 09:26:58.425,null
2819,274,209441,충북,17780,17774,6,15715,2022-03-17 09:26:58.425,null
2820,286,189075,강원,15449,15449,0,15714,2022-03-17 09:26:58.425,null
2821,3261,2331981,경기,181994,181983,11,15713,2022-03-17 09:26:58.424,null
2822,12,50721,세종,5234,5234,0,15712,2022-03-17 09:26:58.424,null
2823,139,163623,울산,14768,14768,0,15711,2022-03-17 09:26:58.424,null
2824,322,199846,대전,12481,12481,0,15710,2022-03-17 09:26:58.424,null
2825,214,214679,광주,16948,16948,0,15709,2022-03-17 09:26:58.423,null
2826,714,539517,인천,32965,32964,1,15708,2022-03-17 09:26:58.423,null
2827,707,324347,대구,24468,24468,0,15707,2022-03-17 09:26:58.423,null
2828,924,638008,부산,42435,42434,1,15706,2022-03-17 09:26:58.422,null
2829,2927,1812116,서울,128375,128375,0,15705,2022-03-17 09:26:58.422,null
2830,11481,8250592,합계,621328,621266,62,15704,2022-03-17 09:26:58.421,null
2831,16,10314,검역,61,0,61,15703,2022-03-16 09:11:12.25,null
2832,46,95002,제주,7682,7680,2,15702,2022-03-16 09:11:12.249,null
2833,324,429712,경남,21898,21896,2,15701,2022-03-16 09:11:12.249,null
2834,485,261872,경북,16782,16780,2,15700,2022-03-16 09:11:12.249,null
2835,90,180388,전남,9314,9309,5,15699,2022-03-16 09:11:12.249,null
2836,297,213947,전북,15397,15390,7,15698,2022-03-16 09:11:12.248,null
2837,365,257572,충남,13702,13702,0,15697,2022-03-16 09:11:12.248,null
2838,264,191661,충북,13755,13751,4,15696,2022-03-16 09:11:12.248,null
2839,268,173626,강원,9653,9649,4,15695,2022-03-16 09:11:12.248,null
2840,3176,2149993,경기,94809,94806,3,15694,2022-03-16 09:11:12.247,null
2841,8,45487,세종,2032,2032,0,15693,2022-03-16 09:11:12.247,null
2842,133,148855,울산,10364,10362,2,15692,2022-03-16 09:11:12.247,null
2843,313,187365,대전,8813,8812,1,15691,2022-03-16 09:11:12.247,null
2844,202,197731,광주,10426,10422,4,15690,2022-03-16 09:11:12.247,null
2845,666,506552,인천,28464,28453,11,15689,2022-03-16 09:11:12.246,null
2846,686,299879,대구,16756,16749,7,15688,2022-03-16 09:11:12.246,null
2847,853,595574,부산,39438,39436,2,15687,2022-03-16 09:11:12.246,null
2848,2860,1683745,서울,81395,81395,0,15686,2022-03-16 09:11:12.246,null
2849,11052,7629275,합계,400741,400624,117,15685,2022-03-16 09:11:12.245,null
2850,16,10253,검역,28,0,28,15684,2022-03-15 09:12:45.854,null
2851,44,87320,제주,3900,3900,0,15683,2022-03-15 09:12:45.854,null
2852,305,407816,경남,23941,23939,2,15682,2022-03-15 09:12:45.853,null
2853,479,245090,경북,14540,14536,4,15681,2022-03-15 09:12:45.853,null
2854,88,171077,전남,11454,11451,3,15680,2022-03-15 09:12:45.853,null
2855,291,198550,전북,11259,11257,2,15679,2022-03-15 09:12:45.853,null
2856,358,243870,충남,16287,16287,0,15678,2022-03-15 09:12:45.853,null
2857,255,177907,충북,10928,10923,5,15677,2022-03-15 09:12:45.852,null
2858,261,163973,강원,9706,9705,1,15676,2022-03-15 09:12:45.852,null
2859,3148,2055186,경기,102984,102983,1,15675,2022-03-15 09:12:45.852,null
2860,8,43455,세종,2514,2514,0,15674,2022-03-15 09:12:45.852,null
2861,132,138491,울산,8302,8302,0,15673,2022-03-15 09:12:45.851,null
2862,312,178552,대전,8309,8309,0,15672,2022-03-15 09:12:45.851,null
2863,200,187305,광주,11173,11167,6,15671,2022-03-15 09:12:45.851,null
2864,658,478090,인천,20445,20444,1,15670,2022-03-15 09:12:45.851,null
2865,672,283124,대구,14350,14350,0,15669,2022-03-15 09:12:45.85,null
2866,827,556137,부산,26151,26149,2,15668,2022-03-15 09:12:45.85,null
2867,2834,1602354,서울,66067,66067,0,15667,2022-03-15 09:12:45.85,null
2868,10888,7228550,합계,362338,362283,55,15666,2022-03-15 09:12:45.85,null
2869,16,10225,검역,36,0,36,15665,2022-03-14 09:02:10.562,null
2870,41,83420,제주,4827,4827,0,15664,2022-03-14 09:02:10.562,null
2871,280,383877,경남,23767,23762,5,15663,2022-03-14 09:02:10.562,null
2872,469,230550,경북,12618,12615,3,15662,2022-03-14 09:02:10.562,null
2873,84,159623,전남,10933,10933,0,15661,2022-03-14 09:02:10.561,null
2874,277,187291,전북,11173,11168,5,15660,2022-03-14 09:02:10.561,null
2875,348,227583,충남,12329,12329,0,15659,2022-03-14 09:02:10.561,null
2876,250,166980,충북,8326,8324,2,15658,2022-03-14 09:02:10.561,null
2877,246,154267,강원,9045,9044,1,15657,2022-03-14 09:02:10.561,null
2878,3066,1952202,경기,77421,77420,1,15656,2022-03-14 09:02:10.56,null
2879,8,40941,세종,2139,2139,0,15655,2022-03-14 09:02:10.56,null
2880,130,130189,울산,5336,5336,0,15654,2022-03-14 09:02:10.56,null
2881,310,170243,대전,8290,8290,0,15653,2022-03-14 09:02:10.56,null
2882,185,176132,광주,8339,8334,5,15652,2022-03-14 09:02:10.559,null
2883,648,457646,인천,18239,18238,1,15651,2022-03-14 09:02:10.559,null
2884,656,268774,대구,12406,12406,0,15650,2022-03-14 09:02:10.559,null
2885,789,529987,부산,27759,27756,3,15649,2022-03-14 09:02:10.559,null
2886,2792,1536292,서울,56807,56807,0,15648,2022-03-14 09:02:10.558,null
2887,10595,6866222,합계,309790,309728,62,15647,2022-03-14 09:02:10.558,null
2888,16,10190,검역,16,0,16,15646,2022-03-13 09:14:31.464,null
2889,38,78593,제주,6203,6203,0,15645,2022-03-13 09:14:31.464,null
2890,271,360110,경남,26098,26096,2,15644,2022-03-13 09:14:31.464,null
2891,461,217932,경북,13773,13765,8,15643,2022-03-13 09:14:31.464,null
2892,80,148692,전남,9546,9544,2,15642,2022-03-13 09:14:31.463,null
2893,273,176118,전북,11441,11441,0,15641,2022-03-13 09:14:31.463,null
2894,344,215254,충남,10740,10740,0,15640,2022-03-13 09:14:31.463,null
2895,246,158654,충북,9997,9997,0,15639,2022-03-13 09:14:31.463,null
2896,241,145222,강원,9381,9380,1,15638,2022-03-13 09:14:31.463,null
2897,3000,1874781,경기,91470,91469,1,15637,2022-03-13 09:14:31.462,null
2898,8,38802,세종,2325,2325,0,15636,2022-03-13 09:14:31.462,null
2899,128,124853,울산,9167,9167,0,15635,2022-03-13 09:14:31.462,null
2900,305,161953,대전,8650,8650,0,15634,2022-03-13 09:14:31.462,null
2901,179,167793,광주,7193,7191,2,15633,2022-03-13 09:14:31.461,null
2902,639,439407,인천,20237,20237,0,15632,2022-03-13 09:14:31.461,null
2903,642,256368,대구,12696,12696,0,15631,2022-03-13 09:14:31.461,null
2904,756,502229,부산,33443,33442,1,15630,2022-03-13 09:14:31.461,null
2905,2768,1479502,서울,67814,67814,0,15629,2022-03-13 09:14:31.46,null
2906,10395,6556453,합계,350190,350157,33,15628,2022-03-13 09:14:31.46,null
2907,16,10174,검역,41,0,41,15627,2022-03-12 08:54:58.186,null
2908,35,72390,제주,5191,5191,0,15626,2022-03-12 08:54:58.186,null
2909,257,334012,경남,24282,24279,3,15625,2022-03-12 08:54:58.186,null
2910,446,204159,경북,13566,13558,8,15624,2022-03-12 08:54:58.185,null
2911,79,139147,전남,10218,10214,4,15623,2022-03-12 08:54:58.185,null
2912,270,164677,전북,10834,10833,1,15622,2022-03-12 08:54:58.185,null
2913,335,204514,충남,13643,13642,1,15621,2022-03-12 08:54:58.185,null
2914,236,148660,충북,9876,9871,5,15620,2022-03-12 08:54:58.184,null
2915,232,135841,강원,9434,9433,1,15619,2022-03-12 08:54:58.184,null
2916,2944,1783312,경기,107943,107941,2,15618,2022-03-12 08:54:58.184,null
2917,8,36477,세종,2512,2512,0,15617,2022-03-12 08:54:58.184,null
2918,124,115686,울산,9100,9100,0,15616,2022-03-12 08:54:58.183,null
2919,296,153303,대전,8515,8515,0,15615,2022-03-12 08:54:58.183,null
2920,166,160600,광주,8954,8948,6,15614,2022-03-12 08:54:58.183,null
2921,619,419170,인천,23738,23735,3,15613,2022-03-12 08:54:58.183,null
2922,625,243675,대구,13414,13414,0,15612,2022-03-12 08:54:58.182,null
2923,717,468786,부산,31967,31967,0,15611,2022-03-12 08:54:58.182,null
2924,2739,1411694,서울,80437,80437,0,15610,2022-03-12 08:54:58.182,null
2925,10144,6206277,합계,383665,383590,75,15609,2022-03-12 08:54:58.182,null
2926,16,10133,검역,46,0,46,15608,2022-03-11 10:11:00.459,null
2927,33,67199,제주,4289,4289,0,15607,2022-03-11 10:11:00.459,null
2928,243,309731,경남,21428,21422,6,15606,2022-03-11 10:11:00.458,null
2929,432,190593,경북,10315,10306,9,15605,2022-03-11 10:11:00.458,null
2930,77,128930,전남,8987,8984,3,15604,2022-03-11 10:11:00.458,null
2931,255,153843,전북,8852,8841,11,15603,2022-03-11 10:11:00.458,null
2932,330,190871,충남,10798,10798,0,15602,2022-03-11 10:11:00.458,null
2933,219,138784,충북,7914,7910,4,15601,2022-03-11 10:11:00.457,null
2934,225,126407,강원,7482,7480,2,15600,2022-03-11 10:11:00.457,null
2935,2883,1675373,경기,72427,72420,7,15599,2022-03-11 10:11:00.457,null
2936,6,33965,세종,1840,1840,0,15598,2022-03-11 10:11:00.457,null
2937,118,106586,울산,5261,5261,0,15597,2022-03-11 10:11:00.456,null
2938,292,144788,대전,7212,7212,0,15596,2022-03-11 10:11:00.456,null
2939,160,151646,광주,8848,8836,12,15595,2022-03-11 10:11:00.456,null
2940,595,395433,인천,17458,17457,1,15594,2022-03-11 10:11:00.456,null
2941,607,230261,대구,10307,10307,0,15593,2022-03-11 10:11:00.455,null
2942,691,436820,부산,22920,22917,3,15592,2022-03-11 10:11:00.455,null
2943,2693,1331263,서울,56603,56600,3,15591,2022-03-11 10:11:00.455,null
2944,9875,5822626,합계,282987,282880,107,15590,2022-03-11 10:11:00.455,null
2945,16,10087,검역,28,0,28,15570,2022-03-10 09:08:28.176,null
2946,30,62910,제주,4923,4923,0,15569,2022-03-10 09:08:28.175,null
2947,233,288305,경남,19412,19410,2,15568,2022-03-10 09:08:28.175,null
2948,418,180278,경북,11964,11960,4,15567,2022-03-10 09:08:28.175,null
2949,76,119947,전남,8470,8467,3,15566,2022-03-10 09:08:28.175,null
2950,244,144992,전북,10075,10072,3,15565,2022-03-10 09:08:28.175,null
2951,323,180073,충남,10666,10664,2,15564,2022-03-10 09:08:28.174,null
2952,214,130871,충북,8765,8765,0,15563,2022-03-10 09:08:28.174,null
2953,219,118925,강원,8172,8169,3,15562,2022-03-10 09:08:28.174,null
2954,2837,1602946,경기,88144,88141,3,15561,2022-03-10 09:08:28.174,null
2955,6,32125,세종,1944,1944,0,15560,2022-03-10 09:08:28.173,null
2956,113,101325,울산,8789,8789,0,15559,2022-03-10 09:08:28.173,null
2957,291,137576,대전,7884,7884,0,15558,2022-03-10 09:08:28.173,null
2958,150,142798,광주,6300,6300,0,15557,2022-03-10 09:08:28.173,null
2959,577,377975,인천,21975,21974,1,15556,2022-03-10 09:08:28.173,null
2960,587,219956,대구,11601,11601,0,15555,2022-03-10 09:08:28.172,null
2961,651,413900,부산,31578,31568,10,15554,2022-03-10 09:08:28.172,null
2962,2661,1274661,서울,66859,66859,0,15553,2022-03-10 09:08:28.172,null
2963,9646,5539650,합계,327549,327490,59,15552,2022-03-10 09:08:28.171,null
2964,16,10059,검역,22,0,22,15551,2022-03-09 09:12:03.781,null
2965,28,57987,제주,3858,3858,0,15550,2022-03-09 09:12:03.781,null
2966,225,268893,경남,22006,22001,5,15549,2022-03-09 09:12:03.78,null
2967,414,168314,경북,12287,12280,7,15548,2022-03-09 09:12:03.78,null
2968,76,111483,전남,7957,7953,4,15547,2022-03-09 09:12:03.78,null
2969,237,134917,전북,9679,9677,2,15546,2022-03-09 09:12:03.78,null
2970,320,169407,충남,10825,10825,0,15545,2022-03-09 09:12:03.779,null
2971,203,122109,충북,9149,9145,4,15544,2022-03-09 09:12:03.779,null
2972,209,110753,강원,8686,8686,0,15543,2022-03-09 09:12:03.779,null
2973,2791,1514802,경기,96684,96681,3,15542,2022-03-09 09:12:03.779,null
2974,6,30181,세종,2214,2214,0,15541,2022-03-09 09:12:03.778,null
2975,111,92536,울산,6582,6582,0,15540,2022-03-09 09:12:03.778,null
2976,286,129692,대전,7977,7977,0,15539,2022-03-09 09:12:03.778,null
2977,147,136500,광주,7418,7413,5,15538,2022-03-09 09:12:03.778,null
2978,553,356000,인천,18828,18823,5,15537,2022-03-09 09:12:03.777,null
2979,575,208359,대구,12899,12899,0,15536,2022-03-09 09:12:03.777,null
2980,613,382323,부산,31153,31152,1,15535,2022-03-09 09:12:03.777,null
2981,2630,1207803,서울,74222,74222,0,15534,2022-03-09 09:12:03.777,null
2982,9440,5212118,합계,342446,342388,58,15533,2022-03-09 09:12:03.776,null
2983,16,10037,검역,31,0,31,15532,2022-03-08 08:59:15.248,null
2984,27,54129,제주,3054,3054,0,15531,2022-03-08 08:59:15.248,null
2985,221,246887,경남,14031,14028,3,15530,2022-03-08 08:59:15.248,null
2986,412,156027,경북,7374,7368,6,15529,2022-03-08 08:59:15.248,null
2987,76,103526,전남,6014,6008,6,15528,2022-03-08 08:59:15.247,null
2988,228,125238,전북,6264,6260,4,15527,2022-03-08 08:59:15.247,null
2989,316,158582,충남,6997,6997,0,15526,2022-03-08 08:59:15.247,null
2990,198,112969,충북,5736,5733,3,15525,2022-03-08 08:59:15.247,null
2991,202,102067,강원,5460,5458,2,15524,2022-03-08 08:59:15.246,null
2992,2742,1418120,경기,52730,52729,1,15523,2022-03-08 08:59:15.246,null
2993,6,27967,세종,1349,1349,0,15522,2022-03-08 08:59:15.246,null
2994,111,85954,울산,4560,4560,0,15521,2022-03-08 08:59:15.246,null
2995,284,121715,대전,5609,5609,0,15520,2022-03-08 08:59:15.246,null
2996,141,129082,광주,6473,6461,12,15519,2022-03-08 08:59:15.245,null
2997,538,337172,인천,12606,12603,3,15518,2022-03-08 08:59:15.245,null
2998,560,195460,대구,7586,7586,0,15517,2022-03-08 08:59:15.245,null
2999,597,351170,부산,19363,19361,2,15516,2022-03-08 08:59:15.245,null
3000,2607,1133589,서울,37484,37483,1,15515,2022-03-08 08:59:15.244,null
3001,9282,4869691,합계,202721,202647,74,15514,2022-03-08 08:59:15.244,null
3002,16,10006,검역,43,0,43,15513,2022-03-07 09:07:08.618,null
3003,26,51075,제주,3233,3233,0,15512,2022-03-07 09:07:08.617,null
3004,206,232857,경남,13450,13441,9,15511,2022-03-07 09:07:08.617,null
3005,400,148653,경북,7514,7509,5,15510,2022-03-07 09:07:08.617,null
3006,73,97512,전남,5738,5734,4,15509,2022-03-07 09:07:08.617,null
3007,225,118974,전북,6065,6063,2,15508,2022-03-07 09:07:08.617,null
3008,312,151585,충남,6775,6774,1,15507,2022-03-07 09:07:08.616,null
3009,194,107233,충북,4904,4900,4,15506,2022-03-07 09:07:08.616,null
3010,191,96609,강원,5451,5451,0,15505,2022-03-07 09:07:08.616,null
3011,2700,1365390,경기,51106,51097,9,15504,2022-03-07 09:07:08.616,null
3012,6,26618,세종,1163,1163,0,15503,2022-03-07 09:07:08.615,null
3013,107,81394,울산,3913,3913,0,15502,2022-03-07 09:07:08.615,null
3014,278,116107,대전,5760,5760,0,15501,2022-03-07 09:07:08.615,null
3015,141,122609,광주,6474,6465,9,15500,2022-03-07 09:07:08.615,null
3016,522,324568,인천,15324,15323,1,15499,2022-03-07 09:07:08.615,null
3017,547,187874,대구,7789,7789,0,15498,2022-03-07 09:07:08.614,null
3018,570,331807,부산,26456,26456,0,15497,2022-03-07 09:07:08.614,null
3019,2582,1096106,서울,39558,39557,1,15496,2022-03-07 09:07:08.614,null
3020,9096,4666977,합계,210716,210628,88,15495,2022-03-07 09:07:08.614,null
3021,16,9963,검역,30,0,30,15494,2022-03-06 09:52:32.383,null
3022,26,47842,제주,3691,3691,0,15493,2022-03-06 09:52:32.383,null
3023,201,219407,경남,14425,14417,8,15492,2022-03-06 09:52:32.383,null
3024,386,141139,경북,8199,8191,8,15491,2022-03-06 09:52:32.382,null
3025,72,91774,전남,5706,5704,2,15490,2022-03-06 09:52:32.382,null
3026,217,112909,전북,6851,6840,11,15489,2022-03-06 09:52:32.382,null
3027,304,144810,충남,7286,7285,1,15488,2022-03-06 09:52:32.382,null
3028,188,102331,충북,6239,6230,9,15487,2022-03-06 09:52:32.381,null
3029,184,91158,강원,5709,5702,7,15486,2022-03-06 09:52:32.381,null
3030,2688,1314285,경기,66837,66833,4,15485,2022-03-06 09:52:32.381,null
3031,6,25455,세종,1384,1384,0,15484,2022-03-06 09:52:32.381,null
3032,103,77481,울산,5015,5015,0,15483,2022-03-06 09:52:32.381,null
3033,272,110347,대전,6189,6189,0,15482,2022-03-06 09:52:32.38,null
3034,140,116135,광주,6657,6656,1,15481,2022-03-06 09:52:32.38,null
3035,511,309244,인천,14859,14854,5,15480,2022-03-06 09:52:32.38,null
3036,529,180085,대구,8896,8896,0,15479,2022-03-06 09:52:32.38,null
3037,555,305351,부산,26205,26204,1,15478,2022-03-06 09:52:32.379,null
3038,2559,1056548,서울,49450,49449,1,15477,2022-03-06 09:52:32.379,null
3039,8957,4456264,합계,243628,243540,88,15476,2022-03-06 09:52:32.379,null
3040,16,9933,검역,38,0,38,15475,2022-03-05 09:46:18.265,null
3041,26,44154,제주,3285,3285,0,15474,2022-03-05 09:46:18.264,null
3042,190,204982,경남,15155,15146,9,15473,2022-03-05 09:46:18.264,null
3043,379,132943,경북,8221,8219,2,15472,2022-03-05 09:46:18.264,null
3044,71,86068,전남,5967,5966,1,15471,2022-03-05 09:46:18.263,null
3045,214,106058,전북,6988,6980,8,15470,2022-03-05 09:46:18.263,null
3046,300,137524,충남,8010,8010,0,15469,2022-03-05 09:46:18.263,null
3047,184,96096,충북,6948,6944,4,15468,2022-03-05 09:46:18.263,null
3048,178,85449,강원,5916,5915,1,15467,2022-03-05 09:46:18.263,null
3049,2654,1247452,경기,70244,70243,1,15466,2022-03-05 09:46:18.262,null
3050,6,24071,세종,1458,1458,0,15465,2022-03-05 09:46:18.262,null
3051,100,72466,울산,5581,5581,0,15464,2022-03-05 09:46:18.262,null
3052,264,104159,대전,5693,5693,0,15463,2022-03-05 09:46:18.262,null
3053,135,109478,광주,7407,7398,9,15462,2022-03-05 09:46:18.261,null
3054,489,294385,인천,18838,18838,0,15461,2022-03-05 09:46:18.261,null
3055,518,171189,대구,9563,9563,0,15460,2022-03-05 09:46:18.261,null
3056,539,279146,부산,21822,21820,2,15459,2022-03-05 09:46:18.261,null
3057,2533,1007099,서울,53193,53191,2,15458,2022-03-05 09:46:18.26,null
3058,8796,4212652,합계,254327,254250,77,15457,2022-03-05 09:46:18.26,null
3059,16,9895,검역,35,0,35,15456,2022-03-04 09:00:59.555,null
3060,24,40869,제주,3399,3399,0,15455,2022-03-04 09:00:59.554,null
3061,182,189827,경남,15999,15991,8,15454,2022-03-04 09:00:59.554,null
3062,367,124722,경북,8382,8373,9,15453,2022-03-04 09:00:59.554,null
3063,66,80102,전남,6412,6409,3,15452,2022-03-04 09:00:59.554,null
3064,204,99070,전북,6539,6536,3,15451,2022-03-04 09:00:59.553,null
3065,288,129514,충남,8263,8263,0,15450,2022-03-04 09:00:59.553,null
3066,175,89148,충북,6743,6737,6,15449,2022-03-04 09:00:59.553,null
3067,172,79533,강원,5585,5584,1,15448,2022-03-04 09:00:59.553,null
3068,2604,1177208,경기,76726,76722,4,15447,2022-03-04 09:00:59.553,null
3069,6,22613,세종,1577,1577,0,15446,2022-03-04 09:00:59.552,null
3070,99,66885,울산,5813,5813,0,15445,2022-03-04 09:00:59.552,null
3071,255,98466,대전,5958,5958,0,15444,2022-03-04 09:00:59.552,null
3072,127,102071,광주,6774,6768,6,15443,2022-03-04 09:00:59.552,null
3073,471,275547,인천,16683,16681,2,15442,2022-03-04 09:00:59.551,null
3074,507,161626,대구,9494,9491,3,15441,2022-03-04 09:00:59.551,null
3075,515,257324,부산,23202,23200,2,15440,2022-03-04 09:00:59.551,null
3076,2502,953906,서울,59269,59269,0,15439,2022-03-04 09:00:59.551,null
3077,8580,3958326,합계,266853,266771,82,15438,2022-03-04 09:00:59.55,null
3078,16,9860,검역,23,0,23,15437,2022-03-03 09:09:31.369,null
3079,23,37470,제주,3294,3294,0,15436,2022-03-03 09:09:31.369,null
3080,174,173828,경남,11944,11942,2,15435,2022-03-03 09:09:31.369,null
3081,355,116340,경북,6533,6529,4,15434,2022-03-03 09:09:31.368,null
3082,63,73690,전남,5244,5240,4,15433,2022-03-03 09:09:31.368,null
3083,195,92532,전북,5285,5280,5,15432,2022-03-03 09:09:31.368,null
3084,282,121252,충남,6639,6639,0,15431,2022-03-03 09:09:31.368,null
3085,168,82410,충북,4829,4820,9,15430,2022-03-03 09:09:31.367,null
3086,165,73948,강원,4615,4615,0,15429,2022-03-03 09:09:31.367,null
3087,2563,1100482,경기,51943,51941,2,15428,2022-03-03 09:09:31.367,null
3088,6,21036,세종,1022,1022,0,15427,2022-03-03 09:09:31.367,null
3089,99,61072,울산,3389,3389,0,15426,2022-03-03 09:09:31.367,null
3090,247,92508,대전,5067,5067,0,15425,2022-03-03 09:09:31.366,null
3091,125,95297,광주,6998,6994,4,15424,2022-03-03 09:09:31.366,null
3092,455,258867,인천,15964,15964,0,15423,2022-03-03 09:09:31.366,null
3093,495,152133,대구,8080,8080,0,15422,2022-03-03 09:09:31.366,null
3094,495,234126,부산,14259,14258,1,15421,2022-03-03 09:09:31.365,null
3095,2468,894637,서울,43675,43675,0,15420,2022-03-03 09:09:31.365,null
3096,8394,3691488,합계,198803,198749,54,15419,2022-03-03 09:09:31.365,null
3097,16,9838,검역,29,0,29,15418,2022-03-02 09:06:39.555,null
3098,23,34176,제주,2207,2207,0,15417,2022-03-02 09:06:39.555,null
3099,158,161884,경남,13201,13196,5,15416,2022-03-02 09:06:39.554,null
3100,349,109807,경북,6969,6961,8,15415,2022-03-02 09:06:39.554,null
3101,62,68446,전남,4996,4992,4,15414,2022-03-02 09:06:39.554,null
3102,191,87247,전북,6413,6407,6,15413,2022-03-02 09:06:39.554,null
3103,276,114613,충남,6915,6915,0,15412,2022-03-02 09:06:39.553,null
3104,167,77581,충북,5574,5569,5,15411,2022-03-02 09:06:39.553,null
3105,162,69333,강원,4971,4966,5,15410,2022-03-02 09:06:39.553,null
3106,2533,1048539,경기,68623,68622,1,15409,2022-03-02 09:06:39.553,null
3107,6,20014,세종,1412,1412,0,15408,2022-03-02 09:06:39.552,null
3108,93,57683,울산,5121,5121,0,15407,2022-03-02 09:06:39.552,null
3109,237,87441,대전,5292,5292,0,15406,2022-03-02 09:06:39.552,null
3110,121,88299,광주,5259,5256,3,15405,2022-03-02 09:06:39.552,null
3111,448,242903,인천,12105,12104,1,15404,2022-03-02 09:06:39.551,null
3112,488,144053,대구,7117,7117,0,15403,2022-03-02 09:06:39.551,null
3113,486,219867,부산,16104,16104,0,15402,2022-03-02 09:06:39.551,null
3114,2450,850962,서울,46933,46932,1,15401,2022-03-02 09:06:39.551,null
3115,8266,3492686,합계,219241,219173,68,15400,2022-03-02 09:06:39.55,null
3116,16,9809,검역,28,0,28,15399,2022-03-01 09:14:04.448,null
3117,23,31969,제주,2273,2273,0,15398,2022-03-01 09:14:04.448,null
3118,153,148684,경남,8031,8018,13,15397,2022-03-01 09:14:04.448,null
3119,341,102838,경북,4668,4665,3,15396,2022-03-01 09:14:04.448,null
3120,60,63450,전남,3283,3280,3,15395,2022-03-01 09:14:04.447,null
3121,189,80834,전북,3938,3937,1,15394,2022-03-01 09:14:04.447,null
3122,271,107698,충남,4853,4853,0,15393,2022-03-01 09:14:04.447,null
3123,163,72008,충북,3502,3500,2,15392,2022-03-01 09:14:04.447,null
3124,160,64362,강원,3477,3477,0,15391,2022-03-01 09:14:04.447,null
3125,2514,979916,경기,39213,39211,2,15390,2022-03-01 09:14:04.446,null
3126,6,18602,세종,876,876,0,15389,2022-03-01 09:14:04.446,null
3127,91,52562,울산,2944,2944,0,15388,2022-03-01 09:14:04.446,null
3128,232,82149,대전,3674,3674,0,15387,2022-03-01 09:14:04.446,null
3129,121,83040,광주,4806,4802,4,15386,2022-03-01 09:14:04.445,null
3130,442,230798,인천,8956,8956,0,15385,2022-03-01 09:14:04.445,null
3131,484,136938,대구,5382,5382,0,15384,2022-03-01 09:14:04.445,null
3132,472,203763,부산,11204,11202,2,15383,2022-03-01 09:14:04.444,null
3133,2432,804029,서울,27885,27885,0,15382,2022-03-01 09:14:04.444,null
3134,8170,3273449,합계,138993,138935,58,15381,2022-03-01 09:14:04.444,null
3135,16,9781,검역,39,0,39,15380,2022-02-28 09:00:50.361,null
3136,22,29696,제주,1806,1806,0,15379,2022-02-28 09:00:50.361,null
3137,148,140653,경남,8413,8398,15,15378,2022-02-28 09:00:50.361,null
3138,332,98170,경북,4940,4935,5,15377,2022-02-28 09:00:50.361,null
3139,59,60167,전남,3320,3318,2,15376,2022-02-28 09:00:50.36,null
3140,181,76896,전북,4070,4066,4,15375,2022-02-28 09:00:50.36,null
3141,268,102845,충남,5084,5078,6,15374,2022-02-28 09:00:50.36,null
3142,162,68506,충북,3053,3046,7,15373,2022-02-28 09:00:50.36,null
3143,155,60885,강원,3318,3315,3,15372,2022-02-28 09:00:50.36,null
3144,2487,940703,경기,37258,37258,0,15371,2022-02-28 09:00:50.359,null
3145,6,17726,세종,834,834,0,15370,2022-02-28 09:00:50.359,null
3146,89,49618,울산,2485,2485,0,15369,2022-02-28 09:00:50.359,null
3147,230,78475,대전,3683,3683,0,15368,2022-02-28 09:00:50.359,null
3148,120,78234,광주,4167,4153,14,15367,2022-02-28 09:00:50.359,null
3149,434,221842,인천,10741,10740,1,15366,2022-02-28 09:00:50.358,null
3150,481,131556,대구,5825,5825,0,15365,2022-02-28 09:00:50.358,null
3151,462,192559,부산,12617,12615,2,15364,2022-02-28 09:00:50.358,null
3152,2406,776144,서울,27973,27911,62,15363,2022-02-28 09:00:50.358,null
3153,8058,3134456,합계,139626,139466,160,15362,2022-02-28 09:00:50.357,null
3154,16,9742,검역,28,0,28,15361,2022-02-27 09:04:07.814,null
3155,21,27890,제주,2167,2165,2,15360,2022-02-27 09:04:07.814,null
3156,144,132240,경남,9247,9242,5,15359,2022-02-27 09:04:07.814,null
3157,325,93230,경북,5383,5377,6,15358,2022-02-27 09:04:07.814,null
3158,57,56847,전남,3413,3409,4,15357,2022-02-27 09:04:07.813,null
3159,175,72827,전북,4216,4211,5,15356,2022-02-27 09:04:07.813,null
3160,265,97761,충남,5963,5950,13,15355,2022-02-27 09:04:07.813,null
3161,161,65455,충북,4092,4085,7,15354,2022-02-27 09:04:07.812,null
3162,154,57567,강원,3380,3375,5,15353,2022-02-27 09:04:07.812,null
3163,2464,903445,경기,46801,46799,2,15352,2022-02-27 09:04:07.812,null
3164,5,16892,세종,921,920,1,15351,2022-02-27 09:04:07.812,null
3165,88,47133,울산,3315,3315,0,15350,2022-02-27 09:04:07.81,null
3166,230,74792,대전,4048,4046,2,15349,2022-02-27 09:04:07.81,null
3167,120,74067,광주,4273,4273,0,15348,2022-02-27 09:04:07.81,null
3168,423,211101,인천,11133,11129,4,15347,2022-02-27 09:04:07.809,null
3169,474,125731,대구,6158,6158,0,15346,2022-02-27 09:04:07.809,null
3170,452,179948,부산,13677,13674,3,15345,2022-02-27 09:04:07.809,null
3171,2370,748173,서울,35351,35286,65,15344,2022-02-27 09:04:07.808,null
3172,7944,2994841,합계,163566,163414,152,15343,2022-02-27 09:04:07.808,null
3173,16,9714,검역,19,0,19,15342,2022-02-26 09:24:48.538,null
3174,21,25723,제주,1917,1916,1,15341,2022-02-26 09:24:48.537,null
3175,144,122993,경남,8645,8638,7,15340,2022-02-26 09:24:48.537,null
3176,322,87847,경북,5305,5301,4,15339,2022-02-26 09:24:48.537,null
3177,57,53434,전남,3437,3433,4,15338,2022-02-26 09:24:48.537,null
3178,172,68617,전북,4161,4156,5,15337,2022-02-26 09:24:48.537,null
3179,261,91798,충남,5284,5283,1,15336,2022-02-26 09:24:48.536,null
3180,158,61363,충북,3792,3778,14,15335,2022-02-26 09:24:48.536,null
3181,151,54187,강원,3264,3258,6,15334,2022-02-26 09:24:48.536,null
3182,2456,856644,경기,48150,48147,3,15333,2022-02-26 09:24:48.536,null
3183,5,15971,세종,998,996,2,15332,2022-02-26 09:24:48.535,null
3184,85,43818,울산,3128,3128,0,15331,2022-02-26 09:24:48.535,null
3185,227,70744,대전,4266,4265,1,15330,2022-02-26 09:24:48.535,null
3186,119,69794,광주,4883,4866,17,15329,2022-02-26 09:24:48.535,null
3187,421,199968,인천,12113,12113,0,15328,2022-02-26 09:24:48.535,null
3188,470,119575,대구,6995,6995,0,15327,2022-02-26 09:24:48.534,null
3189,447,166271,부산,13023,13022,1,15326,2022-02-26 09:24:48.534,null
3190,2363,712822,서울,36829,36773,56,15325,2022-02-26 09:24:48.534,null
3191,7895,2831283,합계,166209,166068,141,15324,2022-02-26 09:24:48.534,null
3192,16,9695,검역,30,0,30,15323,2022-02-25 09:20:20.04,null
3193,21,23806,제주,2062,2062,0,15322,2022-02-25 09:20:20.039,null
3194,140,114348,경남,8899,8892,7,15321,2022-02-25 09:20:20.039,null
3195,313,82542,경북,5393,5387,6,15320,2022-02-25 09:20:20.039,null
3196,57,49997,전남,3533,3529,4,15319,2022-02-25 09:20:20.038,null
3197,169,64457,전북,4217,4208,9,15318,2022-02-25 09:20:20.038,null
3198,258,86514,충남,5184,5175,9,15317,2022-02-25 09:20:20.038,null
3199,154,57571,충북,3968,3962,6,15316,2022-02-25 09:20:20.037,null
3200,147,50923,강원,3429,3426,3,15315,2022-02-25 09:20:20.037,null
3201,2429,808494,경기,48082,48080,2,15314,2022-02-25 09:20:20.037,null
3202,5,14973,세종,1064,1064,0,15313,2022-02-25 09:20:20.037,null
3203,82,40691,울산,3532,3532,0,15312,2022-02-25 09:20:20.036,null
3204,223,66479,대전,4406,4406,0,15311,2022-02-25 09:20:20.036,null
3205,115,64911,광주,4604,4598,6,15310,2022-02-25 09:20:20.036,null
3206,410,187855,인천,12847,12843,4,15309,2022-02-25 09:20:20.036,null
3207,464,112580,대구,6290,6290,0,15308,2022-02-25 09:20:20.035,null
3208,437,153248,부산,12736,12733,3,15307,2022-02-25 09:20:20.035,null
3209,2343,675993,서울,35614,35562,52,15306,2022-02-25 09:20:20.035,null
3210,7783,2665077,합계,165890,165749,141,15305,2022-02-25 09:20:20.035,null
3211,16,9665,검역,53,0,53,15304,2022-02-24 09:53:55.253,null
3212,18,21744,제주,1505,1505,0,15303,2022-02-24 09:53:55.253,null
3213,138,105449,경남,9215,9206,9,15302,2022-02-24 09:53:55.253,null
3214,300,77149,경북,5204,5199,5,15301,2022-02-24 09:53:55.252,null
3215,57,46464,전남,3367,3365,2,15300,2022-02-24 09:53:55.252,null
3216,166,60240,전북,3916,3912,4,15299,2022-02-24 09:53:55.252,null
3217,253,81330,충남,4987,4983,4,15298,2022-02-24 09:53:55.252,null
3218,152,53603,충북,4356,4346,10,15297,2022-02-24 09:53:55.251,null
3219,147,47494,강원,3121,3120,1,15296,2022-02-24 09:53:55.251,null
3220,2403,760412,경기,51320,51317,3,15295,2022-02-24 09:53:55.251,null
3221,5,13909,세종,1082,1082,0,15294,2022-02-24 09:53:55.251,null
3222,80,37159,울산,3231,3231,0,15293,2022-02-24 09:53:55.25,null
3223,220,62073,대전,4504,4502,2,15292,2022-02-24 09:53:55.25,null
3224,114,60307,광주,4136,4128,8,15291,2022-02-24 09:53:55.249,null
3225,399,175009,인천,13863,13861,2,15290,2022-02-24 09:53:55.249,null
3226,461,106290,대구,7148,7148,0,15289,2022-02-24 09:53:55.249,null
3227,429,140512,부산,11836,11835,1,15288,2022-02-24 09:53:55.249,null
3228,2331,640379,서울,37172,37106,66,15287,2022-02-24 09:53:55.248,null
3229,7689,2499188,합계,170016,169846,170,15286,2022-02-24 09:53:55.248,null
3230,16,9612,검역,46,0,46,15285,2022-02-23 09:15:35.668,null
3231,17,20244,제주,1762,1762,0,15284,2022-02-23 09:15:35.668,null
3232,136,96234,경남,8023,8016,7,15283,2022-02-23 09:15:35.668,null
3233,292,71945,경북,4996,4992,4,15282,2022-02-23 09:15:35.668,null
3234,55,43098,전남,3083,3081,2,15281,2022-02-23 09:15:35.667,null
3235,163,56324,전북,4024,4010,14,15280,2022-02-23 09:15:35.667,null
3236,249,76343,충남,4838,4832,6,15279,2022-02-23 09:15:35.667,null
3237,151,49247,충북,3475,3469,6,15278,2022-02-23 09:15:35.666,null
3238,142,44373,강원,3192,3192,0,15277,2022-02-23 09:15:35.666,null
3239,2385,709092,경기,53532,53524,8,15276,2022-02-23 09:15:35.666,null
3240,5,12827,세종,1079,1079,0,15275,2022-02-23 09:15:35.665,null
3241,75,33929,울산,3447,3447,0,15274,2022-02-23 09:15:35.665,null
3242,219,57569,대전,4078,4076,2,15273,2022-02-23 09:15:35.665,null
3243,112,56172,광주,4225,4221,4,15272,2022-02-23 09:15:35.665,null
3244,397,161146,인천,11063,11060,3,15271,2022-02-23 09:15:35.665,null
3245,451,99142,대구,6306,6306,0,15270,2022-02-23 09:15:35.664,null
3246,422,128676,부산,12816,12815,1,15269,2022-02-23 09:15:35.664,null
3247,2320,603209,서울,41467,41389,78,15268,2022-02-23 09:15:35.664,null
3248,7607,2329182,합계,171452,171271,181,15267,2022-02-23 09:15:35.664,null
3249,16,9566,검역,29,0,29,15266,2022-02-22 09:07:42.287,null
3250,14,18482,제주,1301,1301,0,15265,2022-02-22 09:07:42.287,null
3251,133,88211,경남,4839,4829,10,15264,2022-02-22 09:07:42.287,null
3252,288,66949,경북,3127,3114,13,15263,2022-02-22 09:07:42.287,null
3253,54,40015,전남,2109,2106,3,15262,2022-02-22 09:07:42.286,null
3254,163,52300,전북,2463,2456,7,15261,2022-02-22 09:07:42.286,null
3255,240,71505,충남,3337,3333,4,15260,2022-02-22 09:07:42.286,null
3256,149,45772,충북,2187,2181,6,15259,2022-02-22 09:07:42.286,null
3257,139,41182,강원,2057,2055,2,15258,2022-02-22 09:07:42.285,null
3258,2359,655560,경기,29562,29558,4,15257,2022-02-22 09:07:42.285,null
3259,5,11748,세종,648,648,0,15256,2022-02-22 09:07:42.285,null
3260,72,30482,울산,1941,1941,0,15255,2022-02-22 09:07:42.285,null
3261,216,53491,대전,2849,2848,1,15254,2022-02-22 09:07:42.285,null
3262,110,51947,광주,3247,3239,8,15253,2022-02-22 09:07:42.284,null
3263,389,150084,인천,7772,7771,1,15252,2022-02-22 09:07:42.284,null
3264,448,92836,대구,4158,4158,0,15251,2022-02-22 09:07:42.284,null
3265,406,115860,부산,6140,6137,3,15250,2022-02-22 09:07:42.284,null
3266,2307,561744,서울,21807,21769,38,15249,2022-02-22 09:07:42.283,null
3267,7508,2157734,합계,99573,99444,129,15248,2022-02-22 09:07:42.283,null
3268,16,9537,검역,36,0,36,15247,2022-02-21 09:17:46.133,null
3269,14,17182,제주,1081,1081,0,15246,2022-02-21 09:17:46.132,null
3270,132,83372,경남,5045,5038,7,15245,2022-02-21 09:17:46.132,null
3271,281,63822,경북,3250,3246,4,15244,2022-02-21 09:17:46.132,null
3272,53,37907,전남,2070,2070,0,15243,2022-02-21 09:17:46.132,null
3273,158,49837,전북,2728,2720,8,15242,2022-02-21 09:17:46.131,null
3274,236,68188,충남,3313,3313,0,15241,2022-02-21 09:17:46.131,null
3275,147,43585,충북,2226,2218,8,15240,2022-02-21 09:17:46.131,null
3276,135,39125,강원,2016,2009,7,15239,2022-02-21 09:17:46.131,null
3277,2349,625998,경기,26779,26777,2,15238,2022-02-21 09:17:46.131,null
3278,4,11100,세종,646,643,3,15237,2022-02-21 09:17:46.13,null
3279,72,28541,울산,1593,1593,0,15236,2022-02-21 09:17:46.13,null
3280,215,50642,대전,2907,2907,0,15235,2022-02-21 09:17:46.13,null
3281,110,48700,광주,2589,2584,5,15234,2022-02-21 09:17:46.13,null
3282,386,142312,인천,7364,7362,2,15233,2022-02-21 09:17:46.129,null
3283,444,88678,대구,4160,4160,0,15232,2022-02-21 09:17:46.129,null
3284,401,109720,부산,7541,7540,1,15231,2022-02-21 09:17:46.129,null
3285,2297,539938,서울,20018,19957,61,15230,2022-02-21 09:17:46.129,null
3286,7450,2058184,합계,95362,95218,144,15229,2022-02-21 09:17:46.128,null
3287,16,9501,검역,20,0,20,15228,2022-02-20 08:53:21.99,null
3288,14,16102,제주,1231,1231,0,15227,2022-02-20 08:53:21.989,null
3289,132,78329,경남,5093,5087,6,15226,2022-02-20 08:53:21.989,null
3290,273,60572,경북,3349,3342,7,15225,2022-02-20 08:53:21.989,null
3291,53,35837,전남,2064,2060,4,15224,2022-02-20 08:53:21.989,null
3292,157,47109,전북,2791,2778,13,15223,2022-02-20 08:53:21.989,null
3293,232,64875,충남,3348,3343,5,15222,2022-02-20 08:53:21.988,null
3294,147,41367,충북,2312,2302,10,15221,2022-02-20 08:53:21.988,null
3295,130,37109,강원,1999,1990,9,15220,2022-02-20 08:53:21.988,null
3296,2344,599219,경기,31328,31326,2,15219,2022-02-20 08:53:21.988,null
3297,4,10454,세종,658,657,1,15218,2022-02-20 08:53:21.987,null
3298,70,26948,울산,1919,1919,0,15217,2022-02-20 08:53:21.987,null
3299,214,47735,대전,3110,3106,4,15216,2022-02-20 08:53:21.987,null
3300,110,46111,광주,2661,2656,5,15215,2022-02-20 08:53:21.987,null
3301,384,134948,인천,9191,9188,3,15214,2022-02-20 08:53:21.987,null
3302,442,84518,대구,4707,4707,0,15213,2022-02-20 08:53:21.986,null
3303,396,102180,부산,6946,6940,6,15212,2022-02-20 08:53:21.986,null
3304,2287,519923,서울,22102,22100,2,15211,2022-02-20 08:53:21.986,null
3305,7405,1962837,합계,104829,104732,97,15210,2022-02-20 08:53:21.986,null
3306,16,9481,검역,47,0,47,15209,2022-02-19 09:01:36.377,null
3307,14,14871,제주,1206,1205,1,15208,2022-02-19 09:01:36.377,null
3308,130,73236,경남,4418,4414,4,15207,2022-02-19 09:01:36.376,null
3309,266,57223,경북,3186,3180,6,15206,2022-02-19 09:01:36.376,null
3310,51,33773,전남,1900,1898,2,15205,2022-02-19 09:01:36.376,null
3311,155,44318,전북,2492,2486,6,15204,2022-02-19 09:01:36.376,null
3312,228,61527,충남,4077,4072,5,15203,2022-02-19 09:01:36.375,null
3313,147,39055,충북,2394,2392,2,15202,2022-02-19 09:01:36.375,null
3314,129,35110,강원,1799,1798,1,15201,2022-02-19 09:01:36.375,null
3315,2327,567891,경기,30642,30641,1,15200,2022-02-19 09:01:36.375,null
3316,4,9796,세종,677,676,1,15199,2022-02-19 09:01:36.375,null
3317,70,25029,울산,1832,1832,0,15198,2022-02-19 09:01:36.374,null
3318,213,44625,대전,3032,3030,2,15197,2022-02-19 09:01:36.374,null
3319,110,43450,광주,2741,2740,1,15196,2022-02-19 09:01:36.374,null
3320,377,125758,인천,7816,7816,0,15195,2022-02-19 09:01:36.374,null
3321,440,79811,대구,4223,4223,0,15194,2022-02-19 09:01:36.373,null
3322,394,95234,부산,6536,6534,2,15193,2022-02-19 09:01:36.373,null
3323,2283,497821,서울,23193,23135,58,15192,2022-02-19 09:01:36.373,null
3324,7354,1858009,합계,102211,102072,139,15191,2022-02-19 09:01:36.373,null
3325,16,9434,검역,39,0,39,15190,2022-02-18 09:06:06.436,null
3326,14,13665,제주,1114,1114,0,15189,2022-02-18 09:06:06.436,null
3327,128,68819,경남,4622,4609,13,15188,2022-02-18 09:06:06.436,null
3328,262,54038,경북,3285,3281,4,15187,2022-02-18 09:06:06.436,null
3329,50,31873,전남,1911,1908,3,15186,2022-02-18 09:06:06.435,null
3330,150,41826,전북,2510,2503,7,15185,2022-02-18 09:06:06.435,null
3331,225,57450,충남,2944,2939,5,15184,2022-02-18 09:06:06.435,null
3332,141,36661,충북,2554,2552,2,15183,2022-02-18 09:06:06.435,null
3333,127,33311,강원,1932,1927,5,15182,2022-02-18 09:06:06.435,null
3334,2315,537249,경기,36511,36507,4,15181,2022-02-18 09:06:06.434,null
3335,4,9119,세종,703,703,0,15180,2022-02-18 09:06:06.434,null
3336,68,23198,울산,1947,1947,0,15179,2022-02-18 09:06:06.433,null
3337,211,41593,대전,2980,2980,0,15178,2022-02-18 09:06:06.433,null
3338,109,40709,광주,2669,2665,4,15177,2022-02-18 09:06:06.433,null
3339,372,117944,인천,7344,7342,2,15176,2022-02-18 09:06:06.433,null
3340,433,75591,대구,4538,4538,0,15175,2022-02-18 09:06:06.432,null
3341,386,88698,부산,6577,6574,3,15174,2022-02-18 09:06:06.432,null
3342,2272,474628,서울,25651,25626,25,15173,2022-02-18 09:06:06.432,null
3343,7283,1755806,합계,109831,109715,116,15172,2022-02-18 09:06:06.432,null
3344,16,9395,검역,38,0,38,15171,2022-02-17 08:53:19.805,null
3345,14,12551,제주,882,882,0,15170,2022-02-17 08:53:19.805,null
3346,127,64197,경남,4481,4477,4,15169,2022-02-17 08:53:19.805,null
3347,261,50753,경북,2901,2898,3,15168,2022-02-17 08:53:19.805,null
3348,49,29963,전남,1893,1892,1,15167,2022-02-17 08:53:19.804,null
3349,146,39317,전북,2574,2567,7,15166,2022-02-17 08:53:19.804,null
3350,223,54506,충남,3015,3013,2,15165,2022-02-17 08:53:19.804,null
3351,141,34107,충북,2169,2166,3,15164,2022-02-17 08:53:19.804,null
3352,126,31379,강원,1729,1727,2,15163,2022-02-17 08:53:19.803,null
3353,2301,500738,경기,28447,28438,9,15162,2022-02-17 08:53:19.803,null
3354,4,8417,세종,656,656,0,15161,2022-02-17 08:53:19.803,null
3355,67,21251,울산,1691,1691,0,15160,2022-02-17 08:53:19.803,null
3356,211,38613,대전,2702,2702,0,15159,2022-02-17 08:53:19.802,null
3357,109,38040,광주,2612,2608,4,15158,2022-02-17 08:53:19.802,null
3358,366,110600,인천,7238,7235,3,15157,2022-02-17 08:53:19.802,null
3359,431,71053,대구,4199,4199,0,15156,2022-02-17 08:53:19.802,null
3360,382,82121,부산,6219,6216,3,15155,2022-02-17 08:53:19.801,null
3361,2264,448977,서울,19689,19678,11,15154,2022-02-17 08:53:19.801,null
3362,7238,1645978,합계,93135,93045,90,15153,2022-02-17 08:53:19.801,null
3363,16,9357,검역,38,0,38,15152,2022-02-16 09:21:13.629,null
3364,14,11669,제주,924,924,0,15151,2022-02-16 09:21:13.628,null
3365,126,59716,경남,4450,4445,5,15150,2022-02-16 09:21:13.628,null
3366,257,47853,경북,2869,2863,6,15149,2022-02-16 09:21:13.628,null
3367,49,28070,전남,1930,1930,0,15148,2022-02-16 09:21:13.628,null
3368,144,36743,전북,2562,2555,7,15147,2022-02-16 09:21:13.628,null
3369,220,51491,충남,3003,2991,12,15146,2022-02-16 09:21:13.627,null
3370,141,31938,충북,2203,2201,2,15145,2022-02-16 09:21:13.627,null
3371,126,29650,강원,1784,1758,26,15144,2022-02-16 09:21:13.627,null
3372,2289,472291,경기,27963,27954,9,15143,2022-02-16 09:21:13.627,null
3373,4,7761,세종,696,694,2,15142,2022-02-16 09:21:13.626,null
3374,67,19560,울산,1759,1759,0,15141,2022-02-16 09:21:13.626,null
3375,211,35912,대전,2590,2589,1,15140,2022-02-16 09:21:13.626,null
3376,108,35428,광주,2298,2294,4,15139,2022-02-16 09:21:13.626,null
3377,364,103367,인천,5822,5817,5,15138,2022-02-16 09:21:13.626,null
3378,430,66854,대구,4190,4190,0,15137,2022-02-16 09:21:13.625,null
3379,379,75902,부산,6483,6483,0,15136,2022-02-16 09:21:13.625,null
3380,2257,429289,서울,18879,18834,45,15135,2022-02-16 09:21:13.625,null
3381,7202,1552851,합계,90443,90281,162,15134,2022-02-16 09:21:13.624,null
3382,16,9319,검역,57,0,57,15133,2022-02-15 09:02:53.917,null
3383,14,10746,제주,551,551,0,15132,2022-02-15 09:02:53.917,null
3384,126,55268,경남,2771,2765,6,15131,2022-02-15 09:02:53.916,null
3385,257,44988,경북,1765,1755,10,15130,2022-02-15 09:02:53.916,null
3386,49,26140,전남,1301,1299,2,15129,2022-02-15 09:02:53.916,null
3387,142,34181,전북,1579,1579,0,15128,2022-02-15 09:02:53.916,null
3388,218,48488,충남,2219,2218,1,15127,2022-02-15 09:02:53.915,null
3389,140,29737,충북,1327,1322,5,15126,2022-02-15 09:02:53.915,null
3390,126,27866,강원,1179,1174,5,15125,2022-02-15 09:02:53.915,null
3391,2275,444328,경기,17241,17236,5,15124,2022-02-15 09:02:53.915,null
3392,4,7065,세종,415,415,0,15123,2022-02-15 09:02:53.915,null
3393,67,17801,울산,776,776,0,15122,2022-02-15 09:02:53.914,null
3394,209,33324,대전,1577,1575,2,15121,2022-02-15 09:02:53.914,null
3395,107,33130,광주,1608,1599,9,15120,2022-02-15 09:02:53.914,null
3396,363,97547,인천,4906,4904,2,15119,2022-02-15 09:02:53.914,null
3397,427,62664,대구,2362,2362,0,15118,2022-02-15 09:02:53.913,null
3398,374,69419,부산,3090,3080,10,15117,2022-02-15 09:02:53.913,null
3399,2249,410410,서울,12453,12402,51,15116,2022-02-15 09:02:53.913,null
3400,7163,1462421,합계,57177,57012,165,15115,2022-02-15 09:02:53.913,null
3401,16,9262,검역,40,0,40,15114,2022-02-14 09:03:31.01,null
3402,14,10195,제주,509,509,0,15113,2022-02-14 09:03:31.01,null
3403,126,52497,경남,2806,2794,12,15112,2022-02-14 09:03:31.01,null
3404,251,43223,경북,1917,1906,11,15111,2022-02-14 09:03:31.01,null
3405,49,24839,전남,1264,1259,5,15110,2022-02-14 09:03:31.009,null
3406,140,32602,전북,1591,1585,6,15109,2022-02-14 09:03:31.009,null
3407,214,46269,충남,2498,2493,5,15108,2022-02-14 09:03:31.009,null
3408,139,28410,충북,1542,1541,1,15107,2022-02-14 09:03:31.009,null
3409,126,26687,강원,1092,1087,5,15106,2022-02-14 09:03:31.008,null
3410,2254,427088,경기,15875,15866,9,15105,2022-02-14 09:03:31.008,null
3411,4,6650,세종,353,351,2,15104,2022-02-14 09:03:31.008,null
3412,67,17025,울산,676,676,0,15103,2022-02-14 09:03:31.008,null
3413,208,31747,대전,1614,1613,1,15102,2022-02-14 09:03:31.007,null
3414,106,31522,광주,1539,1536,3,15101,2022-02-14 09:03:31.007,null
3415,355,92642,인천,3578,3576,2,15100,2022-02-14 09:03:31.007,null
3416,417,60302,대구,2606,2606,0,15099,2022-02-14 09:03:31.007,null
3417,374,66329,부산,3520,3520,0,15098,2022-02-14 09:03:31.006,null
3418,2242,397957,서울,11599,11595,4,15097,2022-02-14 09:03:31.006,null
3419,7102,1405246,합계,54619,54513,106,15096,2022-02-14 09:03:31.006,null
3420,16,9222,검역,30,0,30,15095,2022-02-13 08:58:01.53,null
3421,14,9687,제주,554,552,2,15094,2022-02-13 08:58:01.53,null
3422,126,49691,경남,2666,2663,3,15093,2022-02-13 08:58:01.53,null
3423,250,41306,경북,2055,2046,9,15092,2022-02-13 08:58:01.529,null
3424,49,23575,전남,1181,1181,0,15091,2022-02-13 08:58:01.529,null
3425,140,31011,전북,1642,1637,5,15090,2022-02-13 08:58:01.529,null
3426,213,43771,충남,2375,2374,1,15089,2022-02-13 08:58:01.529,null
3427,138,26868,충북,1331,1321,10,15088,2022-02-13 08:58:01.528,null
3428,126,25595,강원,985,981,4,15087,2022-02-13 08:58:01.528,null
3429,2247,411215,경기,17074,17065,9,15086,2022-02-13 08:58:01.528,null
3430,4,6297,세종,384,383,1,15085,2022-02-13 08:58:01.528,null
3431,67,16349,울산,805,805,0,15084,2022-02-13 08:58:01.528,null
3432,206,30133,대전,1495,1493,2,15083,2022-02-13 08:58:01.527,null
3433,105,29983,광주,1540,1537,3,15082,2022-02-13 08:58:01.527,null
3434,355,89064,인천,4475,4469,6,15081,2022-02-13 08:58:01.527,null
3435,417,57696,대구,2573,2573,0,15080,2022-02-13 08:58:01.527,null
3436,371,62809,부산,3442,3440,2,15079,2022-02-13 08:58:01.526,null
3437,2237,386358,서울,11824,11777,47,15078,2022-02-13 08:58:01.526,null
3438,7081,1350630,합계,56431,56297,134,15077,2022-02-13 08:58:01.526,null
3439,16,9192,검역,55,0,55,15076,2022-02-12 09:10:35.405,null
3440,13,9133,제주,503,503,0,15075,2022-02-12 09:10:35.405,null
3441,126,47026,경남,1699,1696,3,15074,2022-02-12 09:10:35.404,null
3442,245,39251,경북,1831,1827,4,15073,2022-02-12 09:10:35.404,null
3443,48,22394,전남,1215,1210,5,15072,2022-02-12 09:10:35.404,null
3444,139,29371,전북,1548,1546,2,15071,2022-02-12 09:10:35.404,null
3445,212,41396,충남,2187,2185,2,15070,2022-02-12 09:10:35.404,null
3446,136,25537,충북,1157,1154,3,15069,2022-02-12 09:10:35.403,null
3447,125,24610,강원,960,957,3,15068,2022-02-12 09:10:35.403,null
3448,2238,394141,경기,15960,15952,8,15067,2022-02-12 09:10:35.403,null
3449,4,5913,세종,326,323,3,15066,2022-02-12 09:10:35.403,null
3450,67,15544,울산,726,726,0,15065,2022-02-12 09:10:35.402,null
3451,205,28638,대전,1511,1509,2,15064,2022-02-12 09:10:35.402,null
3452,105,28443,광주,1576,1573,3,15063,2022-02-12 09:10:35.402,null
3453,354,84589,인천,5068,5059,9,15062,2022-02-12 09:10:35.402,null
3454,417,55126,대구,2370,2370,0,15061,2022-02-12 09:10:35.402,null
3455,368,59367,부산,3051,3049,2,15060,2022-02-12 09:10:35.401,null
3456,2227,374534,서울,13198,13189,9,15059,2022-02-12 09:10:35.401,null
3457,7045,1294205,합계,54941,54828,113,15058,2022-02-12 09:10:35.401,null
3458,16,9137,검역,36,0,36,15057,2022-02-11 08:38:49.428,null
3459,13,8630,제주,476,474,2,15056,2022-02-11 08:38:49.428,null
3460,125,45330,경남,2192,2186,6,15055,2022-02-11 08:38:49.428,null
3461,243,37420,경북,1926,1924,2,15054,2022-02-11 08:38:49.428,null
3462,48,21179,전남,1241,1234,7,15053,2022-02-11 08:38:49.428,null
3463,139,27823,전북,1507,1504,3,15052,2022-02-11 08:38:49.427,null
3464,208,39209,충남,1587,1585,2,15051,2022-02-11 08:38:49.427,null
3465,135,24380,충북,1156,1156,0,15050,2022-02-11 08:38:49.427,null
3466,125,23651,강원,1087,1083,4,15049,2022-02-11 08:38:49.427,null
3467,2232,378200,경기,17976,17925,51,15048,2022-02-11 08:38:49.426,null
3468,4,5587,세종,332,332,0,15047,2022-02-11 08:38:49.426,null
3469,67,14818,울산,795,795,0,15046,2022-02-11 08:38:49.426,null
3470,203,27127,대전,1423,1422,1,15045,2022-02-11 08:38:49.426,null
3471,105,26867,광주,1408,1405,3,15044,2022-02-11 08:38:49.426,null
3472,350,79521,인천,3745,3740,5,15043,2022-02-11 08:38:49.425,null
3473,409,52756,대구,2497,2497,0,15042,2022-02-11 08:38:49.425,null
3474,366,56316,부산,3011,3007,4,15041,2022-02-11 08:38:49.425,null
3475,2224,361336,서울,11531,11528,3,15040,2022-02-11 08:38:49.425,null
3476,7012,1239287,합계,53926,53797,129,15039,2022-02-11 08:38:49.424,null
3477,16,9101,검역,23,0,23,15038,2022-02-10 09:06:56.004,null
3478,13,8154,제주,448,448,0,15037,2022-02-10 09:06:56.004,null
3479,124,43138,경남,2341,2341,0,15036,2022-02-10 09:06:56.004,null
3480,240,35494,경북,1818,1813,5,15035,2022-02-10 09:06:56.003,null
3481,48,19938,전남,1495,1492,3,15034,2022-02-10 09:06:56.003,null
3482,138,26316,전북,1771,1754,17,15033,2022-02-10 09:06:56.003,null
3483,205,37622,충남,1716,1711,5,15032,2022-02-10 09:06:56.003,null
3484,133,23224,충북,1082,1081,1,15031,2022-02-10 09:06:56.002,null
3485,123,22564,강원,964,962,2,15030,2022-02-10 09:06:56.002,null
3486,2219,360224,경기,17751,17738,13,15029,2022-02-10 09:06:56.002,null
3487,4,5255,세종,273,272,1,15028,2022-02-10 09:06:56.002,null
3488,67,14023,울산,732,732,0,15027,2022-02-10 09:06:56.002,null
3489,200,25704,대전,1450,1447,3,15026,2022-02-10 09:06:56.001,null
3490,101,25459,광주,1427,1422,5,15025,2022-02-10 09:06:56.001,null
3491,345,75776,인천,3996,3990,6,15024,2022-02-10 09:06:56.001,null
3492,405,50259,대구,2329,2328,1,15023,2022-02-10 09:06:56.001,null
3493,365,53305,부산,2631,2630,1,15022,2022-02-10 09:06:56.0,null
3494,2217,349805,서울,11875,11873,2,15021,2022-02-10 09:06:56.0,null
3495,6963,1185361,합계,54122,54034,88,15020,2022-02-10 09:06:56.0,null
3496,16,9078,검역,42,0,42,15019,2022-02-09 10:38:16.261,null
3497,13,7706,제주,412,412,0,15018,2022-02-09 10:38:16.261,null
3498,123,40797,경남,1947,1943,4,15017,2022-02-09 10:38:16.261,null
3499,238,33676,경북,1958,1953,5,15016,2022-02-09 10:38:16.261,null
3500,47,18443,전남,1128,1125,3,15015,2022-02-09 10:38:16.26,null
3501,137,24545,전북,1564,1562,2,15014,2022-02-09 10:38:16.26,null
3502,205,35906,충남,1768,1761,7,15013,2022-02-09 10:38:16.26,null
3503,133,22142,충북,1377,1375,2,15012,2022-02-09 10:38:16.26,null
3504,123,21600,강원,946,942,4,15011,2022-02-09 10:38:16.26,null
3505,2214,342473,경기,13651,13641,10,15010,2022-02-09 10:38:16.259,null
3506,4,4982,세종,287,285,2,15009,2022-02-09 10:38:16.259,null
3507,67,13291,울산,791,789,2,15008,2022-02-09 10:38:16.259,null
3508,199,24254,대전,1130,1128,2,15007,2022-02-09 10:38:16.259,null
3509,100,24032,광주,1503,1495,8,15006,2022-02-09 10:38:16.259,null
3510,344,71780,인천,3931,3912,19,15005,2022-02-09 10:38:16.258,null
3511,403,47930,대구,2415,2415,0,15004,2022-02-09 10:38:16.258,null
3512,365,50674,부산,3035,3034,1,15003,2022-02-09 10:38:16.258,null
3513,2212,337930,서울,11682,11630,52,15002,2022-02-09 10:38:16.258,null
3514,6943,1131239,합계,49567,49402,165,15001,2022-02-09 10:38:16.257,null
3515,16,9037,검역,41,0,41,15000,2022-02-08 10:15:03.783,null
3516,13,7295,제주,382,382,0,14999,2022-02-08 10:15:03.783,null
3517,122,38851,경남,1902,1894,8,14998,2022-02-08 10:15:03.783,null
3518,233,31718,경북,1545,1543,2,14997,2022-02-08 10:15:03.783,null
3519,47,17315,전남,1015,1015,0,14996,2022-02-08 10:15:03.782,null
3520,135,22982,전북,1226,1225,1,14995,2022-02-08 10:15:03.782,null
3521,205,34138,충남,1402,1401,1,14994,2022-02-08 10:15:03.782,null
3522,133,20765,충북,799,796,3,14993,2022-02-08 10:15:03.782,null
3523,122,20654,강원,738,736,2,14992,2022-02-08 10:15:03.782,null
3524,2207,328822,경기,12138,12123,15,14991,2022-02-08 10:15:03.781,null
3525,4,4695,세종,244,243,1,14990,2022-02-08 10:15:03.781,null
3526,67,12500,울산,501,501,0,14989,2022-02-08 10:15:03.781,null
3527,199,23124,대전,943,940,3,14988,2022-02-08 10:15:03.781,null
3528,100,22529,광주,1241,1237,4,14987,2022-02-08 10:15:03.78,null
3529,342,67849,인천,2982,2976,6,14986,2022-02-08 10:15:03.78,null
3530,403,45515,대구,1789,1788,1,14985,2022-02-08 10:15:03.78,null
3531,365,47639,부산,1921,1918,3,14984,2022-02-08 10:15:03.78,null
3532,2209,326253,서울,5910,5901,9,14983,2022-02-08 10:15:03.78,null
3533,6922,1081681,합계,36719,36619,100,14982,2022-02-08 10:15:03.779,null
3534,16,8996,검역,57,0,57,14981,2022-02-07 16:15:58.827,null
3535,13,6913,제주,369,368,1,14980,2022-02-07 16:15:58.827,null
3536,121,36949,경남,1672,1664,8,14979,2022-02-07 16:15:58.827,null
3537,228,30174,경북,1686,1684,2,14978,2022-02-07 16:15:58.827,null
3538,47,16300,전남,1133,1129,4,14977,2022-02-07 16:15:58.826,null
3539,130,21756,전북,1271,1269,2,14976,2022-02-07 16:15:58.826,null
3540,205,32736,충남,1473,1467,6,14975,2022-02-07 16:15:58.826,null
3541,131,19966,충북,885,884,1,14974,2022-02-07 16:15:58.826,null
3542,122,19916,강원,740,738,2,14973,2022-02-07 16:15:58.826,null
3543,2195,316684,경기,9805,9780,25,14972,2022-02-07 16:15:58.825,null
3544,4,4451,세종,262,261,1,14971,2022-02-07 16:15:58.825,null
3545,66,11999,울산,593,592,1,14970,2022-02-07 16:15:58.825,null
3546,199,22181,대전,969,968,1,14969,2022-02-07 16:15:58.825,null
3547,99,21288,광주,1209,1205,4,14968,2022-02-07 16:15:58.824,null
3548,342,64867,인천,2376,2366,10,14967,2022-02-07 16:15:58.824,null
3549,399,43726,대구,1971,1967,4,14966,2022-02-07 16:15:58.824,null
3550,364,45718,부산,1927,1916,11,14965,2022-02-07 16:15:58.824,null
3551,2205,320343,서울,6888,6873,15,14964,2022-02-07 16:15:58.824,null
3552,6886,1044963,합계,35286,35131,155,14963,2022-02-07 16:15:58.823,null
3553,16,8939,검역,51,0,51,14924,2022-02-06 09:22:46.46,null
3554,13,6544,제주,285,285,0,14923,2022-02-06 09:22:46.46,null
3555,121,35277,경남,1763,1750,13,14922,2022-02-06 09:22:46.459,null
3556,227,28488,경북,1750,1741,9,14921,2022-02-06 09:22:46.459,null
3557,47,15167,전남,1192,1190,2,14920,2022-02-06 09:22:46.459,null
3558,130,20486,전북,1012,1010,2,14919,2022-02-06 09:22:46.459,null
3559,205,31263,충남,1526,1520,6,14918,2022-02-06 09:22:46.458,null
3560,131,19081,충북,953,950,3,14917,2022-02-06 09:22:46.458,null
3561,122,19177,강원,786,783,3,14916,2022-02-06 09:22:46.458,null
3562,2188,306879,경기,11952,11924,28,14915,2022-02-06 09:22:46.458,null
3563,4,4189,세종,270,269,1,14914,2022-02-06 09:22:46.457,null
3564,66,11406,울산,571,571,0,14913,2022-02-06 09:22:46.457,null
3565,199,21212,대전,1190,1189,1,14912,2022-02-06 09:22:46.457,null
3566,99,20079,광주,1186,1180,6,14911,2022-02-06 09:22:46.457,null
3567,342,62492,인천,2238,2227,11,14910,2022-02-06 09:22:46.457,null
3568,398,41756,대구,1971,1967,4,14909,2022-02-06 09:22:46.456,null
3569,362,43791,부산,2174,2168,6,14908,2022-02-06 09:22:46.456,null
3570,2203,313462,서울,7821,7778,43,14907,2022-02-06 09:22:46.456,null
3571,6873,1009688,합계,38691,38502,189,14906,2022-02-06 09:22:46.456,null
3572,16,8904,검역,65,0,65,14905,2022-02-05 10:31:39.573,null
3573,13,6259,제주,248,247,1,14904,2022-02-05 10:31:39.573,null
3574,120,33514,경남,1483,1480,3,14903,2022-02-05 10:31:39.572,null
3575,226,26738,경북,1489,1485,4,14902,2022-02-05 10:31:39.572,null
3576,47,13975,전남,965,962,3,14901,2022-02-05 10:31:39.572,null
3577,130,19476,전북,1283,1272,11,14900,2022-02-05 10:31:39.572,null
3578,204,29737,충남,1160,1155,5,14899,2022-02-05 10:31:39.572,null
3579,130,18128,충북,776,771,5,14898,2022-02-05 10:31:39.571,null
3580,122,18391,강원,698,691,7,14897,2022-02-05 10:31:39.571,null
3581,2185,294927,경기,10449,10419,30,14896,2022-02-05 10:31:39.571,null
3582,4,3920,세종,296,293,3,14895,2022-02-05 10:31:39.571,null
3583,66,10835,울산,503,503,0,14894,2022-02-05 10:31:39.57,null
3584,199,20022,대전,1032,1027,5,14893,2022-02-05 10:31:39.57,null
3585,97,18893,광주,1244,1232,12,14892,2022-02-05 10:31:39.57,null
3586,342,60254,인천,2500,2494,6,14891,2022-02-05 10:31:39.57,null
3587,396,39787,대구,1642,1637,5,14890,2022-02-05 10:31:39.569,null
3588,362,41617,부산,1931,1930,1,14889,2022-02-05 10:31:39.569,null
3589,2199,305641,서울,8598,8564,34,14888,2022-02-05 10:31:39.569,null
3590,6858,971018,합계,36362,36162,200,14887,2022-02-05 10:31:39.569,null
3591,16,8839,검역,53,0,53,14886,2022-02-04 09:00:14.594,null
3592,13,6011,제주,212,207,5,14885,2022-02-04 09:00:14.594,null
3593,120,32031,경남,1064,1056,8,14884,2022-02-04 09:00:14.594,null
3594,225,25249,경북,1144,1140,4,14883,2022-02-04 09:00:14.594,null
3595,47,13010,전남,648,642,6,14882,2022-02-04 09:00:14.593,null
3596,130,18193,전북,1064,1063,1,14881,2022-02-04 09:00:14.593,null
3597,204,28577,충남,1072,1067,5,14880,2022-02-04 09:00:14.593,null
3598,129,17352,충북,628,628,0,14879,2022-02-04 09:00:14.593,null
3599,122,17693,강원,636,632,4,14878,2022-02-04 09:00:14.593,null
3600,2177,284478,경기,7226,7202,24,14877,2022-02-04 09:00:14.592,null
3601,4,3624,세종,252,248,4,14876,2022-02-04 09:00:14.592,null
3602,66,10332,울산,471,471,0,14875,2022-02-04 09:00:14.592,null
3603,198,18990,대전,763,757,6,14874,2022-02-04 09:00:14.592,null
3604,96,17649,광주,829,826,3,14873,2022-02-04 09:00:14.591,null
3605,341,57754,인천,1783,1779,4,14872,2022-02-04 09:00:14.591,null
3606,393,38145,대구,1713,1707,6,14871,2022-02-04 09:00:14.591,null
3607,361,39686,부산,1725,1719,6,14870,2022-02-04 09:00:14.591,null
3608,2194,297043,서울,6160,6139,21,14869,2022-02-04 09:00:14.59,null
3609,6836,934656,합계,27443,27283,160,14868,2022-02-04 09:00:14.59,null
3610,16,8787,검역,29,0,29,14867,2022-02-03 08:47:33.842,null
3611,13,5799,제주,169,168,1,14866,2022-02-03 08:47:33.841,null
3612,119,30967,경남,910,902,8,14865,2022-02-03 08:47:33.841,null
3613,221,24105,경북,935,929,6,14864,2022-02-03 08:47:33.841,null
3614,47,12362,전남,454,452,2,14863,2022-02-03 08:47:33.841,null
3615,129,17129,전북,947,944,3,14862,2022-02-03 08:47:33.84,null
3616,200,27505,충남,917,908,9,14861,2022-02-03 08:47:33.84,null
3617,127,16724,충북,570,568,2,14860,2022-02-03 08:47:33.84,null
3618,121,17057,강원,469,467,2,14859,2022-02-03 08:47:33.84,null
3619,2172,277252,경기,6557,6532,25,14858,2022-02-03 08:47:33.839,null
3620,4,3372,세종,138,137,1,14857,2022-02-03 08:47:33.839,null
3621,66,9861,울산,270,270,0,14856,2022-02-03 08:47:33.839,null
3622,198,18227,대전,559,555,4,14855,2022-02-03 08:47:33.839,null
3623,96,16820,광주,694,691,3,14854,2022-02-03 08:47:33.839,null
3624,339,55971,인천,1535,1533,2,14853,2022-02-03 08:47:33.838,null
3625,392,36432,대구,1256,1253,3,14852,2022-02-03 08:47:33.838,null
3626,361,37961,부산,1280,1273,7,14851,2022-02-03 08:47:33.838,null
3627,2191,290883,서울,5218,5191,27,14850,2022-02-03 08:47:33.837,null
3628,6812,907214,합계,22907,22773,134,14849,2022-02-03 08:47:33.837,null
3629,16,8759,검역,32,0,32,14848,2022-02-02 09:11:31.68,null
3630,13,5630,제주,122,120,2,14847,2022-02-02 09:11:31.679,null
3631,118,30057,경남,901,893,8,14846,2022-02-02 09:11:31.679,null
3632,217,23170,경북,777,771,6,14845,2022-02-02 09:11:31.679,null
3633,47,11908,전남,468,464,4,14844,2022-02-02 09:11:31.679,null
3634,127,16182,전북,656,648,8,14843,2022-02-02 09:11:31.678,null
3635,199,26588,충남,889,881,8,14842,2022-02-02 09:11:31.678,null
3636,127,16154,충북,459,455,4,14841,2022-02-02 09:11:31.678,null
3637,120,16588,강원,354,350,4,14840,2022-02-02 09:11:31.678,null
3638,2167,270695,경기,6050,6018,32,14839,2022-02-02 09:11:31.678,null
3639,4,3234,세종,140,139,1,14838,2022-02-02 09:11:31.677,null
3640,66,9591,울산,300,296,4,14837,2022-02-02 09:11:31.677,null
3641,197,17668,대전,481,479,2,14836,2022-02-02 09:11:31.677,null
3642,94,16126,광주,618,614,4,14835,2022-02-02 09:11:31.677,null
3643,339,54437,인천,1400,1396,4,14834,2022-02-02 09:11:31.676,null
3644,391,35177,대구,1147,1141,6,14833,2022-02-02 09:11:31.676,null
3645,360,36681,부산,1267,1260,7,14832,2022-02-02 09:11:31.676,null
3646,2185,285665,서울,4209,4186,23,14831,2022-02-02 09:11:31.676,null
3647,6787,884310,합계,20270,20111,159,14830,2022-02-02 09:11:31.675,null
3648,16,8727,검역,69,0,69,14829,2022-02-01 09:14:49.463,null
3649,13,5508,제주,86,86,0,14828,2022-02-01 09:14:49.463,null
3650,118,29156,경남,858,845,13,14827,2022-02-01 09:14:49.463,null
3651,216,22393,경북,619,614,5,14826,2022-02-01 09:14:49.462,null
3652,47,11440,전남,411,402,9,14825,2022-02-01 09:14:49.462,null
3653,126,15526,전북,586,583,3,14824,2022-02-01 09:14:49.462,null
3654,198,25700,충남,730,720,10,14823,2022-02-01 09:14:49.462,null
3655,126,15696,충북,410,405,5,14822,2022-02-01 09:14:49.462,null
3656,120,16234,강원,254,253,1,14821,2022-02-01 09:14:49.461,null
3657,2165,264645,경기,5537,5509,28,14820,2022-02-01 09:14:49.461,null
3658,4,3094,세종,108,108,0,14819,2022-02-01 09:14:49.461,null
3659,66,9291,울산,254,250,4,14818,2022-02-01 09:14:49.461,null
3660,196,17187,대전,462,460,2,14817,2022-02-01 09:14:49.46,null
3661,91,15508,광주,500,493,7,14816,2022-02-01 09:14:49.46,null
3662,338,53037,인천,1381,1366,15,14815,2022-02-01 09:14:49.46,null
3663,391,34030,대구,967,954,13,14814,2022-02-01 09:14:49.46,null
3664,359,35414,부산,980,972,8,14813,2022-02-01 09:14:49.46,null
3665,2182,281456,서울,4131,4103,28,14812,2022-02-01 09:14:49.459,null
3666,6772,864042,합계,18343,18123,220,14811,2022-02-01 09:14:49.459,null
3667,16,8662,검역,54,0,54,14810,2022-01-31 09:24:20.82,null
3668,13,5422,제주,74,71,3,14809,2022-01-31 09:24:20.82,null
3669,118,28299,경남,754,741,13,14808,2022-01-31 09:24:20.82,null
3670,213,21774,경북,587,583,4,14807,2022-01-31 09:24:20.82,null
3671,47,11029,전남,293,284,9,14806,2022-01-31 09:24:20.819,null
3672,125,14942,전북,530,524,6,14805,2022-01-31 09:24:20.819,null
3673,197,24972,충남,676,666,10,14804,2022-01-31 09:24:20.819,null
3674,126,15286,충북,356,351,5,14803,2022-01-31 09:24:20.819,null
3675,119,15980,강원,277,272,5,14802,2022-01-31 09:24:20.819,null
3676,2159,259108,경기,5105,5064,41,14801,2022-01-31 09:24:20.818,null
3677,4,2986,세종,78,78,0,14800,2022-01-31 09:24:20.818,null
3678,66,9037,울산,202,202,0,14799,2022-01-31 09:24:20.818,null
3679,195,16725,대전,446,444,2,14798,2022-01-31 09:24:20.818,null
3680,89,15008,광주,482,476,6,14797,2022-01-31 09:24:20.817,null
3681,338,51656,인천,1226,1209,17,14796,2022-01-31 09:24:20.817,null
3682,391,33063,대구,981,973,8,14795,2022-01-31 09:24:20.817,null
3683,359,34435,부산,771,764,7,14794,2022-01-31 09:24:20.817,null
3684,2180,277325,서울,4193,4148,45,14793,2022-01-31 09:24:20.816,null
3685,6755,845709,합계,17085,16850,235,14792,2022-01-31 09:24:20.816,null
3686,16,8610,검역,46,0,46,14791,2022-01-30 09:14:52.419,null
3687,13,5348,제주,69,67,2,14790,2022-01-30 09:14:52.419,null
3688,118,27545,경남,629,617,12,14789,2022-01-30 09:14:52.419,null
3689,211,21187,경북,597,589,8,14788,2022-01-30 09:14:52.418,null
3690,47,10736,전남,320,313,7,14787,2022-01-30 09:14:52.418,null
3691,125,14412,전북,437,432,5,14786,2022-01-30 09:14:52.418,null
3692,194,24303,충남,676,668,8,14785,2022-01-30 09:14:52.418,null
3693,126,14930,충북,351,347,4,14784,2022-01-30 09:14:52.417,null
3694,119,15703,강원,221,215,6,14783,2022-01-30 09:14:52.417,null
3695,2146,254003,경기,5711,5662,49,14782,2022-01-30 09:14:52.417,null
3696,4,2908,세종,76,74,2,14781,2022-01-30 09:14:52.417,null
3697,66,8835,울산,212,202,10,14780,2022-01-30 09:14:52.416,null
3698,195,16280,대전,450,442,8,14779,2022-01-30 09:14:52.416,null
3699,88,14526,광주,477,469,8,14778,2022-01-30 09:14:52.416,null
3700,336,50430,인천,1316,1306,10,14777,2022-01-30 09:14:52.416,null
3701,391,32085,대구,908,902,6,14776,2022-01-30 09:14:52.416,null
3702,358,33664,부산,851,841,10,14775,2022-01-30 09:14:52.415,null
3703,2179,273132,서울,4185,4157,28,14774,2022-01-30 09:14:52.415,null
3704,6732,828637,합계,17532,17303,229,14773,2022-01-30 09:14:52.415,null
3705,16,8564,검역,46,0,46,14772,2022-01-29 08:46:50.62,null
3706,13,5279,제주,76,74,2,14771,2022-01-29 08:46:50.62,null
3707,118,26916,경남,697,691,6,14770,2022-01-29 08:46:50.62,null
3708,206,20591,경북,590,578,12,14769,2022-01-29 08:46:50.619,null
3709,47,10416,전남,314,310,4,14768,2022-01-29 08:46:50.619,null
3710,125,13991,전북,559,558,1,14767,2022-01-29 08:46:50.619,null
3711,193,23627,충남,517,508,9,14766,2022-01-29 08:46:50.619,null
3712,126,14579,충북,310,309,1,14765,2022-01-29 08:46:50.619,null
3713,119,15482,강원,207,205,2,14764,2022-01-29 08:46:50.618,null
3714,2140,248292,경기,5629,5588,41,14763,2022-01-29 08:46:50.618,null
3715,4,2832,세종,43,42,1,14762,2022-01-29 08:46:50.618,null
3716,66,8623,울산,200,200,0,14761,2022-01-29 08:46:50.618,null
3717,193,15830,대전,429,425,4,14760,2022-01-29 08:46:50.617,null
3718,87,14049,광주,422,417,5,14759,2022-01-29 08:46:50.617,null
3719,335,49114,인천,1615,1599,16,14758,2022-01-29 08:46:50.617,null
3720,389,31177,대구,881,875,6,14757,2022-01-29 08:46:50.617,null
3721,358,32813,부산,808,804,4,14756,2022-01-29 08:46:50.616,null
3722,2177,268947,서울,4199,4166,33,14755,2022-01-29 08:46:50.616,null
3723,6712,811122,합계,17542,17349,193,14754,2022-01-29 08:46:50.616,null
3724,16,8518,검역,50,0,50,14753,2022-01-28 09:09:26.943,null
3725,13,5203,제주,44,44,0,14752,2022-01-28 09:09:26.943,null
3726,118,26219,경남,603,595,8,14751,2022-01-28 09:09:26.942,null
3727,204,20001,경북,538,529,9,14750,2022-01-28 09:09:26.942,null
3728,46,10102,전남,327,323,4,14749,2022-01-28 09:09:26.942,null
3729,125,13433,전북,381,369,12,14748,2022-01-28 09:09:26.942,null
3730,190,23110,충남,536,533,3,14747,2022-01-28 09:09:26.942,null
3731,125,14269,충북,299,297,2,14746,2022-01-28 09:09:26.941,null
3732,118,15275,강원,212,211,1,14745,2022-01-28 09:09:26.941,null
3733,2125,242663,경기,5175,5143,32,14744,2022-01-28 09:09:26.941,null
3734,4,2790,세종,59,58,1,14743,2022-01-28 09:09:26.941,null
3735,66,8423,울산,158,156,2,14742,2022-01-28 09:09:26.941,null
3736,193,15401,대전,370,367,3,14741,2022-01-28 09:09:26.94,null
3737,84,13627,광주,422,420,2,14740,2022-01-28 09:09:26.94,null
3738,335,47499,인천,1244,1228,16,14739,2022-01-28 09:09:26.94,null
3739,389,30296,대구,866,862,4,14738,2022-01-28 09:09:26.94,null
3740,358,32005,부산,821,813,8,14737,2022-01-28 09:09:26.94,null
3741,2169,264748,서울,3991,3946,45,14736,2022-01-28 09:09:26.939,null
3742,6678,793582,합계,16096,15894,202,14735,2022-01-28 09:09:26.939,null
3743,16,8472,검역,56,0,56,14734,2022-01-27 09:06:14.129,null
3744,13,5159,제주,72,69,3,14733,2022-01-27 09:06:14.129,null
3745,118,25616,경남,660,654,6,14732,2022-01-27 09:06:14.128,null
3746,203,19463,경북,489,480,9,14731,2022-01-27 09:06:14.128,null
3747,46,9775,전남,294,289,5,14730,2022-01-27 09:06:14.127,null
3748,125,13052,전북,311,308,3,14729,2022-01-27 09:06:14.127,null
3749,189,22574,충남,439,431,8,14728,2022-01-27 09:06:14.126,null
3750,125,13970,충북,294,287,7,14727,2022-01-27 09:06:14.126,null
3751,118,15063,강원,189,187,2,14726,2022-01-27 09:06:14.125,null
3752,2111,237491,경기,4765,4738,27,14725,2022-01-27 09:06:14.125,null
3753,4,2731,세종,76,76,0,14724,2022-01-27 09:06:14.124,null
3754,66,8265,울산,148,146,2,14723,2022-01-27 09:06:14.124,null
3755,193,15032,대전,413,408,5,14722,2022-01-27 09:06:14.123,null
3756,79,13205,광주,343,337,6,14721,2022-01-27 09:06:14.123,null
3757,335,46258,인천,1029,1010,19,14720,2022-01-27 09:06:14.122,null
3758,389,29430,대구,770,764,6,14719,2022-01-27 09:06:14.122,null
3759,356,31184,부산,741,732,9,14718,2022-01-27 09:06:14.121,null
3760,2168,260757,서울,3429,3385,44,14717,2022-01-27 09:06:14.121,null
3761,6654,777497,합계,14518,14301,217,14716,2022-01-27 09:06:14.12,null
3762,16,8416,검역,54,0,54,14715,2022-01-26 09:02:47.182,null
3763,13,5087,제주,53,51,2,14714,2022-01-26 09:02:47.182,null
3764,118,24956,경남,542,531,11,14713,2022-01-26 09:02:47.182,null
3765,203,18974,경북,445,438,7,14712,2022-01-26 09:02:47.182,null
3766,46,9481,전남,286,284,2,14711,2022-01-26 09:02:47.182,null
3767,123,12741,전북,301,293,8,14710,2022-01-26 09:02:47.181,null
3768,186,22135,충남,417,403,14,14709,2022-01-26 09:02:47.181,null
3769,124,13676,충북,247,243,4,14708,2022-01-26 09:02:47.181,null
3770,118,14874,강원,163,158,5,14707,2022-01-26 09:02:47.181,null
3771,2095,232726,경기,4221,4184,37,14706,2022-01-26 09:02:47.18,null
3772,4,2655,세종,77,76,1,14705,2022-01-26 09:02:47.18,null
3773,66,8117,울산,148,142,6,14704,2022-01-26 09:02:47.18,null
3774,192,14619,대전,370,366,4,14703,2022-01-26 09:02:47.18,null
3775,77,12862,광주,396,392,4,14702,2022-01-26 09:02:47.18,null
3776,334,45229,인천,879,860,19,14701,2022-01-26 09:02:47.179,null
3777,388,28662,대구,672,664,8,14700,2022-01-26 09:02:47.179,null
3778,353,30443,부산,563,548,15,14699,2022-01-26 09:02:47.179,null
3779,2164,257330,서울,3178,3110,68,14698,2022-01-26 09:02:47.179,null
3780,6620,762983,합계,13012,12743,269,14697,2022-01-26 09:02:47.178,null
3781,16,8362,검역,31,0,31,14696,2022-01-25 09:10:03.494,null
3782,13,5034,제주,32,30,2,14695,2022-01-25 09:10:03.494,null
3783,117,24414,경남,344,341,3,14694,2022-01-25 09:10:03.494,null
3784,200,18529,경북,281,275,6,14693,2022-01-25 09:10:03.494,null
3785,46,9195,전남,191,187,4,14692,2022-01-25 09:10:03.493,null
3786,123,12440,전북,238,232,6,14691,2022-01-25 09:10:03.493,null
3787,185,21718,충남,311,304,7,14690,2022-01-25 09:10:03.493,null
3788,123,13429,충북,124,122,2,14689,2022-01-25 09:10:03.493,null
3789,117,14711,강원,165,153,12,14688,2022-01-25 09:10:03.492,null
3790,2085,228505,경기,2917,2869,48,14687,2022-01-25 09:10:03.492,null
3791,4,2578,세종,69,69,0,14686,2022-01-25 09:10:03.492,null
3792,66,7969,울산,101,96,5,14685,2022-01-25 09:10:03.492,null
3793,192,14249,대전,226,221,5,14684,2022-01-25 09:10:03.492,null
3794,75,12466,광주,315,315,0,14683,2022-01-25 09:10:03.491,null
3795,331,44350,인천,670,653,17,14682,2022-01-25 09:10:03.491,null
3796,388,27990,대구,489,483,6,14681,2022-01-25 09:10:03.491,null
3797,352,29880,부산,343,332,11,14680,2022-01-25 09:10:03.491,null
3798,2155,254160,서울,1724,1674,50,14679,2022-01-25 09:10:03.49,null
3799,6588,749979,합계,8571,8356,215,14678,2022-01-25 09:10:03.49,null
3800,16,8333,검역,81,0,81,14677,2022-01-24 09:00:35.453,null
3801,13,5002,제주,20,15,5,14676,2022-01-24 09:00:35.453,null
3802,117,24070,경남,234,220,14,14675,2022-01-24 09:00:35.453,null
3803,195,18248,경북,234,213,21,14674,2022-01-24 09:00:35.452,null
3804,46,9004,전남,206,196,10,14673,2022-01-24 09:00:35.452,null
3805,123,12202,전북,200,192,8,14672,2022-01-24 09:00:35.452,null
3806,183,21407,충남,265,240,25,14671,2022-01-24 09:00:35.452,null
3807,123,13305,충북,147,141,6,14670,2022-01-24 09:00:35.452,null
3808,117,14546,강원,100,96,4,14669,2022-01-24 09:00:35.451,null
3809,2081,225590,경기,2442,2391,51,14668,2022-01-24 09:00:35.451,null
3810,4,2509,세종,33,31,2,14667,2022-01-24 09:00:35.451,null
3811,66,7868,울산,69,65,4,14666,2022-01-24 09:00:35.451,null
3812,192,14023,대전,158,153,5,14665,2022-01-24 09:00:35.45,null
3813,74,12151,광주,286,278,8,14664,2022-01-24 09:00:35.45,null
3814,329,43680,인천,582,552,30,14663,2022-01-24 09:00:35.45,null
3815,387,27501,대구,479,463,16,14662,2022-01-24 09:00:35.45,null
3816,351,29537,부산,298,287,11,14661,2022-01-24 09:00:35.449,null
3817,2148,252437,서울,1679,1626,53,14660,2022-01-24 09:00:35.449,null
3818,6565,741413,합계,7513,7159,354,14659,2022-01-24 09:00:35.449,null
3819,16,8254,검역,63,0,63,14658,2022-01-23 08:15:31.091,null
3820,13,4982,제주,27,23,4,14657,2022-01-23 08:15:31.091,null
3821,116,23836,경남,226,213,13,14656,2022-01-23 08:15:31.09,null
3822,192,18014,경북,215,207,8,14655,2022-01-23 08:15:31.09,null
3823,46,8798,전남,196,191,5,14654,2022-01-23 08:15:31.09,null
3824,123,12002,전북,140,136,4,14653,2022-01-23 08:15:31.09,null
3825,181,21142,충남,207,197,10,14652,2022-01-23 08:15:31.089,null
3826,123,13158,충북,110,108,2,14651,2022-01-23 08:15:31.089,null
3827,116,14446,강원,89,79,10,14650,2022-01-23 08:15:31.089,null
3828,2076,223148,경기,2713,2667,46,14649,2022-01-23 08:15:31.089,null
3829,4,2476,세종,24,23,1,14648,2022-01-23 08:15:31.089,null
3830,66,7799,울산,91,84,7,14647,2022-01-23 08:15:31.088,null
3831,192,13865,대전,159,151,8,14646,2022-01-23 08:15:31.088,null
3832,71,11865,광주,316,306,10,14645,2022-01-23 08:15:31.088,null
3833,329,43098,인천,610,589,21,14644,2022-01-23 08:15:31.088,null
3834,387,27022,대구,458,448,10,14643,2022-01-23 08:15:31.088,null
3835,349,29239,부산,292,287,5,14642,2022-01-23 08:15:31.087,null
3836,2140,250758,서울,1694,1634,60,14641,2022-01-23 08:15:31.087,null
3837,6540,733902,합계,7630,7343,287,14640,2022-01-23 08:15:31.087,null
3838,16,8191,검역,88,0,88,14639,2022-01-22 07:29:31.788,null
3839,13,4955,제주,18,17,1,14638,2022-01-22 07:29:31.788,null
3840,116,23610,경남,220,215,5,14637,2022-01-22 07:29:31.787,null
3841,192,17799,경북,207,198,9,14636,2022-01-22 07:29:31.787,null
3842,46,8602,전남,154,152,2,14635,2022-01-22 07:29:31.787,null
3843,123,11862,전북,171,167,4,14634,2022-01-22 07:29:31.787,null
3844,181,20935,충남,200,191,9,14633,2022-01-22 07:29:31.786,null
3845,123,13048,충북,150,143,7,14632,2022-01-22 07:29:31.786,null
3846,115,14357,강원,99,87,12,14631,2022-01-22 07:29:31.786,null
3847,2072,220435,경기,2426,2383,43,14630,2022-01-22 07:29:31.786,null
3848,4,2452,세종,12,12,0,14629,2022-01-22 07:29:31.786,null
3849,66,7708,울산,51,50,1,14628,2022-01-22 07:29:31.785,null
3850,192,13706,대전,119,118,1,14627,2022-01-22 07:29:31.785,null
3851,70,11549,광주,252,246,6,14626,2022-01-22 07:29:31.785,null
3852,329,42489,인천,571,542,29,14625,2022-01-22 07:29:31.784,null
3853,387,26564,대구,444,442,2,14624,2022-01-22 07:29:31.784,null
3854,349,28947,부산,236,231,5,14623,2022-01-22 07:29:31.784,null
3855,2135,249065,서울,1591,1535,56,14622,2022-01-22 07:29:31.784,null
3856,6529,726274,합계,7009,6729,280,14621,2022-01-22 07:29:31.783,null
3857,16,8103,검역,36,0,36,14620,2022-01-21 08:58:27.95,null
3858,13,4938,제주,15,10,5,14619,2022-01-21 08:58:27.95,null
3859,114,23391,경남,188,178,10,14618,2022-01-21 08:58:27.949,null
3860,190,17592,경북,234,225,9,14617,2022-01-21 08:58:27.949,null
3861,46,8448,전남,199,198,1,14616,2022-01-21 08:58:27.949,null
3862,123,11691,전북,165,159,6,14615,2022-01-21 08:58:27.949,null
3863,180,20735,충남,193,183,10,14614,2022-01-21 08:58:27.949,null
3864,123,12898,충북,87,85,2,14613,2022-01-21 08:58:27.948,null
3865,114,14258,강원,161,136,25,14612,2022-01-21 08:58:27.948,null
3866,2068,218009,경기,2431,2349,82,14611,2022-01-21 08:58:27.948,null
3867,4,2440,세종,17,17,0,14610,2022-01-21 08:58:27.948,null
3868,66,7657,울산,82,78,4,14609,2022-01-21 08:58:27.948,null
3869,192,13587,대전,111,111,0,14608,2022-01-21 08:58:27.947,null
3870,67,11297,광주,242,237,5,14607,2022-01-21 08:58:27.947,null
3871,328,41919,인천,452,438,14,14606,2022-01-21 08:58:27.947,null
3872,387,26120,대구,388,386,2,14605,2022-01-21 08:58:27.947,null
3873,348,28711,부산,216,207,9,14604,2022-01-21 08:58:27.946,null
3874,2122,247475,서울,1552,1485,67,14603,2022-01-21 08:58:27.946,null
3875,6501,719269,합계,6769,6482,287,14602,2022-01-21 08:58:27.946,null
3876,16,8067,검역,44,0,44,14601,2022-01-20 09:16:42.952,null
3877,13,4923,제주,10,9,1,14600,2022-01-20 09:16:42.952,null
3878,114,23203,경남,224,218,6,14599,2022-01-20 09:16:42.952,null
3879,190,17358,경북,226,220,6,14598,2022-01-20 09:16:42.951,null
3880,46,8249,전남,160,157,3,14597,2022-01-20 09:16:42.951,null
3881,123,11526,전북,138,131,7,14596,2022-01-20 09:16:42.951,null
3882,179,20542,충남,217,208,9,14595,2022-01-20 09:16:42.951,null
3883,123,12812,충북,176,174,2,14594,2022-01-20 09:16:42.95,null
3884,113,14097,강원,111,107,4,14593,2022-01-20 09:16:42.95,null
3885,2062,215578,경기,2418,2364,54,14592,2022-01-20 09:16:42.95,null
3886,4,2423,세종,9,9,0,14591,2022-01-20 09:16:42.95,null
3887,66,7575,울산,72,69,3,14590,2022-01-20 09:16:42.95,null
3888,189,13476,대전,97,94,3,14589,2022-01-20 09:16:42.949,null
3889,65,11055,광주,354,350,4,14588,2022-01-20 09:16:42.949,null
3890,327,41467,인천,418,407,11,14587,2022-01-20 09:16:42.949,null
3891,387,25732,대구,364,355,9,14586,2022-01-20 09:16:42.949,null
3892,346,28495,부산,203,193,10,14585,2022-01-20 09:16:42.949,null
3893,2117,245925,서울,1362,1292,70,14584,2022-01-20 09:16:42.948,null
3894,6480,712503,합계,6603,6357,246,14583,2022-01-20 09:16:42.948,null
3895,16,8023,검역,64,0,64,14582,2022-01-19 09:09:24.648,null
3896,13,4913,제주,13,8,5,14581,2022-01-19 09:09:24.648,null
3897,114,22979,경남,201,183,18,14580,2022-01-19 09:09:24.648,null
3898,190,17132,경북,170,151,19,14579,2022-01-19 09:09:24.648,null
3899,46,8089,전남,154,143,11,14578,2022-01-19 09:09:24.648,null
3900,123,11388,전북,143,134,9,14577,2022-01-19 09:09:24.647,null
3901,178,20325,충남,183,173,10,14576,2022-01-19 09:09:24.647,null
3902,123,12636,충북,81,79,2,14575,2022-01-19 09:09:24.647,null
3903,111,13986,강원,148,146,2,14574,2022-01-19 09:09:24.647,null
3904,2052,213160,경기,2176,2116,60,14573,2022-01-19 09:09:24.647,null
3905,4,2414,세종,26,26,0,14572,2022-01-19 09:09:24.646,null
3906,65,7503,울산,44,44,0,14571,2022-01-19 09:09:24.646,null
3907,189,13379,대전,118,109,9,14570,2022-01-19 09:09:24.646,null
3908,62,10701,광주,226,218,8,14569,2022-01-19 09:09:24.646,null
3909,327,41049,인천,424,401,23,14568,2022-01-19 09:09:24.645,null
3910,386,25368,대구,213,197,16,14567,2022-01-19 09:09:24.645,null
3911,346,28292,부산,190,178,12,14566,2022-01-19 09:09:24.645,null
3912,2107,244565,서울,1231,1125,106,14565,2022-01-19 09:09:24.645,null
3913,6452,705902,합계,5805,5431,374,14564,2022-01-19 09:09:24.644,null
3914,16,7960,검역,77,0,77,14563,2022-01-18 09:04:47.189,null
3915,13,4900,제주,3,2,1,14562,2022-01-18 09:04:47.189,null
3916,114,22778,경남,142,134,8,14561,2022-01-18 09:04:47.189,null
3917,189,16962,경북,138,129,9,14560,2022-01-18 09:04:47.189,null
3918,45,7935,전남,139,138,1,14559,2022-01-18 09:04:47.189,null
3919,121,11245,전북,151,147,4,14558,2022-01-18 09:04:47.188,null
3920,177,20142,충남,145,140,5,14557,2022-01-18 09:04:47.188,null
3921,123,12555,충북,59,55,4,14556,2022-01-18 09:04:47.188,null
3922,110,13838,강원,94,94,0,14555,2022-01-18 09:04:47.188,null
3923,2036,210984,경기,1530,1470,60,14554,2022-01-18 09:04:47.188,null
3924,4,2388,세종,23,21,2,14553,2022-01-18 09:04:47.187,null
3925,65,7459,울산,35,33,2,14552,2022-01-18 09:04:47.187,null
3926,187,13262,대전,108,101,7,14551,2022-01-18 09:04:47.187,null
3927,60,10475,광주,184,174,10,14550,2022-01-18 09:04:47.187,null
3928,326,40625,인천,196,177,19,14549,2022-01-18 09:04:47.186,null
3929,385,25155,대구,171,162,9,14548,2022-01-18 09:04:47.186,null
3930,344,28102,부산,114,102,12,14547,2022-01-18 09:04:47.186,null
3931,2063,243337,서울,763,684,79,14546,2022-01-18 09:04:47.186,null
3932,6378,700102,합계,4072,3763,309,14545,2022-01-18 09:04:47.186,null
3933,16,7883,검역,58,0,58,14544,2022-01-17 09:03:57.784,null
3934,13,4897,제주,12,12,0,14543,2022-01-17 09:03:57.784,null
3935,114,22636,경남,119,106,13,14542,2022-01-17 09:03:57.784,null
3936,188,16824,경북,95,87,8,14541,2022-01-17 09:03:57.783,null
3937,45,7796,전남,166,161,5,14540,2022-01-17 09:03:57.783,null
3938,121,11094,전북,124,114,10,14539,2022-01-17 09:03:57.783,null
3939,174,19997,충남,104,93,11,14538,2022-01-17 09:03:57.783,null
3940,121,12497,충북,42,38,4,14537,2022-01-17 09:03:57.783,null
3941,110,13744,강원,79,73,6,14536,2022-01-17 09:03:57.782,null
3942,2017,209454,경기,1427,1351,76,14535,2022-01-17 09:03:57.782,null
3943,4,2365,세종,7,5,2,14534,2022-01-17 09:03:57.782,null
3944,65,7424,울산,19,17,2,14533,2022-01-17 09:03:57.782,null
3945,187,13154,대전,82,79,3,14532,2022-01-17 09:03:57.782,null
3946,57,10291,광주,242,237,5,14531,2022-01-17 09:03:57.781,null
3947,324,40430,인천,200,187,13,14530,2022-01-17 09:03:57.781,null
3948,385,24984,대구,176,171,5,14529,2022-01-17 09:03:57.781,null
3949,341,27988,부산,117,109,8,14528,2022-01-17 09:03:57.781,null
3950,2051,242574,서울,790,711,79,14527,2022-01-17 09:03:57.78,null
3951,6333,696032,합계,3859,3551,308,14526,2022-01-17 09:03:57.78,null
3952,16,7825,검역,86,0,86,14525,2022-01-16 09:34:37.487,null
3953,13,4885,제주,8,5,3,14524,2022-01-16 09:34:37.487,null
3954,114,22517,경남,123,112,11,14523,2022-01-16 09:34:37.487,null
3955,188,16729,경북,108,102,6,14522,2022-01-16 09:34:37.487,null
3956,45,7630,전남,169,160,9,14521,2022-01-16 09:34:37.486,null
3957,120,10970,전북,123,112,11,14520,2022-01-16 09:34:37.486,null
3958,170,19893,충남,114,105,9,14519,2022-01-16 09:34:37.486,null
3959,121,12455,충북,39,37,2,14518,2022-01-16 09:34:37.486,null
3960,110,13665,강원,74,69,5,14517,2022-01-16 09:34:37.485,null
3961,2014,208027,경기,1586,1511,75,14516,2022-01-16 09:34:37.485,null
3962,4,2359,세종,21,20,1,14515,2022-01-16 09:34:37.485,null
3963,65,7405,울산,19,15,4,14514,2022-01-16 09:34:37.485,null
3964,184,13072,대전,54,47,7,14513,2022-01-16 09:34:37.484,null
3965,55,10049,광주,183,173,10,14512,2022-01-16 09:34:37.484,null
3966,324,40230,인천,260,235,25,14511,2022-01-16 09:34:37.484,null
3967,385,24808,대구,157,147,10,14510,2022-01-16 09:34:37.484,null
3968,338,27871,부산,145,137,8,14509,2022-01-16 09:34:37.483,null
3969,2044,241784,서울,925,826,99,14508,2022-01-16 09:34:37.483,null
3970,6310,692174,합계,4194,3813,381,14507,2022-01-16 09:34:37.483,null
3971,16,7739,검역,94,0,94,14506,2022-01-15 08:30:50.548,null
3972,13,4877,제주,13,10,3,14505,2022-01-15 08:30:50.548,null
3973,113,22394,경남,116,108,8,14504,2022-01-15 08:30:50.548,null
3974,187,16621,경북,95,85,10,14503,2022-01-15 08:30:50.548,null
3975,45,7462,전남,155,151,4,14502,2022-01-15 08:30:50.548,null
3976,120,10847,전북,123,120,3,14501,2022-01-15 08:30:50.547,null
3977,166,19779,충남,121,110,11,14500,2022-01-15 08:30:50.547,null
3978,120,12416,충북,83,77,6,14499,2022-01-15 08:30:50.547,null
3979,110,13591,강원,79,75,4,14498,2022-01-15 08:30:50.547,null
3980,2009,206441,경기,1823,1761,62,14497,2022-01-15 08:30:50.547,null
3981,4,2338,세종,15,15,0,14496,2022-01-15 08:30:50.546,null
3982,65,7386,울산,17,14,3,14495,2022-01-15 08:30:50.546,null
3983,184,13018,대전,53,49,4,14494,2022-01-15 08:30:50.546,null
3984,55,9866,광주,207,205,2,14493,2022-01-15 08:30:50.546,null
3985,322,39970,인천,248,221,27,14492,2022-01-15 08:30:50.545,null
3986,382,24651,대구,126,118,8,14491,2022-01-15 08:30:50.545,null
3987,337,27726,부산,143,135,8,14490,2022-01-15 08:30:50.545,null
3988,2033,240862,서울,912,823,89,14489,2022-01-15 08:30:50.545,null
3989,6281,687984,합계,4423,4077,346,14488,2022-01-15 08:30:50.544,null
3990,16,7647,검역,145,0,145,14487,2022-01-14 09:02:25.089,null
3991,13,4864,제주,6,3,3,14486,2022-01-14 09:02:25.089,null
3992,113,22278,경남,126,117,9,14485,2022-01-14 09:02:25.089,null
3993,187,16526,경북,93,88,5,14484,2022-01-14 09:02:25.089,null
3994,45,7307,전남,133,132,1,14483,2022-01-14 09:02:25.088,null
3995,120,10724,전북,102,99,3,14482,2022-01-14 09:02:25.088,null
3996,165,19659,충남,106,99,7,14481,2022-01-14 09:02:25.088,null
3997,120,12333,충북,71,67,4,14480,2022-01-14 09:02:25.088,null
3998,110,13512,강원,144,139,5,14479,2022-01-14 09:02:25.087,null
3999,2002,204618,경기,1856,1784,72,14478,2022-01-14 09:02:25.087,null
4000,4,2323,세종,8,8,0,14477,2022-01-14 09:02:25.087,null
4001,65,7369,울산,40,34,6,14476,2022-01-14 09:02:25.087,null
4002,184,12965,대전,66,64,2,14475,2022-01-14 09:02:25.087,null
4003,55,9660,광주,224,224,0,14474,2022-01-14 09:02:25.086,null
4004,317,39722,인천,266,242,24,14473,2022-01-14 09:02:25.086,null
4005,382,24526,대구,90,77,13,14472,2022-01-14 09:02:25.086,null
4006,337,27583,부산,127,121,6,14471,2022-01-14 09:02:25.086,null
4007,2024,239950,서울,939,835,104,14470,2022-01-14 09:02:25.085,null
4008,6259,683566,합계,4542,4133,409,14469,2022-01-14 09:02:25.085,null
4009,16,7503,검역,93,0,93,14468,2022-01-13 08:47:41.205,null
4010,13,4858,제주,7,7,0,14467,2022-01-13 08:47:41.205,null
4011,112,22152,경남,115,94,21,14466,2022-01-13 08:47:41.205,null
4012,186,16433,경북,99,92,7,14465,2022-01-13 08:47:41.205,null
4013,44,7174,전남,136,133,3,14464,2022-01-13 08:47:41.204,null
4014,120,10623,전북,106,106,0,14463,2022-01-13 08:47:41.204,null
4015,165,19553,충남,131,126,5,14462,2022-01-13 08:47:41.204,null
4016,120,12263,충북,61,58,3,14461,2022-01-13 08:47:41.204,null
4017,110,13368,강원,89,82,7,14460,2022-01-13 08:47:41.203,null
4018,1985,202762,경기,1535,1444,91,14459,2022-01-13 08:47:41.203,null
4019,4,2315,세종,7,6,1,14458,2022-01-13 08:47:41.203,null
4020,65,7329,울산,27,26,1,14457,2022-01-13 08:47:41.203,null
4021,181,12899,대전,68,63,5,14456,2022-01-13 08:47:41.203,null
4022,54,9436,광주,188,182,6,14455,2022-01-13 08:47:41.202,null
4023,315,39456,인천,240,224,16,14454,2022-01-13 08:47:41.202,null
4024,382,24436,대구,125,119,6,14453,2022-01-13 08:47:41.202,null
4025,329,27456,부산,162,156,6,14452,2022-01-13 08:47:41.202,null
4026,2009,239014,서울,978,858,120,14451,2022-01-13 08:47:41.201,null
4027,6210,679030,합계,4167,3776,391,14450,2022-01-13 08:47:41.201,null
4028,16,7412,검역,135,0,135,14449,2022-01-12 09:11:55.83,null
4029,13,4851,제주,5,4,1,14448,2022-01-12 09:11:55.83,null
4030,112,22037,경남,119,112,7,14447,2022-01-12 09:11:55.829,null
4031,185,16334,경북,77,72,5,14446,2022-01-12 09:11:55.829,null
4032,44,7038,전남,164,160,4,14445,2022-01-12 09:11:55.829,null
4033,117,10517,전북,58,58,0,14444,2022-01-12 09:11:55.829,null
4034,163,19422,충남,115,112,3,14443,2022-01-12 09:11:55.829,null
4035,120,12202,충북,68,66,2,14442,2022-01-12 09:11:55.828,null
4036,108,13279,강원,117,113,4,14441,2022-01-12 09:11:55.828,null
4037,1970,201227,경기,1629,1567,62,14440,2022-01-12 09:11:55.828,null
4038,4,2308,세종,14,14,0,14439,2022-01-12 09:11:55.828,null
4039,65,7302,울산,27,27,0,14438,2022-01-12 09:11:55.828,null
4040,180,12831,대전,90,81,9,14437,2022-01-12 09:11:55.827,null
4041,52,9248,광주,158,158,0,14436,2022-01-12 09:11:55.827,null
4042,312,39216,인천,262,243,19,14435,2022-01-12 09:11:55.827,null
4043,381,24311,대구,93,91,2,14434,2022-01-12 09:11:55.827,null
4044,328,27294,부산,164,156,8,14433,2022-01-12 09:11:55.826,null
4045,1996,238039,서울,1093,973,120,14432,2022-01-12 09:11:55.826,null
4046,6166,674868,합계,4388,4007,381,14431,2022-01-12 09:11:55.826,null
4047,16,7277,검역,70,0,70,14430,2022-01-11 09:09:28.121,null
4048,13,4846,제주,15,13,2,14429,2022-01-11 09:09:28.12,null
4049,109,21918,경남,92,84,8,14428,2022-01-11 09:09:28.12,null
4050,183,16257,경북,60,58,2,14427,2022-01-11 09:09:28.12,null
4051,44,6874,전남,88,87,1,14426,2022-01-11 09:09:28.12,null
4052,116,10459,전북,58,55,3,14425,2022-01-11 09:09:28.12,null
4053,162,19307,충남,105,98,7,14424,2022-01-11 09:09:28.12,null
4054,119,12134,충북,54,53,1,14423,2022-01-11 09:09:28.119,null
4055,108,13162,강원,88,85,3,14422,2022-01-11 09:09:28.119,null
4056,1955,199600,경기,1115,1055,60,14421,2022-01-11 09:09:28.119,null
4057,4,2294,세종,16,15,1,14420,2022-01-11 09:09:28.119,null
4058,64,7275,울산,22,17,5,14419,2022-01-11 09:09:28.119,null
4059,180,12741,대전,43,34,9,14418,2022-01-11 09:09:28.118,null
4060,51,9090,광주,176,175,1,14417,2022-01-11 09:09:28.118,null
4061,308,38955,인천,154,140,14,14416,2022-01-11 09:09:28.118,null
4062,380,24218,대구,71,66,5,14415,2022-01-11 09:09:28.118,null
4063,324,27130,부산,115,108,7,14414,2022-01-11 09:09:28.117,null
4064,1978,236946,서울,755,670,85,14413,2022-01-11 09:09:28.117,null
4065,6114,670483,합계,3097,2813,284,14412,2022-01-11 09:09:28.117,null
4066,16,7209,검역,72,0,72,14411,2022-01-10 09:08:34.468,null
4067,13,4831,제주,13,8,5,14410,2022-01-10 09:08:34.468,null
4068,109,21826,경남,80,77,3,14409,2022-01-10 09:08:34.468,null
4069,182,16197,경북,88,79,9,14408,2022-01-10 09:08:34.467,null
4070,44,6786,전남,86,83,3,14407,2022-01-10 09:08:34.467,null
4071,116,10401,전북,96,93,3,14406,2022-01-10 09:08:34.467,null
4072,161,19202,충남,101,90,11,14405,2022-01-10 09:08:34.467,null
4073,119,12080,충북,30,27,3,14404,2022-01-10 09:08:34.467,null
4074,108,13074,강원,60,56,4,14403,2022-01-10 09:08:34.466,null
4075,1940,198485,경기,1014,982,32,14402,2022-01-10 09:08:34.466,null
4076,4,2278,세종,13,12,1,14401,2022-01-10 09:08:34.466,null
4077,64,7253,울산,23,20,3,14400,2022-01-10 09:08:34.466,null
4078,179,12698,대전,33,30,3,14399,2022-01-10 09:08:34.466,null
4079,50,8914,광주,133,131,2,14398,2022-01-10 09:08:34.465,null
4080,304,38801,인천,125,115,10,14397,2022-01-10 09:08:34.465,null
4081,376,24148,대구,94,89,5,14396,2022-01-10 09:08:34.465,null
4082,321,27015,부산,165,158,7,14395,2022-01-10 09:08:34.465,null
4083,1965,236192,서울,781,718,63,14394,2022-01-10 09:08:34.465,null
4084,6071,667390,합계,3007,2768,239,14393,2022-01-10 09:08:34.464,null
4085,16,7138,검역,54,0,54,14392,2022-01-09 08:43:12.844,null
4086,13,4818,제주,11,8,3,14391,2022-01-09 08:43:12.844,null
4087,107,21746,경남,98,86,12,14390,2022-01-09 08:43:12.844,null
4088,180,16109,경북,93,89,4,14389,2022-01-09 08:43:12.844,null
4089,43,6700,전남,112,111,1,14388,2022-01-09 08:43:12.843,null
4090,114,10305,전북,76,71,5,14387,2022-01-09 08:43:12.843,null
4091,159,19104,충남,111,106,5,14386,2022-01-09 08:43:12.843,null
4092,118,12050,충북,34,32,2,14385,2022-01-09 08:43:12.843,null
4093,108,13014,강원,77,70,7,14384,2022-01-09 08:43:12.843,null
4094,1931,197471,경기,1114,1081,33,14383,2022-01-09 08:43:12.842,null
4095,4,2265,세종,13,13,0,14382,2022-01-09 08:43:12.842,null
4096,64,7230,울산,34,31,3,14381,2022-01-09 08:43:12.842,null
4097,179,12665,대전,40,35,5,14380,2022-01-09 08:43:12.842,null
4098,50,8781,광주,92,88,4,14379,2022-01-09 08:43:12.842,null
4099,302,38676,인천,185,172,13,14378,2022-01-09 08:43:12.841,null
4100,376,24054,대구,108,105,3,14377,2022-01-09 08:43:12.841,null
4101,318,26850,부산,158,151,7,14376,2022-01-09 08:43:12.841,null
4102,1955,235415,서울,966,891,75,14375,2022-01-09 08:43:12.841,null
4103,6037,664391,합계,3376,3140,236,14374,2022-01-09 08:43:12.84,null
4104,16,7084,검역,53,0,53,14373,2022-01-08 08:32:16.448,null
4105,13,4807,제주,9,6,3,14372,2022-01-08 08:32:16.448,null
4106,104,21648,경남,101,96,5,14371,2022-01-08 08:32:16.448,null
4107,179,16016,경북,85,82,3,14370,2022-01-08 08:32:16.448,null
4108,43,6588,전남,96,93,3,14369,2022-01-08 08:32:16.447,null
4109,113,10229,전북,67,64,3,14368,2022-01-08 08:32:16.447,null
4110,157,18993,충남,96,93,3,14367,2022-01-08 08:32:16.447,null
4111,117,12016,충북,53,51,2,14366,2022-01-08 08:32:16.447,null
4112,108,12937,강원,81,77,4,14365,2022-01-08 08:32:16.447,null
4113,1916,196357,경기,1208,1168,40,14364,2022-01-08 08:32:16.446,null
4114,4,2252,세종,12,11,1,14363,2022-01-08 08:32:16.446,null
4115,63,7196,울산,27,27,0,14362,2022-01-08 08:32:16.446,null
4116,179,12625,대전,47,42,5,14361,2022-01-08 08:32:16.446,null
4117,49,8689,광주,89,87,2,14360,2022-01-08 08:32:16.445,null
4118,299,38491,인천,203,193,10,14359,2022-01-08 08:32:16.445,null
4119,375,23946,대구,108,104,4,14358,2022-01-08 08:32:16.445,null
4120,317,26692,부산,181,173,8,14357,2022-01-08 08:32:16.445,null
4121,1934,234449,서울,994,933,61,14356,2022-01-08 08:32:16.445,null
4122,5986,661015,합계,3510,3300,210,14355,2022-01-08 08:32:16.444,null
4123,16,7031,검역,38,0,38,14354,2022-01-07 09:07:38.476,null
4124,13,4798,제주,10,8,2,14353,2022-01-07 09:07:38.476,null
4125,102,21548,경남,102,99,3,14352,2022-01-07 09:07:38.475,null
4126,178,15931,경북,109,104,5,14351,2022-01-07 09:07:38.475,null
4127,40,6492,전남,124,120,4,14350,2022-01-07 09:07:38.475,null
4128,112,10162,전북,84,78,6,14349,2022-01-07 09:07:38.475,null
4129,156,18897,충남,116,108,8,14348,2022-01-07 09:07:38.474,null
4130,116,11963,충북,90,88,2,14347,2022-01-07 09:07:38.474,null
4131,108,12856,강원,90,88,2,14346,2022-01-07 09:07:38.474,null
4132,1906,195149,경기,1261,1224,37,14345,2022-01-07 09:07:38.474,null
4133,4,2240,세종,14,14,0,14344,2022-01-07 09:07:38.474,null
4134,63,7169,울산,38,33,5,14343,2022-01-07 09:07:38.473,null
4135,179,12578,대전,29,28,1,14342,2022-01-07 09:07:38.473,null
4136,49,8600,광주,87,87,0,14341,2022-01-07 09:07:38.473,null
4137,293,38288,인천,181,172,9,14340,2022-01-07 09:07:38.473,null
4138,373,23838,대구,99,95,4,14339,2022-01-07 09:07:38.472,null
4139,311,26511,부산,207,204,3,14338,2022-01-07 09:07:38.472,null
4140,1913,233457,서울,1038,979,59,14337,2022-01-07 09:07:38.472,null
4141,5932,657508,합계,3717,3529,188,14336,2022-01-07 09:07:38.471,null
4142,16,6994,검역,69,0,69,14335,2022-01-06 09:00:30.288,null
4143,13,4788,제주,19,16,3,14334,2022-01-06 09:00:30.288,null
4144,99,21446,경남,103,101,2,14333,2022-01-06 09:00:30.287,null
4145,177,15822,경북,89,88,1,14332,2022-01-06 09:00:30.287,null
4146,40,6368,전남,59,57,2,14331,2022-01-06 09:00:30.287,null
4147,111,10078,전북,71,71,0,14330,2022-01-06 09:00:30.287,null
4148,156,18781,충남,79,77,2,14329,2022-01-06 09:00:30.287,null
4149,115,11873,충북,45,45,0,14328,2022-01-06 09:00:30.286,null
4150,105,12766,강원,57,54,3,14327,2022-01-06 09:00:30.286,null
4151,1897,193888,경기,1526,1496,30,14326,2022-01-06 09:00:30.286,null
4152,4,2226,세종,18,18,0,14325,2022-01-06 09:00:30.286,null
4153,63,7131,울산,30,28,2,14324,2022-01-06 09:00:30.286,null
4154,178,12549,대전,41,38,3,14323,2022-01-06 09:00:30.285,null
4155,49,8513,광주,91,91,0,14322,2022-01-06 09:00:30.285,null
4156,287,38107,인천,283,273,10,14321,2022-01-06 09:00:30.285,null
4157,371,23739,대구,110,106,4,14320,2022-01-06 09:00:30.285,null
4158,308,26304,부산,228,222,6,14319,2022-01-06 09:00:30.284,null
4159,1898,232419,서울,1208,1150,58,14318,2022-01-06 09:00:30.284,null
4160,5887,653792,합계,4126,3931,195,14317,2022-01-06 09:00:30.284,null
4161,16,6926,검역,49,0,49,14316,2022-01-05 09:04:30.498,null
4162,13,4769,제주,43,43,0,14315,2022-01-05 09:04:30.498,null
4163,98,21343,경남,114,111,3,14314,2022-01-05 09:04:30.498,null
4164,173,15733,경북,97,97,0,14313,2022-01-05 09:04:30.498,null
4165,40,6309,전남,60,60,0,14312,2022-01-05 09:04:30.498,null
4166,108,10007,전북,97,93,4,14311,2022-01-05 09:04:30.497,null
4167,155,18702,충남,139,137,2,14310,2022-01-05 09:04:30.497,null
4168,114,11828,충북,68,67,1,14309,2022-01-05 09:04:30.497,null
4169,105,12709,강원,69,68,1,14308,2022-01-05 09:04:30.497,null
4170,1884,192362,경기,1467,1416,51,14307,2022-01-05 09:04:30.497,null
4171,4,2208,세종,17,17,0,14306,2022-01-05 09:04:30.496,null
4172,63,7101,울산,48,47,1,14305,2022-01-05 09:04:30.496,null
4173,175,12508,대전,51,41,10,14304,2022-01-05 09:04:30.496,null
4174,47,8422,광주,75,73,2,14303,2022-01-05 09:04:30.496,null
4175,281,37824,인천,271,261,10,14302,2022-01-05 09:04:30.495,null
4176,369,23629,대구,112,108,4,14301,2022-01-05 09:04:30.495,null
4177,305,26076,부산,255,248,7,14300,2022-01-05 09:04:30.495,null
4178,1888,231213,서울,1412,1346,66,14299,2022-01-05 09:04:30.495,null
4179,5838,649669,합계,4444,4233,211,14298,2022-01-05 09:04:30.494,null
4180,16,6878,검역,26,0,26,14297,2022-01-04 09:07:46.528,null
4181,13,4726,제주,18,17,1,14296,2022-01-04 09:07:46.528,null
4182,97,21229,경남,117,112,5,14295,2022-01-04 09:07:46.528,null
4183,171,15636,경북,62,59,3,14294,2022-01-04 09:07:46.528,null
4184,40,6249,전남,46,42,4,14293,2022-01-04 09:07:46.527,null
4185,107,9910,전북,92,89,3,14292,2022-01-04 09:07:46.527,null
4186,152,18563,충남,114,110,4,14291,2022-01-04 09:07:46.527,null
4187,113,11760,충북,61,61,0,14290,2022-01-04 09:07:46.527,null
4188,103,12640,강원,63,62,1,14289,2022-01-04 09:07:46.527,null
4189,1872,190895,경기,947,916,31,14288,2022-01-04 09:07:46.527,null
4190,4,2191,세종,11,11,0,14287,2022-01-04 09:07:46.526,null
4191,63,7053,울산,34,33,1,14286,2022-01-04 09:07:46.526,null
4192,174,12457,대전,34,31,3,14285,2022-01-04 09:07:46.526,null
4193,47,8347,광주,61,59,2,14284,2022-01-04 09:07:46.526,null
4194,279,37553,인천,171,162,9,14283,2022-01-04 09:07:46.525,null
4195,369,23517,대구,84,79,5,14282,2022-01-04 09:07:46.525,null
4196,296,25821,부산,145,143,2,14281,2022-01-04 09:07:46.525,null
4197,1865,229801,서울,938,903,35,14280,2022-01-04 09:07:46.525,null
4198,5781,645226,합계,3024,2889,135,14279,2022-01-04 09:07:46.524,null
4199,16,6852,검역,43,0,43,14278,2022-01-03 09:01:48.117,null
4200,13,4708,제주,28,27,1,14277,2022-01-03 09:01:48.117,null
4201,95,21113,경남,132,129,3,14276,2022-01-03 09:01:48.116,null
4202,170,15574,경북,49,47,2,14275,2022-01-03 09:01:48.116,null
4203,40,6203,전남,35,33,2,14274,2022-01-03 09:01:48.115,null
4204,105,9818,전북,86,83,3,14273,2022-01-03 09:01:48.115,null
4205,150,18449,충남,115,115,0,14272,2022-01-03 09:01:48.114,null
4206,113,11699,충북,47,45,2,14271,2022-01-03 09:01:48.114,null
4207,102,12577,강원,54,50,4,14270,2022-01-03 09:01:48.113,null
4208,1864,189948,경기,917,894,23,14269,2022-01-03 09:01:48.113,null
4209,4,2180,세종,10,9,1,14268,2022-01-03 09:01:48.112,null
4210,63,7019,울산,38,38,0,14267,2022-01-03 09:01:48.112,null
4211,173,12423,대전,49,46,3,14266,2022-01-03 09:01:48.111,null
4212,45,8286,광주,75,73,2,14265,2022-01-03 09:01:48.111,null
4213,274,37382,인천,187,177,10,14264,2022-01-03 09:01:48.11,null
4214,369,23433,대구,98,97,1,14263,2022-01-03 09:01:48.11,null
4215,287,25676,부산,173,166,7,14262,2022-01-03 09:01:48.109,null
4216,1847,228867,서울,993,964,29,14261,2022-01-03 09:01:48.109,null
4217,5730,642207,합계,3129,2993,136,14260,2022-01-03 09:01:48.108,null
4218,16,6809,검역,31,0,31,14259,2022-01-02 09:00:41.983,null
4219,13,4680,제주,19,18,1,14258,2022-01-02 09:00:41.983,null
4220,92,20981,경남,141,136,5,14257,2022-01-02 09:00:41.983,null
4221,170,15525,경북,94,94,0,14256,2022-01-02 09:00:41.983,null
4222,40,6168,전남,42,40,2,14255,2022-01-02 09:00:41.982,null
4223,105,9732,전북,79,76,3,14254,2022-01-02 09:00:41.982,null
4224,149,18334,충남,101,98,3,14253,2022-01-02 09:00:41.982,null
4225,110,11652,충북,50,49,1,14252,2022-01-02 09:00:41.982,null
4226,102,12523,강원,59,56,3,14251,2022-01-02 09:00:41.982,null
4227,1854,189031,경기,1277,1244,33,14250,2022-01-02 09:00:41.981,null
4228,4,2170,세종,12,12,0,14249,2022-01-02 09:00:41.981,null
4229,63,6981,울산,58,58,0,14248,2022-01-02 09:00:41.981,null
4230,170,12374,대전,59,54,5,14247,2022-01-02 09:00:41.981,null
4231,45,8211,광주,93,93,0,14246,2022-01-02 09:00:41.981,null
4232,268,37195,인천,233,231,2,14245,2022-01-02 09:00:41.98,null
4233,368,23335,대구,86,83,3,14244,2022-01-02 09:00:41.98,null
4234,286,25503,부산,216,214,2,14243,2022-01-02 09:00:41.98,null
4235,1839,227879,서울,1183,1127,56,14242,2022-01-02 09:00:41.98,null
4236,5694,639083,합계,3833,3683,150,14241,2022-01-02 09:00:41.979,null
4237,16,6779,검역,25,0,25,14240,2022-01-01 08:56:49.63,null
4238,13,4661,제주,23,22,1,14239,2022-01-01 08:56:49.63,null
4239,92,20840,경남,162,162,0,14238,2022-01-01 08:56:49.629,null
4240,166,15431,경북,116,114,2,14237,2022-01-01 08:56:49.629,null
4241,38,6126,전남,48,47,1,14236,2022-01-01 08:56:49.629,null
4242,105,9653,전북,85,84,1,14235,2022-01-01 08:56:49.629,null
4243,147,18233,충남,138,136,2,14234,2022-01-01 08:56:49.629,null
4244,109,11602,충북,104,103,1,14233,2022-01-01 08:56:49.628,null
4245,102,12464,강원,59,59,0,14232,2022-01-01 08:56:49.628,null
4246,1835,187754,경기,1391,1359,32,14231,2022-01-01 08:56:49.628,null
4247,4,2158,세종,16,16,0,14230,2022-01-01 08:56:49.628,null
4248,62,6923,울산,50,50,0,14229,2022-01-01 08:56:49.627,null
4249,168,12315,대전,65,64,1,14228,2022-01-01 08:56:49.627,null
4250,45,8118,광주,92,91,1,14227,2022-01-01 08:56:49.627,null
4251,266,36962,인천,241,239,2,14226,2022-01-01 08:56:49.627,null
4252,366,23249,대구,125,125,0,14225,2022-01-01 08:56:49.627,null
4253,278,25287,부산,212,210,2,14224,2022-01-01 08:56:49.626,null
4254,1813,226698,서울,1464,1429,35,14223,2022-01-01 08:56:49.626,null
4255,5625,635253,합계,4416,4310,106,14222,2022-01-01 08:56:49.626,null
4256,16,6754,검역,26,0,26,14221,2021-12-31 09:06:59.806,null
4257,13,4638,제주,16,14,2,14220,2021-12-31 09:06:59.805,null
4258,91,20678,경남,231,228,3,14219,2021-12-31 09:06:59.805,null
4259,161,15315,경북,105,103,2,14218,2021-12-31 09:06:59.805,null
4260,37,6078,전남,60,58,2,14217,2021-12-31 09:06:59.805,null
4261,105,9568,전북,99,99,0,14216,2021-12-31 09:06:59.805,null
4262,144,18095,충남,137,136,1,14215,2021-12-31 09:06:59.804,null
4263,109,11498,충북,74,73,1,14214,2021-12-31 09:06:59.804,null
4264,102,12405,강원,72,69,3,14213,2021-12-31 09:06:59.804,null
4265,1822,186363,경기,1476,1454,22,14212,2021-12-31 09:06:59.804,null
4266,4,2142,세종,17,17,0,14211,2021-12-31 09:06:59.803,null
4267,62,6873,울산,40,38,2,14210,2021-12-31 09:06:59.803,null
4268,167,12250,대전,71,69,2,14209,2021-12-31 09:06:59.803,null
4269,44,8026,광주,85,85,0,14208,2021-12-31 09:06:59.803,null
4270,265,36721,인천,304,293,11,14207,2021-12-31 09:06:59.803,null
4271,364,23124,대구,132,130,2,14206,2021-12-31 09:06:59.802,null
4272,271,25075,부산,260,257,3,14205,2021-12-31 09:06:59.802,null
4273,1786,225235,서울,1670,1635,35,14204,2021-12-31 09:06:59.802,null
4274,5563,630838,합계,4875,4758,117,14203,2021-12-31 09:06:59.802,null
4275,16,6729,검역,34,0,34,14202,2021-12-30 09:09:47.379,null
4276,13,4622,제주,21,20,1,14201,2021-12-30 09:09:47.378,null
4277,87,20447,경남,197,197,0,14200,2021-12-30 09:09:47.378,null
4278,152,15210,경북,82,82,0,14199,2021-12-30 09:09:47.378,null
4279,37,6018,전남,48,47,1,14198,2021-12-30 09:09:47.378,null
4280,99,9469,전북,230,228,2,14197,2021-12-30 09:09:47.378,null
4281,141,17958,충남,123,122,1,14196,2021-12-30 09:09:47.377,null
4282,108,11424,충북,80,80,0,14195,2021-12-30 09:09:47.377,null
4283,100,12333,강원,91,87,4,14194,2021-12-30 09:09:47.377,null
4284,1792,184887,경기,1465,1448,17,14193,2021-12-30 09:09:47.377,null
4285,4,2125,세종,21,21,0,14192,2021-12-30 09:09:47.377,null
4286,62,6833,울산,40,37,3,14191,2021-12-30 09:09:47.376,null
4287,165,12179,대전,90,88,2,14190,2021-12-30 09:09:47.376,null
4288,41,7941,광주,102,101,1,14189,2021-12-30 09:09:47.376,null
4289,260,36418,인천,318,316,2,14188,2021-12-30 09:09:47.376,null
4290,361,22992,대구,117,115,2,14187,2021-12-30 09:09:47.376,null
4291,266,24815,부산,256,252,4,14186,2021-12-30 09:09:47.375,null
4292,1751,223567,서울,1722,1689,33,14185,2021-12-30 09:09:47.375,null
4293,5455,625967,합계,5037,4930,107,14184,2021-12-30 09:09:47.375,null
4294,16,6695,검역,26,0,26,14183,2021-12-29 08:59:08.535,null
4295,13,4601,제주,33,32,1,14182,2021-12-29 08:59:08.535,null
4296,85,20250,경남,265,262,3,14181,2021-12-29 08:59:08.535,null
4297,150,15128,경북,104,103,1,14180,2021-12-29 08:59:08.535,null
4298,37,5970,전남,39,39,0,14179,2021-12-29 08:59:08.535,null
4299,99,9239,전북,109,109,0,14178,2021-12-29 08:59:08.534,null
4300,135,17835,충남,119,117,2,14177,2021-12-29 08:59:08.534,null
4301,108,11344,충북,101,98,3,14176,2021-12-29 08:59:08.534,null
4302,99,12242,강원,87,87,0,14175,2021-12-29 08:59:08.534,null
4303,1766,183425,경기,1633,1608,25,14174,2021-12-29 08:59:08.534,null
4304,4,2104,세종,21,19,2,14173,2021-12-29 08:59:08.533,null
4305,61,6793,울산,49,47,2,14172,2021-12-29 08:59:08.533,null
4306,164,12090,대전,79,77,2,14171,2021-12-29 08:59:08.533,null
4307,39,7839,광주,80,80,0,14170,2021-12-29 08:59:08.533,null
4308,257,36101,인천,314,309,5,14169,2021-12-29 08:59:08.532,null
4309,359,22875,대구,139,136,3,14168,2021-12-29 08:59:08.532,null
4310,261,24560,부산,296,291,5,14167,2021-12-29 08:59:08.532,null
4311,1729,221847,서울,1915,1869,46,14166,2021-12-29 08:59:08.532,null
4312,5382,620938,합계,5409,5283,126,14165,2021-12-29 08:59:08.531,null
4313,16,6669,검역,10,0,10,14164,2021-12-28 09:02:52.058,null
4314,13,4568,제주,6,6,0,14163,2021-12-28 09:02:52.057,null
4315,85,19985,경남,176,173,3,14162,2021-12-28 09:02:52.057,null
4316,149,15024,경북,86,84,2,14161,2021-12-28 09:02:52.056,null
4317,37,5931,전남,38,36,2,14160,2021-12-28 09:02:52.056,null
4318,99,9131,전북,90,90,0,14159,2021-12-28 09:02:52.055,null
4319,133,17716,충남,128,126,2,14158,2021-12-28 09:02:52.055,null
4320,108,11243,충북,65,64,1,14157,2021-12-28 09:02:52.054,null
4321,99,12155,강원,79,79,0,14156,2021-12-28 09:02:52.054,null
4322,1760,181792,경기,1063,1045,18,14155,2021-12-28 09:02:52.053,null
4323,4,2083,세종,18,18,0,14154,2021-12-28 09:02:52.053,null
4324,61,6744,울산,39,39,0,14153,2021-12-28 09:02:52.052,null
4325,161,12011,대전,80,79,1,14152,2021-12-28 09:02:52.052,null
4326,39,7759,광주,70,70,0,14151,2021-12-28 09:02:52.051,null
4327,250,35787,인천,241,233,8,14150,2021-12-28 09:02:52.051,null
4328,356,22736,대구,149,148,1,14149,2021-12-28 09:02:52.05,null
4329,255,24264,부산,237,233,4,14148,2021-12-28 09:02:52.05,null
4330,1721,219934,서울,1290,1254,36,14147,2021-12-28 09:02:52.049,null
4331,5346,615532,합계,3865,3777,88,14146,2021-12-28 09:02:52.049,null
4332,16,6659,검역,14,0,14,14145,2021-12-27 09:00:33.916,null
4333,13,4562,제주,16,16,0,14144,2021-12-27 09:00:33.916,null
4334,85,19809,경남,200,197,3,14143,2021-12-27 09:00:33.915,null
4335,149,14938,경북,71,70,1,14142,2021-12-27 09:00:33.915,null
4336,37,5893,전남,30,30,0,14141,2021-12-27 09:00:33.915,null
4337,98,9041,전북,89,88,1,14140,2021-12-27 09:00:33.915,null
4338,131,17588,충남,148,148,0,14139,2021-12-27 09:00:33.915,null
4339,107,11178,충북,63,63,0,14138,2021-12-27 09:00:33.914,null
4340,99,12076,강원,120,119,1,14137,2021-12-27 09:00:33.914,null
4341,1744,180729,경기,1173,1160,13,14136,2021-12-27 09:00:33.914,null
4342,4,2065,세종,10,10,0,14135,2021-12-27 09:00:33.914,null
4343,61,6705,울산,42,40,2,14134,2021-12-27 09:00:33.913,null
4344,161,11931,대전,40,38,2,14133,2021-12-27 09:00:33.913,null
4345,38,7689,광주,60,59,1,14132,2021-12-27 09:00:33.913,null
4346,249,35546,인천,234,227,7,14131,2021-12-27 09:00:33.913,null
4347,356,22588,대구,131,127,4,14130,2021-12-27 09:00:33.913,null
4348,254,24027,부산,270,267,3,14129,2021-12-27 09:00:33.912,null
4349,1698,218646,서울,1496,1466,30,14128,2021-12-27 09:00:33.912,null
4350,5300,611670,합계,4207,4125,82,14127,2021-12-27 09:00:33.912,null
4351,16,6645,검역,5,0,5,14126,2021-12-26 08:02:50.677,null
4352,13,4546,제주,28,28,0,14125,2021-12-26 08:02:50.677,null
4353,85,19609,경남,201,200,1,14124,2021-12-26 08:02:50.677,null
4354,148,14867,경북,130,125,5,14123,2021-12-26 08:02:50.677,null
4355,34,5863,전남,48,47,1,14122,2021-12-26 08:02:50.676,null
4356,98,8952,전북,98,97,1,14121,2021-12-26 08:02:50.676,null
4357,128,17440,충남,117,116,1,14120,2021-12-26 08:02:50.676,null
4358,107,11115,충북,80,79,1,14119,2021-12-26 08:02:50.676,null
4359,98,11956,강원,107,107,0,14118,2021-12-26 08:02:50.676,null
4360,1733,179556,경기,1653,1634,19,14117,2021-12-26 08:02:50.675,null
4361,3,2055,세종,12,10,2,14116,2021-12-26 08:02:50.675,null
4362,61,6663,울산,53,52,1,14115,2021-12-26 08:02:50.675,null
4363,156,11891,대전,84,77,7,14114,2021-12-26 08:02:50.675,null
4364,38,7629,광주,67,65,2,14113,2021-12-26 08:02:50.675,null
4365,241,35312,인천,328,325,3,14112,2021-12-26 08:02:50.674,null
4366,356,22457,대구,120,120,0,14111,2021-12-26 08:02:50.674,null
4367,249,23757,부산,371,368,3,14110,2021-12-26 08:02:50.674,null
4368,1681,217150,서울,1917,1889,28,14109,2021-12-26 08:02:50.674,null
4369,5245,607463,합계,5419,5339,80,14108,2021-12-26 08:02:50.673,null
4370,16,6640,검역,13,0,13,14107,2021-12-25 07:37:53.455,null
4371,13,4518,제주,15,15,0,14106,2021-12-25 07:37:53.455,null
4372,82,19408,경남,213,212,1,14105,2021-12-25 07:37:53.454,null
4373,145,14737,경북,128,127,1,14104,2021-12-25 07:37:53.454,null
4374,34,5815,전남,53,53,0,14103,2021-12-25 07:37:53.454,null
4375,97,8854,전북,116,114,2,14102,2021-12-25 07:37:53.454,null
4376,125,17323,충남,161,161,0,14101,2021-12-25 07:37:53.454,null
4377,106,11036,충북,83,83,0,14100,2021-12-25 07:37:53.453,null
4378,97,11849,강원,147,147,0,14099,2021-12-25 07:37:53.453,null
4379,1702,177903,경기,1680,1663,17,14098,2021-12-25 07:37:53.453,null
4380,3,2043,세종,21,21,0,14097,2021-12-25 07:37:53.453,null
4381,61,6610,울산,63,62,1,14096,2021-12-25 07:37:53.452,null
4382,154,11807,대전,104,102,2,14095,2021-12-25 07:37:53.452,null
4383,37,7562,광주,78,76,2,14094,2021-12-25 07:37:53.452,null
4384,238,34984,인천,400,398,2,14093,2021-12-25 07:37:53.452,null
4385,356,22337,대구,103,102,1,14092,2021-12-25 07:37:53.452,null
4386,247,23386,부산,341,340,1,14091,2021-12-25 07:37:53.451,null
4387,1663,215233,서울,2123,2091,32,14090,2021-12-25 07:37:53.451,null
4388,5176,602045,합계,5842,5767,75,14089,2021-12-25 07:37:53.451,null
4389,16,6627,검역,8,0,8,14088,2021-12-24 09:04:23.503,null
4390,13,4503,제주,25,24,1,14087,2021-12-24 09:04:23.503,null
4391,81,19195,경남,230,228,2,14086,2021-12-24 09:04:23.503,null
4392,143,14609,경북,144,144,0,14085,2021-12-24 09:04:23.503,null
4393,34,5762,전남,69,68,1,14084,2021-12-24 09:04:23.502,null
4394,97,8738,전북,118,117,1,14083,2021-12-24 09:04:23.502,null
4395,123,17162,충남,180,176,4,14082,2021-12-24 09:04:23.502,null
4396,105,10953,충북,91,90,1,14081,2021-12-24 09:04:23.502,null
4397,97,11702,강원,130,129,1,14080,2021-12-24 09:04:23.502,null
4398,1666,176223,경기,1668,1647,21,14079,2021-12-24 09:04:23.501,null
4399,3,2022,세종,36,36,0,14078,2021-12-24 09:04:23.501,null
4400,61,6547,울산,43,43,0,14077,2021-12-24 09:04:23.501,null
4401,148,11703,대전,81,81,0,14076,2021-12-24 09:04:23.5,null
4402,37,7484,광주,54,54,0,14075,2021-12-24 09:04:23.5,null
4403,234,34585,인천,438,433,5,14074,2021-12-24 09:04:23.5,null
4404,354,22234,대구,151,150,1,14073,2021-12-24 09:04:23.5,null
4405,244,23046,부산,421,419,2,14072,2021-12-24 09:04:23.5,null
4406,1615,213114,서울,2346,2324,22,14071,2021-12-24 09:04:23.499,null
4407,5071,596209,합계,6233,6163,70,14070,2021-12-24 09:04:23.499,null
4408,16,6619,검역,6,0,6,14069,2021-12-23 08:53:41.657,null
4409,13,4478,제주,17,17,0,14068,2021-12-23 08:53:41.657,null
4410,79,18965,경남,201,200,1,14067,2021-12-23 08:53:41.657,null
4411,140,14466,경북,135,134,1,14066,2021-12-23 08:53:41.657,null
4412,34,5693,전남,69,68,1,14065,2021-12-23 08:53:41.657,null
4413,97,8620,전북,149,149,0,14064,2021-12-23 08:53:41.656,null
4414,122,16982,충남,183,180,3,14063,2021-12-23 08:53:41.656,null
4415,105,10862,충북,85,85,0,14062,2021-12-23 08:53:41.656,null
4416,97,11572,강원,120,120,0,14061,2021-12-23 08:53:41.656,null
4417,1648,174555,경기,1949,1929,20,14060,2021-12-23 08:53:41.655,null
4418,3,1987,세종,19,18,1,14059,2021-12-23 08:53:41.655,null
4419,61,6504,울산,44,43,1,14058,2021-12-23 08:53:41.655,null
4420,145,11622,대전,133,133,0,14057,2021-12-23 08:53:41.655,null
4421,37,7430,광주,66,66,0,14056,2021-12-23 08:53:41.655,null
4422,230,34147,인천,422,420,2,14055,2021-12-23 08:53:41.654,null
4423,349,22083,대구,168,167,1,14054,2021-12-23 08:53:41.654,null
4424,241,22625,부산,433,432,1,14053,2021-12-23 08:53:41.654,null
4425,1598,210768,서울,2720,2695,25,14052,2021-12-23 08:53:41.654,null
4426,5015,589978,합계,6919,6856,63,14051,2021-12-23 08:53:41.653,null
4427,16,6613,검역,5,0,5,14050,2021-12-22 09:22:43.008,null
4428,13,4461,제주,37,37,0,14049,2021-12-22 09:22:43.008,null
4429,77,18764,경남,252,246,6,14048,2021-12-22 09:22:43.007,null
4430,135,14331,경북,139,137,2,14047,2021-12-22 09:22:43.007,null
4431,32,5624,전남,47,46,1,14046,2021-12-22 09:22:43.007,null
4432,97,8475,전북,135,135,0,14045,2021-12-22 09:22:43.007,null
4433,122,16801,충남,165,162,3,14044,2021-12-22 09:22:43.007,null
4434,104,10777,충북,123,121,2,14043,2021-12-22 09:22:43.006,null
4435,96,11452,강원,130,130,0,14042,2021-12-22 09:22:43.006,null
4436,1609,172606,경기,2225,2192,33,14041,2021-12-22 09:22:43.006,null
4437,3,1968,세종,47,45,2,14040,2021-12-22 09:22:43.006,null
4438,60,6460,울산,39,39,0,14039,2021-12-22 09:22:43.006,null
4439,129,11489,대전,157,156,1,14038,2021-12-22 09:22:43.005,null
4440,36,7364,광주,106,103,3,14037,2021-12-22 09:22:43.005,null
4441,224,33725,인천,479,475,4,14036,2021-12-22 09:22:43.005,null
4442,348,21915,대구,133,131,2,14035,2021-12-22 09:22:43.005,null
4443,236,22192,부산,432,431,1,14034,2021-12-22 09:22:43.005,null
4444,1569,208048,서울,2805,2779,26,14033,2021-12-22 09:22:43.004,null
4445,4906,583065,합계,7456,7365,91,14032,2021-12-22 09:22:43.004,null
4446,16,6608,검역,10,0,10,14031,2021-12-21 09:03:16.287,null
4447,13,4424,제주,26,25,1,14030,2021-12-21 09:03:16.287,null
4448,76,18512,경남,184,184,0,14029,2021-12-21 09:03:16.286,null
4449,133,14192,경북,107,101,6,14028,2021-12-21 09:03:16.286,null
4450,32,5577,전남,41,40,1,14027,2021-12-21 09:03:16.286,null
4451,95,8340,전북,144,144,0,14026,2021-12-21 09:03:16.285,null
4452,122,16636,충남,163,163,0,14025,2021-12-21 09:03:16.285,null
4453,102,10654,충북,89,87,2,14024,2021-12-21 09:03:16.285,null
4454,95,11322,강원,117,116,1,14023,2021-12-21 09:03:16.285,null
4455,1586,170381,경기,1313,1299,14,14022,2021-12-21 09:03:16.285,null
4456,3,1921,세종,21,21,0,14021,2021-12-21 09:03:16.284,null
4457,60,6421,울산,35,35,0,14020,2021-12-21 09:03:16.284,null
4458,122,11332,대전,126,125,1,14019,2021-12-21 09:03:16.284,null
4459,35,7258,광주,76,75,1,14018,2021-12-21 09:03:16.284,null
4460,222,33246,인천,384,381,3,14017,2021-12-21 09:03:16.283,null
4461,346,21782,대구,138,136,2,14016,2021-12-21 09:03:16.283,null
4462,233,21760,부산,234,233,1,14015,2021-12-21 09:03:16.283,null
4463,1537,205249,서울,1994,1979,15,14014,2021-12-21 09:03:16.283,null
4464,4828,575615,합계,5202,5144,58,14013,2021-12-21 09:03:16.282,null
4465,16,6598,검역,13,0,13,14012,2021-12-20 09:05:51.081,null
4466,13,4398,제주,30,26,4,14011,2021-12-20 09:05:51.081,null
4467,74,18328,경남,156,155,1,14010,2021-12-20 09:05:51.081,null
4468,132,14085,경북,117,115,2,14009,2021-12-20 09:05:51.08,null
4469,31,5536,전남,56,54,2,14008,2021-12-20 09:05:51.08,null
4470,94,8196,전북,100,99,1,14007,2021-12-20 09:05:51.08,null
4471,119,16473,충남,185,184,1,14006,2021-12-20 09:05:51.08,null
4472,101,10565,충북,68,68,0,14005,2021-12-20 09:05:51.079,null
4473,94,11205,강원,130,126,4,14004,2021-12-20 09:05:51.079,null
4474,1572,169068,경기,1488,1475,13,14003,2021-12-20 09:05:51.079,null
4475,3,1900,세종,16,16,0,14002,2021-12-20 09:05:51.079,null
4476,59,6386,울산,36,36,0,14001,2021-12-20 09:05:51.079,null
4477,119,11206,대전,112,112,0,14000,2021-12-20 09:05:51.078,null
4478,35,7182,광주,52,52,0,13999,2021-12-20 09:05:51.078,null
4479,218,32862,인천,375,371,4,13998,2021-12-20 09:05:51.078,null
4480,346,21645,대구,111,110,1,13997,2021-12-20 09:05:51.078,null
4481,229,21526,부산,365,364,1,13996,2021-12-20 09:05:51.078,null
4482,1521,203255,서울,1908,1895,13,13995,2021-12-20 09:05:51.077,null
4483,4776,570414,합계,5318,5258,60,13994,2021-12-20 09:05:51.077,null
4484,16,6586,검역,6,0,6,13993,2021-12-19 09:08:01.701,null
4485,12,4368,제주,22,22,0,13992,2021-12-19 09:08:01.701,null
4486,70,18172,경남,215,214,1,13991,2021-12-19 09:08:01.701,null
4487,132,13968,경북,137,134,3,13990,2021-12-19 09:08:01.701,null
4488,30,5480,전남,43,43,0,13989,2021-12-19 09:08:01.701,null
4489,93,8097,전북,92,92,0,13988,2021-12-19 09:08:01.7,null
4490,118,16288,충남,207,206,1,13987,2021-12-19 09:08:01.7,null
4491,101,10497,충북,92,91,1,13986,2021-12-19 09:08:01.699,null
4492,93,11075,강원,100,100,0,13985,2021-12-19 09:08:01.699,null
4493,1555,167580,경기,1753,1723,30,13984,2021-12-19 09:08:01.698,null
4494,3,1884,세종,23,23,0,13983,2021-12-19 09:08:01.698,null
4495,59,6350,울산,39,37,2,13982,2021-12-19 09:08:01.698,null
4496,118,11094,대전,149,147,2,13981,2021-12-19 09:08:01.698,null
4497,34,7130,광주,29,27,2,13980,2021-12-19 09:08:01.697,null
4498,213,32487,인천,493,492,1,13979,2021-12-19 09:08:01.697,null
4499,344,21534,대구,153,152,1,13978,2021-12-19 09:08:01.697,null
4500,228,21161,부산,363,362,1,13977,2021-12-19 09:08:01.696,null
4501,1503,201347,서울,2320,2308,12,13976,2021-12-19 09:08:01.696,null
4502,4722,565098,합계,6236,6173,63,13975,2021-12-19 09:08:01.695,null
4503,16,6580,검역,9,0,9,13974,2021-12-18 09:15:52.19,null
4504,11,4346,제주,30,30,0,13973,2021-12-18 09:15:52.19,null
4505,67,17957,경남,211,210,1,13972,2021-12-18 09:15:52.19,null
4506,131,13832,경북,139,139,0,13971,2021-12-18 09:15:52.19,null
4507,30,5437,전남,44,44,0,13970,2021-12-18 09:15:52.19,null
4508,92,8005,전북,110,110,0,13969,2021-12-18 09:15:52.189,null
4509,115,16081,충남,240,238,2,13968,2021-12-18 09:15:52.189,null
4510,101,10405,충북,127,127,0,13967,2021-12-18 09:15:52.189,null
4511,91,10975,강원,126,126,0,13966,2021-12-18 09:15:52.189,null
4512,1530,165827,경기,2041,2033,8,13965,2021-12-18 09:15:52.188,null
4513,3,1861,세종,43,43,0,13964,2021-12-18 09:15:52.188,null
4514,59,6311,울산,46,46,0,13963,2021-12-18 09:15:52.188,null
4515,110,10945,대전,120,120,0,13962,2021-12-18 09:15:52.188,null
4516,33,7101,광주,57,55,2,13961,2021-12-18 09:15:52.187,null
4517,210,31994,인천,600,599,1,13960,2021-12-18 09:15:52.187,null
4518,341,21381,대구,215,214,1,13959,2021-12-18 09:15:52.187,null
4519,225,20798,부산,362,362,0,13958,2021-12-18 09:15:52.187,null
4520,1479,199028,서울,2794,2788,6,13957,2021-12-18 09:15:52.186,null
4521,4644,558864,합계,7314,7284,30,13956,2021-12-18 09:15:52.186,null
4522,16,6571,검역,8,0,8,13955,2021-12-17 09:09:46.324,null
4523,11,4316,제주,35,35,0,13954,2021-12-17 09:09:46.324,null
4524,67,17746,경남,171,171,0,13953,2021-12-17 09:09:46.324,null
4525,131,13693,경북,169,168,1,13952,2021-12-17 09:09:46.324,null
4526,30,5393,전남,60,58,2,13951,2021-12-17 09:09:46.323,null
4527,91,7895,전북,122,122,0,13950,2021-12-17 09:09:46.323,null
4528,112,15841,충남,203,203,0,13949,2021-12-17 09:09:46.323,null
4529,99,10278,충북,128,128,0,13948,2021-12-17 09:09:46.323,null
4530,90,10849,강원,134,134,0,13947,2021-12-17 09:09:46.323,null
4531,1514,163786,경기,2153,2147,6,13946,2021-12-17 09:09:46.322,null
4532,3,1818,세종,25,25,0,13945,2021-12-17 09:09:46.322,null
4533,59,6265,울산,57,57,0,13944,2021-12-17 09:09:46.322,null
4534,110,10825,대전,162,162,0,13943,2021-12-17 09:09:46.322,null
4535,32,7044,광주,42,42,0,13942,2021-12-17 09:09:46.321,null
4536,205,31394,인천,572,565,7,13941,2021-12-17 09:09:46.321,null
4537,339,21167,대구,160,158,2,13940,2021-12-17 09:09:46.321,null
4538,221,20436,부산,388,388,0,13939,2021-12-17 09:09:46.321,null
4539,1461,196234,서울,2846,2837,9,13938,2021-12-17 09:09:46.32,null
4540,4591,551551,합계,7435,7400,35,13937,2021-12-17 09:09:46.32,null
4541,16,6563,검역,3,0,3,13936,2021-12-16 09:06:37.424,null
4542,10,4281,제주,29,29,0,13935,2021-12-16 09:06:37.424,null
4543,67,17575,경남,199,199,0,13934,2021-12-16 09:06:37.424,null
4544,128,13524,경북,208,208,0,13933,2021-12-16 09:06:37.424,null
4545,30,5333,전남,58,58,0,13932,2021-12-16 09:06:37.423,null
4546,89,7773,전북,150,149,1,13931,2021-12-16 09:06:37.423,null
4547,110,15638,충남,177,177,0,13930,2021-12-16 09:06:37.423,null
4548,98,10150,충북,149,149,0,13929,2021-12-16 09:06:37.423,null
4549,89,10715,강원,148,148,0,13928,2021-12-16 09:06:37.423,null
4550,1490,161633,경기,2152,2140,12,13927,2021-12-16 09:06:37.422,null
4551,3,1793,세종,28,28,0,13926,2021-12-16 09:06:37.422,null
4552,59,6208,울산,76,76,0,13925,2021-12-16 09:06:37.422,null
4553,101,10663,대전,129,129,0,13924,2021-12-16 09:06:37.422,null
4554,32,7002,광주,44,44,0,13923,2021-12-16 09:06:37.422,null
4555,201,30822,인천,511,509,2,13922,2021-12-16 09:06:37.421,null
4556,339,21007,대구,158,156,2,13921,2021-12-16 09:06:37.421,null
4557,218,20048,부산,346,345,1,13920,2021-12-16 09:06:37.421,null
4558,1438,193389,서울,3057,3047,10,13919,2021-12-16 09:06:37.421,null
4559,4518,544117,합계,7622,7591,31,13918,2021-12-16 09:06:37.42,null
4560,16,6560,검역,4,0,4,13917,2021-12-15 09:07:09.35,null
4561,10,4252,제주,33,32,1,13916,2021-12-15 09:07:09.35,null
4562,66,17376,경남,195,194,1,13915,2021-12-15 09:07:09.35,null
4563,127,13316,경북,193,193,0,13914,2021-12-15 09:07:09.35,null
4564,29,5275,전남,60,59,1,13913,2021-12-15 09:07:09.349,null
4565,87,7623,전북,120,120,0,13912,2021-12-15 09:07:09.349,null
4566,108,15461,충남,210,209,1,13911,2021-12-15 09:07:09.349,null
4567,98,10001,충북,105,105,0,13910,2021-12-15 09:07:09.349,null
4568,88,10567,강원,160,160,0,13909,2021-12-15 09:07:09.348,null
4569,1472,159481,경기,2299,2296,3,13908,2021-12-15 09:07:09.348,null
4570,3,1765,세종,26,26,0,13907,2021-12-15 09:07:09.348,null
4571,59,6132,울산,59,59,0,13906,2021-12-15 09:07:09.348,null
4572,100,10534,대전,164,164,0,13905,2021-12-15 09:07:09.348,null
4573,32,6958,광주,59,59,0,13904,2021-12-15 09:07:09.347,null
4574,195,30311,인천,476,475,1,13903,2021-12-15 09:07:09.347,null
4575,338,20849,대구,178,177,1,13902,2021-12-15 09:07:09.347,null
4576,210,19702,부산,343,343,0,13901,2021-12-15 09:07:09.347,null
4577,1418,190332,서울,3166,3157,9,13900,2021-12-15 09:07:09.346,null
4578,4456,536495,합계,7850,7828,22,13899,2021-12-15 09:07:09.346,null
4579,16,6556,검역,15,0,15,13898,2021-12-14 09:07:12.101,null
4580,10,4219,제주,39,39,0,13897,2021-12-14 09:07:12.101,null
4581,66,17181,경남,181,181,0,13896,2021-12-14 09:07:12.101,null
4582,126,13123,경북,166,165,1,13895,2021-12-14 09:07:12.101,null
4583,29,5215,전남,58,58,0,13894,2021-12-14 09:07:12.1,null
4584,87,7503,전북,117,117,0,13893,2021-12-14 09:07:12.1,null
4585,103,15255,충남,203,202,1,13892,2021-12-14 09:07:12.1,null
4586,97,9896,충북,86,86,0,13891,2021-12-14 09:07:12.1,null
4587,86,10407,강원,132,132,0,13890,2021-12-14 09:07:12.1,null
4588,1450,157182,경기,1497,1486,11,13889,2021-12-14 09:07:12.099,null
4589,3,1739,세종,20,20,0,13888,2021-12-14 09:07:12.099,null
4590,57,6073,울산,85,85,0,13887,2021-12-14 09:07:12.099,null
4591,95,10370,대전,151,151,0,13886,2021-12-14 09:07:12.099,null
4592,32,6899,광주,71,69,2,13885,2021-12-14 09:07:12.099,null
4593,192,29835,인천,348,348,0,13884,2021-12-14 09:07:12.098,null
4594,336,20671,대구,130,128,2,13883,2021-12-14 09:07:12.098,null
4595,207,19359,부산,206,205,1,13882,2021-12-14 09:07:12.098,null
4596,1395,187169,서울,2062,2053,9,13881,2021-12-14 09:07:12.098,null
4597,4387,528652,합계,5567,5525,42,13880,2021-12-14 09:07:12.097,null
4598,16,6541,검역,7,0,7,13879,2021-12-13 09:00:42.806,null
4599,10,4180,제주,36,36,0,13878,2021-12-13 09:00:42.805,null
4600,65,17000,경남,218,214,4,13877,2021-12-13 09:00:42.805,null
4601,124,12957,경북,163,162,1,13876,2021-12-13 09:00:42.805,null
4602,29,5157,전남,83,83,0,13875,2021-12-13 09:00:42.804,null
4603,86,7387,전북,81,81,0,13874,2021-12-13 09:00:42.804,null
4604,101,15053,충남,184,183,1,13873,2021-12-13 09:00:42.804,null
4605,97,9810,충북,76,76,0,13872,2021-12-13 09:00:42.804,null
4606,84,10275,강원,111,111,0,13871,2021-12-13 09:00:42.804,null
4607,1423,155685,경기,1367,1361,6,13870,2021-12-13 09:00:42.803,null
4608,3,1719,세종,12,10,2,13869,2021-12-13 09:00:42.803,null
4609,57,5988,울산,39,39,0,13868,2021-12-13 09:00:42.803,null
4610,89,10219,대전,78,78,0,13867,2021-12-13 09:00:42.803,null
4611,32,6828,광주,37,37,0,13866,2021-12-13 09:00:42.803,null
4612,186,29487,인천,390,389,1,13865,2021-12-13 09:00:42.802,null
4613,334,20541,대구,144,142,2,13864,2021-12-13 09:00:42.802,null
4614,201,19153,부산,241,239,2,13863,2021-12-13 09:00:42.802,null
4615,1356,185108,서울,2550,2542,8,13862,2021-12-13 09:00:42.802,null
4616,4293,523088,합계,5817,5783,34,13861,2021-12-13 09:00:42.801,null
4617,16,6534,검역,7,0,7,13860,2021-12-12 08:26:53.712,null
4618,10,4144,제주,32,32,0,13859,2021-12-12 08:26:53.712,null
4619,65,16782,경남,198,198,0,13858,2021-12-12 08:26:53.712,null
4620,121,12794,경북,147,147,0,13857,2021-12-12 08:26:53.711,null
4621,29,5074,전남,80,80,0,13856,2021-12-12 08:26:53.711,null
4622,85,7306,전북,88,88,0,13855,2021-12-12 08:26:53.711,null
4623,99,14869,충남,207,204,3,13854,2021-12-12 08:26:53.711,null
4624,96,9734,충북,90,90,0,13853,2021-12-12 08:26:53.71,null
4625,84,10164,강원,123,122,1,13852,2021-12-12 08:26:53.71,null
4626,1413,154318,경기,2015,2012,3,13851,2021-12-12 08:26:53.71,null
4627,3,1707,세종,15,15,0,13850,2021-12-12 08:26:53.71,null
4628,57,5949,울산,50,49,1,13849,2021-12-12 08:26:53.71,null
4629,87,10141,대전,115,115,0,13848,2021-12-12 08:26:53.709,null
4630,32,6791,광주,71,68,3,13847,2021-12-12 08:26:53.709,null
4631,181,29097,인천,458,457,1,13846,2021-12-12 08:26:53.709,null
4632,334,20397,대구,137,137,0,13845,2021-12-12 08:26:53.709,null
4633,201,18912,부산,328,327,1,13844,2021-12-12 08:26:53.708,null
4634,1340,182558,서울,2528,2520,8,13843,2021-12-12 08:26:53.708,null
4635,4253,517271,합계,6689,6661,28,13842,2021-12-12 08:26:53.708,null
4636,16,6527,검역,2,0,2,13841,2021-12-11 06:15:36.602,null
4637,10,4112,제주,46,46,0,13840,2021-12-11 06:15:36.602,null
4638,64,16584,경남,193,193,0,13839,2021-12-11 06:15:36.602,null
4639,120,12647,경북,138,137,1,13838,2021-12-11 06:15:36.602,null
4640,29,4994,전남,75,75,0,13837,2021-12-11 06:15:36.601,null
4641,85,7218,전북,106,106,0,13836,2021-12-11 06:15:36.601,null
4642,94,14662,충남,163,162,1,13835,2021-12-11 06:15:36.601,null
4643,96,9644,충북,81,81,0,13834,2021-12-11 06:15:36.6,null
4644,82,10041,강원,170,170,0,13833,2021-12-11 06:15:36.6,null
4645,1401,152303,경기,2058,2053,5,13832,2021-12-11 06:15:36.6,null
4646,3,1692,세종,7,7,0,13831,2021-12-11 06:15:36.6,null
4647,57,5899,울산,34,34,0,13830,2021-12-11 06:15:36.599,null
4648,85,10026,대전,118,118,0,13829,2021-12-11 06:15:36.599,null
4649,32,6720,광주,25,25,0,13828,2021-12-11 06:15:36.599,null
4650,177,28639,인천,464,461,3,13827,2021-12-11 06:15:36.598,null
4651,333,20260,대구,143,141,2,13826,2021-12-11 06:15:36.598,null
4652,198,18584,부산,319,319,0,13825,2021-12-11 06:15:36.598,null
4653,1328,180031,서울,2835,2824,11,13824,2021-12-11 06:15:36.597,null
4654,4210,510583,합계,6977,6952,25,13823,2021-12-11 06:15:36.597,null
4655,16,6525,검역,8,0,8,13822,2021-12-10 09:05:10.81,null
4656,10,4066,제주,47,47,0,13821,2021-12-10 09:05:10.81,null
4657,64,16391,경남,206,204,2,13820,2021-12-10 09:05:10.81,null
4658,116,12509,경북,183,182,1,13819,2021-12-10 09:05:10.809,null
4659,28,4919,전남,69,69,0,13818,2021-12-10 09:05:10.809,null
4660,85,7112,전북,97,97,0,13817,2021-12-10 09:05:10.809,null
4661,91,14499,충남,160,158,2,13816,2021-12-10 09:05:10.809,null
4662,96,9563,충북,94,94,0,13815,2021-12-10 09:05:10.809,null
4663,81,9871,강원,152,150,2,13814,2021-12-10 09:05:10.808,null
4664,1366,150245,경기,2030,2022,8,13813,2021-12-10 09:05:10.808,null
4665,3,1685,세종,10,10,0,13812,2021-12-10 09:05:10.808,null
4666,57,5865,울산,43,43,0,13811,2021-12-10 09:05:10.808,null
4667,81,9908,대전,157,157,0,13810,2021-12-10 09:05:10.807,null
4668,32,6695,광주,35,35,0,13809,2021-12-10 09:05:10.807,null
4669,176,28175,인천,465,463,2,13808,2021-12-10 09:05:10.807,null
4670,330,20117,대구,163,163,0,13807,2021-12-10 09:05:10.807,null
4671,194,18265,부산,303,303,0,13806,2021-12-10 09:05:10.807,null
4672,1304,177196,서울,2800,2786,14,13805,2021-12-10 09:05:10.806,null
4673,4130,503606,합계,7022,6983,39,13804,2021-12-10 09:05:10.806,null
4674,16,6517,검역,5,0,5,13803,2021-12-09 09:07:15.524,null
4675,10,4019,제주,48,48,0,13802,2021-12-09 09:07:15.524,null
4676,63,16185,경남,193,192,1,13801,2021-12-09 09:07:15.524,null
4677,116,12326,경북,143,143,0,13800,2021-12-09 09:07:15.523,null
4678,28,4850,전남,69,69,0,13799,2021-12-09 09:07:15.523,null
4679,84,7015,전북,125,125,0,13798,2021-12-09 09:07:15.523,null
4680,90,14339,충남,208,208,0,13797,2021-12-09 09:07:15.523,null
4681,96,9469,충북,92,91,1,13796,2021-12-09 09:07:15.523,null
4682,80,9719,강원,139,138,1,13795,2021-12-09 09:07:15.522,null
4683,1350,148215,경기,2141,2136,5,13794,2021-12-09 09:07:15.522,null
4684,3,1675,세종,16,16,0,13793,2021-12-09 09:07:15.522,null
4685,57,5822,울산,49,49,0,13792,2021-12-09 09:07:15.522,null
4686,78,9751,대전,167,166,1,13791,2021-12-09 09:07:15.521,null
4687,32,6660,광주,36,36,0,13790,2021-12-09 09:07:15.521,null
4688,173,27710,인천,497,497,0,13789,2021-12-09 09:07:15.521,null
4689,328,19954,대구,132,131,1,13788,2021-12-09 09:07:15.521,null
4690,193,17962,부산,252,252,0,13787,2021-12-09 09:07:15.52,null
4691,1280,174396,서울,2790,2785,5,13786,2021-12-09 09:07:15.52,null
4692,4077,496584,합계,7102,7082,20,13785,2021-12-09 09:07:15.52,null
4693,16,6513,검역,7,0,7,13784,2021-12-08 08:59:20.343,null
4694,9,3971,제주,51,51,0,13783,2021-12-08 08:59:20.343,null
4695,63,15992,경남,156,155,1,13782,2021-12-08 08:59:20.343,null
4696,115,12183,경북,131,129,2,13781,2021-12-08 08:59:20.342,null
4697,28,4781,전남,54,53,1,13780,2021-12-08 08:59:20.342,null
4698,83,6890,전북,103,103,0,13779,2021-12-08 08:59:20.342,null
4699,87,14132,충남,203,203,0,13778,2021-12-08 08:59:20.342,null
4700,95,9377,충북,61,61,0,13777,2021-12-08 08:59:20.342,null
4701,79,9580,강원,143,141,2,13776,2021-12-08 08:59:20.341,null
4702,1330,146074,경기,2268,2263,5,13775,2021-12-08 08:59:20.341,null
4703,3,1659,세종,16,16,0,13774,2021-12-08 08:59:20.341,null
4704,57,5773,울산,26,25,1,13773,2021-12-08 08:59:20.341,null
4705,75,9584,대전,185,184,1,13772,2021-12-08 08:59:20.34,null
4706,32,6624,광주,57,57,0,13771,2021-12-08 08:59:20.34,null
4707,168,27213,인천,433,431,2,13770,2021-12-08 08:59:20.34,null
4708,326,19822,대구,127,127,0,13769,2021-12-08 08:59:20.34,null
4709,191,17710,부산,253,253,0,13768,2021-12-08 08:59:20.339,null
4710,1263,171606,서울,2901,2890,11,13767,2021-12-08 08:59:20.339,null
4711,4020,489484,합계,7175,7142,33,13766,2021-12-08 08:59:20.339,null
4712,16,6506,검역,5,0,5,13765,2021-12-07 09:03:51.87,null
4713,9,3920,제주,61,60,1,13764,2021-12-07 09:03:51.87,null
4714,63,15836,경남,129,128,1,13763,2021-12-07 09:03:51.87,null
4715,115,12052,경북,129,128,1,13762,2021-12-07 09:03:51.87,null
4716,27,4727,전남,58,56,2,13761,2021-12-07 09:03:51.87,null
4717,80,6787,전북,74,74,0,13760,2021-12-07 09:03:51.869,null
4718,87,13929,충남,135,134,1,13759,2021-12-07 09:03:51.869,null
4719,95,9316,충북,80,80,0,13758,2021-12-07 09:03:51.869,null
4720,78,9437,강원,109,108,1,13757,2021-12-07 09:03:51.869,null
4721,1304,143806,경기,1321,1315,6,13756,2021-12-07 09:03:51.868,null
4722,3,1643,세종,11,10,1,13755,2021-12-07 09:03:51.868,null
4723,57,5747,울산,14,14,0,13754,2021-12-07 09:03:51.868,null
4724,74,9400,대전,121,118,3,13753,2021-12-07 09:03:51.868,null
4725,31,6567,광주,47,47,0,13752,2021-12-07 09:03:51.868,null
4726,166,26780,인천,251,248,3,13751,2021-12-07 09:03:51.867,null
4727,325,19695,대구,129,129,0,13750,2021-12-07 09:03:51.867,null
4728,188,17457,부산,160,160,0,13749,2021-12-07 09:03:51.867,null
4729,1239,168705,서울,2120,2115,5,13748,2021-12-07 09:03:51.867,null
4730,3957,482310,합계,4954,4924,30,13747,2021-12-07 09:03:51.866,null
4731,16,6501,검역,6,0,6,13746,2021-12-06 09:03:08.45,null
4732,9,3859,제주,39,39,0,13745,2021-12-06 09:03:08.449,null
4733,62,15707,경남,121,120,1,13744,2021-12-06 09:03:08.449,null
4734,112,11923,경북,181,180,1,13743,2021-12-06 09:03:08.448,null
4735,27,4669,전남,37,37,0,13742,2021-12-06 09:03:08.448,null
4736,79,6713,전북,73,72,1,13741,2021-12-06 09:03:08.447,null
4737,84,13794,충남,157,155,2,13740,2021-12-06 09:03:08.447,null
4738,95,9236,충북,59,59,0,13739,2021-12-06 09:03:08.446,null
4739,78,9328,강원,112,112,0,13738,2021-12-06 09:03:08.446,null
4740,1279,142485,경기,1314,1308,6,13737,2021-12-06 09:03:08.445,null
4741,3,1632,세종,13,13,0,13736,2021-12-06 09:03:08.445,null
4742,57,5733,울산,15,13,2,13735,2021-12-06 09:03:08.444,null
4743,74,9280,대전,106,106,0,13734,2021-12-06 09:03:08.443,null
4744,31,6520,광주,43,43,0,13733,2021-12-06 09:03:08.443,null
4745,164,26529,인천,302,301,1,13732,2021-12-06 09:03:08.443,null
4746,323,19566,대구,146,145,1,13731,2021-12-06 09:03:08.443,null
4747,186,17297,부산,193,192,1,13730,2021-12-06 09:03:08.442,null
4748,1214,166586,서울,1408,1401,7,13729,2021-12-06 09:03:08.442,null
4749,3893,477358,합계,4325,4296,29,13728,2021-12-06 09:03:08.442,null
4750,16,6495,검역,6,0,6,13727,2021-12-05 08:47:30.294,null
4751,9,3820,제주,17,16,1,13726,2021-12-05 08:47:30.294,null
4752,62,15586,경남,138,136,2,13725,2021-12-05 08:47:30.294,null
4753,111,11742,경북,99,98,1,13724,2021-12-05 08:47:30.293,null
4754,27,4632,전남,47,47,0,13723,2021-12-05 08:47:30.293,null
4755,78,6641,전북,57,56,1,13722,2021-12-05 08:47:30.293,null
4756,84,13637,충남,174,174,0,13721,2021-12-05 08:47:30.293,null
4757,95,9177,충북,82,82,0,13720,2021-12-05 08:47:30.293,null
4758,76,9216,강원,116,116,0,13719,2021-12-05 08:47:30.292,null
4759,1268,141171,경기,1485,1484,1,13718,2021-12-05 08:47:30.292,null
4760,3,1619,세종,16,16,0,13717,2021-12-05 08:47:30.292,null
4761,57,5718,울산,16,16,0,13716,2021-12-05 08:47:30.292,null
4762,73,9174,대전,142,141,1,13715,2021-12-05 08:47:30.291,null
4763,31,6477,광주,40,40,0,13714,2021-12-05 08:47:30.291,null
4764,163,26227,인천,337,336,1,13713,2021-12-05 08:47:30.291,null
4765,322,19420,대구,117,117,0,13712,2021-12-05 08:47:30.291,null
4766,184,17104,부산,207,207,0,13711,2021-12-05 08:47:30.291,null
4767,1193,165178,서울,2032,2022,10,13710,2021-12-05 08:47:30.29,null
4768,3852,473034,합계,5128,5104,24,13709,2021-12-05 08:47:30.29,null
4769,16,6489,검역,4,0,4,13708,2021-12-04 09:17:37.919,null
4770,9,3803,제주,21,21,0,13707,2021-12-04 09:17:37.919,null
4771,58,15449,경남,114,114,0,13706,2021-12-04 09:17:37.918,null
4772,111,11643,경북,90,87,3,13705,2021-12-04 09:17:37.918,null
4773,27,4585,전남,52,51,1,13704,2021-12-04 09:17:37.918,null
4774,78,6584,전북,65,65,0,13703,2021-12-04 09:17:37.918,null
4775,84,13463,충남,133,131,2,13702,2021-12-04 09:17:37.918,null
4776,93,9095,충북,56,56,0,13701,2021-12-04 09:17:37.917,null
4777,75,9100,강원,114,114,0,13700,2021-12-04 09:17:37.917,null
4778,1255,139686,경기,1675,1671,4,13699,2021-12-04 09:17:37.917,null
4779,2,1603,세종,8,8,0,13698,2021-12-04 09:17:37.917,null
4780,57,5702,울산,7,7,0,13697,2021-12-04 09:17:37.917,null
4781,71,9032,대전,126,126,0,13696,2021-12-04 09:17:37.916,null
4782,31,6437,광주,39,38,1,13695,2021-12-04 09:17:37.916,null
4783,161,25890,인천,284,282,2,13694,2021-12-04 09:17:37.916,null
4784,320,19303,대구,90,89,1,13693,2021-12-04 09:17:37.916,null
4785,183,16897,부산,201,201,0,13692,2021-12-04 09:17:37.915,null
4786,1178,163146,서울,2273,2266,7,13691,2021-12-04 09:17:37.915,null
4787,3809,467907,합계,5352,5327,25,13690,2021-12-04 09:17:37.915,null
4788,16,6485,검역,11,0,11,13689,2021-12-03 09:10:27.046,null
4789,9,3782,제주,20,20,0,13688,2021-12-03 09:10:27.046,null
4790,56,15335,경남,99,99,0,13687,2021-12-03 09:10:27.046,null
4791,110,11553,경북,82,82,0,13686,2021-12-03 09:10:27.046,null
4792,27,4533,전남,35,34,1,13685,2021-12-03 09:10:27.046,null
4793,76,6519,전북,66,66,0,13684,2021-12-03 09:10:27.045,null
4794,83,13330,충남,156,155,1,13683,2021-12-03 09:10:27.045,null
4795,92,9039,충북,97,97,0,13682,2021-12-03 09:10:27.045,null
4796,75,8986,강원,98,98,0,13681,2021-12-03 09:10:27.045,null
4797,1231,138011,경기,1465,1464,1,13680,2021-12-03 09:10:27.045,null
4798,2,1595,세종,7,7,0,13679,2021-12-03 09:10:27.044,null
4799,57,5695,울산,20,19,1,13678,2021-12-03 09:10:27.044,null
4800,71,8906,대전,97,97,0,13677,2021-12-03 09:10:27.044,null
4801,30,6398,광주,45,45,0,13676,2021-12-03 09:10:27.044,null
4802,155,25606,인천,307,306,1,13675,2021-12-03 09:10:27.044,null
4803,318,19213,대구,99,99,0,13674,2021-12-03 09:10:27.043,null
4804,183,16696,부산,141,141,0,13673,2021-12-03 09:10:27.043,null
4805,1148,160873,서울,2099,2094,5,13672,2021-12-03 09:10:27.043,null
4806,3739,462555,합계,4944,4923,21,13671,2021-12-03 09:10:27.043,null
4807,16,6474,검역,5,0,5,13651,2021-12-02 09:02:44.572,null
4808,9,3762,제주,31,31,0,13650,2021-12-02 09:02:44.572,null
4809,56,15236,경남,94,94,0,13649,2021-12-02 09:02:44.572,null
4810,110,11471,경북,106,106,0,13648,2021-12-02 09:02:44.572,null
4811,27,4498,전남,39,37,2,13647,2021-12-02 09:02:44.571,null
4812,76,6453,전북,71,71,0,13646,2021-12-02 09:02:44.571,null
4813,80,13174,충남,149,149,0,13645,2021-12-02 09:02:44.571,null
4814,92,8942,충북,49,49,0,13644,2021-12-02 09:02:44.571,null
4815,75,8889,강원,145,142,3,13643,2021-12-02 09:02:44.57,null
4816,1215,136546,경기,1495,1490,5,13642,2021-12-02 09:02:44.57,null
4817,2,1588,세종,8,8,0,13641,2021-12-02 09:02:44.57,null
4818,57,5675,울산,18,18,0,13640,2021-12-02 09:02:44.57,null
4819,70,8809,대전,166,166,0,13639,2021-12-02 09:02:44.57,null
4820,30,6353,광주,39,39,0,13638,2021-12-02 09:02:44.569,null
4821,154,25299,인천,355,354,1,13637,2021-12-02 09:02:44.569,null
4822,317,19114,대구,70,69,1,13636,2021-12-02 09:02:44.569,null
4823,183,16555,부산,158,157,1,13635,2021-12-02 09:02:44.569,null
4824,1136,158774,서울,2268,2262,6,13634,2021-12-02 09:02:44.568,null
4825,3705,457612,합계,5266,5242,24,13633,2021-12-02 09:02:44.568,null
4826,16,6469,검역,20,0,20,13613,2021-12-01 09:01:47.038,null
4827,9,3731,제주,27,27,0,13612,2021-12-01 09:01:47.038,null
4828,56,15142,경남,127,126,1,13611,2021-12-01 09:01:47.038,null
4829,110,11365,경북,97,97,0,13610,2021-12-01 09:01:47.038,null
4830,26,4459,전남,40,40,0,13609,2021-12-01 09:01:47.037,null
4831,76,6382,전북,50,50,0,13608,2021-12-01 09:01:47.037,null
4832,78,13025,충남,96,95,1,13607,2021-12-01 09:01:47.037,null
4833,92,8893,충북,48,48,0,13606,2021-12-01 09:01:47.037,null
4834,74,8745,강원,105,105,0,13605,2021-12-01 09:01:47.037,null
4835,1202,135053,경기,1582,1576,6,13604,2021-12-01 09:01:47.036,null
4836,2,1580,세종,20,19,1,13603,2021-12-01 09:01:47.036,null
4837,57,5657,울산,17,15,2,13602,2021-12-01 09:01:47.036,null
4838,68,8643,대전,88,86,2,13601,2021-12-01 09:01:47.036,null
4839,30,6314,광주,29,29,0,13600,2021-12-01 09:01:47.035,null
4840,151,24944,인천,326,322,4,13599,2021-12-01 09:01:47.037,null
4841,315,19044,대구,86,86,0,13598,2021-12-01 09:01:47.035,null
4842,183,16397,부산,143,142,1,13597,2021-12-01 09:01:47.035,null
4843,1113,156507,서울,2222,2212,10,13596,2021-12-01 09:01:47.035,null
4844,3659,452350,합계,5123,5075,48,13595,2021-12-01 09:01:47.034,null
4845,16,6449,검역,8,0,8,13594,2021-11-30 09:02:53.631,null
4846,9,3704,제주,22,21,1,13593,2021-11-30 09:02:53.63,null
4847,56,15015,경남,60,60,0,13592,2021-11-30 09:02:53.63,null
4848,109,11268,경북,68,68,0,13591,2021-11-30 09:02:53.63,null
4849,26,4419,전남,36,35,1,13590,2021-11-30 09:02:53.63,null
4850,75,6332,전북,50,50,0,13589,2021-11-30 09:02:53.63,null
4851,77,12930,충남,81,81,0,13588,2021-11-30 09:02:53.629,null
4852,92,8845,충북,59,59,0,13587,2021-11-30 09:02:53.629,null
4853,73,8640,강원,84,84,0,13586,2021-11-30 09:02:53.629,null
4854,1192,133472,경기,909,907,2,13585,2021-11-30 09:02:53.629,null
4855,2,1560,세종,22,22,0,13584,2021-11-30 09:02:53.628,null
4856,57,5640,울산,3,3,0,13583,2021-11-30 09:02:53.628,null
4857,64,8555,대전,43,41,2,13582,2021-11-30 09:02:53.628,null
4858,30,6285,광주,52,51,1,13581,2021-11-30 09:02:53.628,null
4859,148,24618,인천,192,191,1,13580,2021-11-30 09:02:53.628,null
4860,315,18958,대구,78,77,1,13579,2021-11-30 09:02:53.627,null
4861,183,16254,부산,79,77,2,13578,2021-11-30 09:02:53.627,null
4862,1100,154286,서울,1186,1176,10,13577,2021-11-30 09:02:53.627,null
4863,3624,447230,합계,3032,3003,29,13576,2021-11-30 09:02:53.627,null
4864,16,6441,검역,3,0,3,13575,2021-11-29 09:08:11.258,null
4865,9,3682,제주,44,43,1,13574,2021-11-29 09:08:11.258,null
4866,56,14955,경남,86,85,1,13573,2021-11-29 09:08:11.258,null
4867,108,11200,경북,68,67,1,13572,2021-11-29 09:08:11.258,null
4868,26,4383,전남,28,28,0,13571,2021-11-29 09:08:11.257,null
4869,74,6282,전북,49,49,0,13570,2021-11-29 09:08:11.257,null
4870,77,12849,충남,53,50,3,13569,2021-11-29 09:08:11.257,null
4871,91,8786,충북,33,33,0,13568,2021-11-29 09:08:11.257,null
4872,72,8556,강원,56,55,1,13567,2021-11-29 09:08:11.256,null
4873,1175,132565,경기,910,905,5,13566,2021-11-29 09:08:11.256,null
4874,2,1538,세종,15,15,0,13565,2021-11-29 09:08:11.256,null
4875,57,5637,울산,2,2,0,13564,2021-11-29 09:08:11.256,null
4876,64,8512,대전,43,43,0,13563,2021-11-29 09:08:11.256,null
4877,30,6233,광주,61,61,0,13562,2021-11-29 09:08:11.255,null
4878,143,24426,인천,233,233,0,13561,2021-11-29 09:08:11.255,null
4879,314,18880,대구,88,87,1,13560,2021-11-29 09:08:11.255,null
4880,182,16175,부산,144,144,0,13559,2021-11-29 09:08:11.255,null
4881,1084,153100,서울,1393,1386,7,13558,2021-11-29 09:08:11.254,null
4882,3580,444200,합계,3309,3286,23,13557,2021-11-29 09:08:11.254,null
4883,16,6438,검역,10,0,10,13556,2021-11-28 08:55:08.758,null
4884,9,3638,제주,35,35,0,13555,2021-11-28 08:55:08.758,null
4885,56,14870,경남,89,88,1,13554,2021-11-28 08:55:08.758,null
4886,106,11132,경북,103,103,0,13553,2021-11-28 08:55:08.758,null
4887,25,4355,전남,25,25,0,13552,2021-11-28 08:55:08.758,null
4888,73,6233,전북,45,44,1,13551,2021-11-28 08:55:08.757,null
4889,77,12796,충남,121,120,1,13550,2021-11-28 08:55:08.757,null
4890,90,8753,충북,25,23,2,13549,2021-11-28 08:55:08.757,null
4891,72,8500,강원,63,61,2,13548,2021-11-28 08:55:08.757,null
4892,1167,131655,경기,1090,1083,7,13547,2021-11-28 08:55:08.756,null
4893,2,1523,세종,5,5,0,13546,2021-11-28 08:55:08.756,null
4894,57,5635,울산,4,4,0,13545,2021-11-28 08:55:08.756,null
4895,63,8469,대전,53,53,0,13544,2021-11-28 08:55:08.756,null
4896,30,6172,광주,52,52,0,13543,2021-11-28 08:55:08.756,null
4897,141,24193,인천,278,276,2,13542,2021-11-28 08:55:08.755,null
4898,311,18792,대구,106,106,0,13541,2021-11-28 08:55:08.755,null
4899,181,16031,부산,148,147,1,13540,2021-11-28 08:55:08.755,null
4900,1072,151711,서울,1676,1668,8,13539,2021-11-28 08:55:08.755,null
4901,3548,440896,합계,3928,3893,35,13538,2021-11-28 08:55:08.754,null
4902,16,6428,검역,5,0,5,13537,2021-11-27 09:36:03.484,null
4903,9,3603,제주,27,27,0,13536,2021-11-27 09:36:03.484,null
4904,52,14781,경남,87,87,0,13535,2021-11-27 09:36:03.484,null
4905,105,11029,경북,96,95,1,13534,2021-11-27 09:36:03.484,null
4906,25,4330,전남,36,36,0,13533,2021-11-27 09:36:03.483,null
4907,73,6188,전북,50,50,0,13532,2021-11-27 09:36:03.483,null
4908,76,12675,충남,78,76,2,13531,2021-11-27 09:36:03.483,null
4909,90,8728,충북,39,38,1,13530,2021-11-27 09:36:03.483,null
4910,72,8437,강원,93,93,0,13529,2021-11-27 09:36:03.483,null
4911,1151,130565,경기,1109,1105,4,13528,2021-11-27 09:36:03.482,null
4912,2,1518,세종,11,11,0,13527,2021-11-27 09:36:03.482,null
4913,57,5631,울산,7,6,1,13526,2021-11-27 09:36:03.482,null
4914,60,8416,대전,38,38,0,13525,2021-11-27 09:36:03.482,null
4915,30,6120,광주,35,35,0,13524,2021-11-27 09:36:03.482,null
4916,139,23915,인천,288,287,1,13523,2021-11-27 09:36:03.481,null
4917,308,18686,대구,76,76,0,13522,2021-11-27 09:36:03.481,null
4918,181,15883,부산,105,104,1,13521,2021-11-27 09:36:03.481,null
4919,1046,150035,서울,1888,1881,7,13520,2021-11-27 09:36:03.481,null
4920,3492,436968,합계,4068,4045,23,13519,2021-11-27 09:36:03.48,null
4921,16,6423,검역,4,0,4,13518,2021-11-26 09:03:24.525,null
4922,9,3576,제주,32,32,0,13517,2021-11-26 09:03:24.524,null
4923,52,14694,경남,86,86,0,13516,2021-11-26 09:03:24.524,null
4924,103,10934,경북,116,116,0,13515,2021-11-26 09:03:24.524,null
4925,25,4294,전남,38,38,0,13514,2021-11-26 09:03:24.524,null
4926,72,6138,전북,46,45,1,13513,2021-11-26 09:03:24.524,null
4927,76,12597,충남,87,87,0,13512,2021-11-26 09:03:24.523,null
4928,90,8689,충북,25,25,0,13511,2021-11-26 09:03:24.523,null
4929,71,8344,강원,53,53,0,13510,2021-11-26 09:03:24.523,null
4930,1131,129456,경기,1120,1115,5,13509,2021-11-26 09:03:24.523,null
4931,2,1507,세종,15,15,0,13508,2021-11-26 09:03:24.522,null
4932,57,5624,울산,13,13,0,13507,2021-11-26 09:03:24.522,null
4933,60,8378,대전,44,44,0,13506,2021-11-26 09:03:24.522,null
4934,30,6085,광주,31,30,1,13505,2021-11-26 09:03:24.521,null
4935,137,23627,인천,248,245,3,13504,2021-11-26 09:03:24.521,null
4936,305,18610,대구,103,103,0,13503,2021-11-26 09:03:24.521,null
4937,179,15778,부산,98,96,2,13502,2021-11-26 09:03:24.521,null
4938,1025,148147,서울,1742,1739,3,13501,2021-11-26 09:03:24.52,null
4939,3440,432901,합계,3901,3882,19,13500,2021-11-26 09:03:24.52,null
4940,16,6419,검역,5,0,5,13499,2021-11-25 09:04:56.335,null
4941,9,3544,제주,29,29,0,13498,2021-11-25 09:04:56.335,null
4942,52,14608,경남,74,72,2,13497,2021-11-25 09:04:56.335,null
4943,102,10818,경북,98,97,1,13496,2021-11-25 09:04:56.335,null
4944,25,4256,전남,42,42,0,13495,2021-11-25 09:04:56.334,null
4945,72,6092,전북,35,35,0,13494,2021-11-25 09:04:56.334,null
4946,76,12511,충남,111,110,1,13493,2021-11-25 09:04:56.334,null
4947,89,8664,충북,39,39,0,13492,2021-11-25 09:04:56.334,null
4948,71,8291,강원,87,86,1,13491,2021-11-25 09:04:56.334,null
4949,1118,128336,경기,1102,1096,6,13490,2021-11-25 09:04:56.333,null
4950,2,1492,세종,20,20,0,13489,2021-11-25 09:04:56.333,null
4951,57,5611,울산,13,13,0,13488,2021-11-25 09:04:56.333,null
4952,59,8334,대전,50,50,0,13487,2021-11-25 09:04:56.333,null
4953,30,6054,광주,35,35,0,13486,2021-11-25 09:04:56.332,null
4954,136,23379,인천,260,259,1,13485,2021-11-25 09:04:56.332,null
4955,304,18507,대구,81,80,1,13484,2021-11-25 09:04:56.332,null
4956,179,15680,부산,97,97,0,13483,2021-11-25 09:04:56.332,null
4957,1004,146406,서울,1760,1757,3,13482,2021-11-25 09:04:56.331,null
4958,3401,429002,합계,3938,3917,21,13481,2021-11-25 09:04:56.331,null
4959,16,6414,검역,7,0,7,13480,2021-11-24 09:02:32.134,null
4960,9,3515,제주,22,22,0,13479,2021-11-24 09:02:32.134,null
4961,50,14534,경남,87,87,0,13478,2021-11-24 09:02:32.134,null
4962,100,10720,경북,65,65,0,13477,2021-11-24 09:02:32.134,null
4963,25,4214,전남,52,52,0,13476,2021-11-24 09:02:32.133,null
4964,72,6057,전북,34,34,0,13475,2021-11-24 09:02:32.133,null
4965,76,12400,충남,291,291,0,13474,2021-11-24 09:02:32.133,null
4966,89,8625,충북,40,40,0,13473,2021-11-24 09:02:32.133,null
4967,71,8204,강원,65,62,3,13472,2021-11-24 09:02:32.133,null
4968,1101,127234,경기,1184,1176,8,13471,2021-11-24 09:02:32.132,null
4969,2,1472,세종,7,7,0,13470,2021-11-24 09:02:32.132,null
4970,57,5598,울산,11,11,0,13469,2021-11-24 09:02:32.132,null
4971,58,8284,대전,51,51,0,13468,2021-11-24 09:02:32.132,null
4972,30,6019,광주,46,45,1,13467,2021-11-24 09:02:32.132,null
4973,132,23119,인천,221,219,2,13466,2021-11-24 09:02:32.131,null
4974,303,18426,대구,78,78,0,13465,2021-11-24 09:02:32.131,null
4975,178,15583,부산,120,118,2,13464,2021-11-24 09:02:32.131,null
4976,993,144646,서울,1734,1729,5,13463,2021-11-24 09:02:32.131,2021-11-24 13:29:40.336
4977,3362,425064,합계,4115,4087,28,13462,2021-11-24 09:02:32.13,2021-11-24 13:30:11.829
4978,16,6407,검역,1,0,1,13461,2021-11-23 08:57:17.931,null
4979,9,3493,제주,29,29,0,13460,2021-11-23 08:57:17.931,null
4980,50,14447,경남,80,80,0,13459,2021-11-23 08:57:17.931,null
4981,100,10655,경북,51,51,0,13458,2021-11-23 08:57:17.931,null
4982,25,4162,전남,20,20,0,13457,2021-11-23 08:57:17.93,null
4983,71,6023,전북,42,40,2,13456,2021-11-23 08:57:17.93,null
4984,76,12109,충남,77,77,0,13455,2021-11-23 08:57:17.93,null
4985,89,8585,충북,20,20,0,13454,2021-11-23 08:57:17.93,null
4986,71,8139,강원,66,66,0,13453,2021-11-23 08:57:17.929,null
4987,1091,126050,경기,773,769,4,13452,2021-11-23 08:57:17.929,null
4988,2,1465,세종,8,8,0,13451,2021-11-23 08:57:17.929,null
4989,57,5587,울산,7,7,0,13450,2021-11-23 08:57:17.929,null
4990,57,8233,대전,68,68,0,13449,2021-11-23 08:57:17.928,null
4991,30,5973,광주,55,55,0,13448,2021-11-23 08:57:17.928,null
4992,131,22898,인천,131,129,2,13447,2021-11-23 08:57:17.928,null
4993,302,18348,대구,50,50,0,13446,2021-11-23 08:57:17.928,null
4994,178,15463,부산,56,56,0,13445,2021-11-23 08:57:17.927,null
4995,973,142913,서울,1165,1160,5,13444,2021-11-23 08:57:17.927,null
4996,3328,420950,합계,2699,2685,14,13443,2021-11-23 08:57:17.927,null
4997,16,6406,검역,7,0,7,13442,2021-11-22 09:03:29.196,null
4998,9,3464,제주,17,17,0,13441,2021-11-22 09:03:29.195,null
4999,48,14367,경남,65,63,2,13440,2021-11-22 09:03:29.195,null
5000,100,10604,경북,39,39,0,13439,2021-11-22 09:03:29.195,null
5001,25,4142,전남,27,25,2,13438,2021-11-22 09:03:29.195,null
5002,70,5981,전북,34,34,0,13437,2021-11-22 09:03:29.194,null
5003,75,12032,충남,47,47,0,13436,2021-11-22 09:03:29.194,null
5004,89,8565,충북,26,26,0,13435,2021-11-22 09:03:29.194,null
5005,70,8073,강원,55,55,0,13434,2021-11-22 09:03:29.193,null
5006,1082,125278,경기,820,817,3,13433,2021-11-22 09:03:29.193,null
5007,2,1457,세종,5,5,0,13432,2021-11-22 09:03:29.193,null
5008,57,5580,울산,10,10,0,13431,2021-11-22 09:03:29.193,null
5009,56,8165,대전,36,36,0,13430,2021-11-22 09:03:29.192,null
5010,30,5918,광주,57,57,0,13429,2021-11-22 09:03:29.192,null
5011,129,22767,인천,161,159,2,13428,2021-11-22 09:03:29.192,null
5012,302,18298,대구,53,53,0,13427,2021-11-22 09:03:29.192,null
5013,178,15407,부산,90,89,1,13426,2021-11-22 09:03:29.191,null
5014,960,141748,서울,1278,1274,4,13425,2021-11-22 09:03:29.191,null
5015,3298,418252,합계,2827,2806,21,13424,2021-11-22 09:03:29.191,null
5016,16,6399,검역,5,0,5,13423,2021-11-21 09:06:03.3,null
5017,9,3447,제주,15,15,0,13422,2021-11-21 09:06:03.3,null
5018,47,14302,경남,76,76,0,13421,2021-11-21 09:06:03.3,null
5019,100,10565,경북,26,25,1,13420,2021-11-21 09:06:03.3,null
5020,25,4115,전남,38,37,1,13419,2021-11-21 09:06:03.3,null
5021,70,5947,전북,41,40,1,13418,2021-11-21 09:06:03.299,null
5022,75,11985,충남,47,47,0,13417,2021-11-21 09:06:03.299,null
5023,89,8539,충북,20,20,0,13416,2021-11-21 09:06:03.299,null
5024,69,8018,강원,75,75,0,13415,2021-11-21 09:06:03.299,null
5025,1072,124458,경기,992,988,4,13414,2021-11-21 09:06:03.299,null
5026,2,1452,세종,7,7,0,13413,2021-11-21 09:06:03.298,null
5027,57,5570,울산,9,9,0,13412,2021-11-21 09:06:03.298,null
5028,56,8129,대전,43,43,0,13411,2021-11-21 09:06:03.298,null
5029,30,5861,광주,70,70,0,13410,2021-11-21 09:06:03.298,null
5030,127,22606,인천,206,203,3,13409,2021-11-21 09:06:03.297,null
5031,300,18245,대구,44,42,2,13408,2021-11-21 09:06:03.297,null
5032,178,15317,부산,86,86,0,13407,2021-11-21 09:06:03.297,null
5033,952,140470,서울,1320,1315,5,13406,2021-11-21 09:06:03.297,null
5034,3274,415425,합계,3120,3098,22,13405,2021-11-21 09:06:03.296,null
5035,16,6394,검역,6,0,6,13404,2021-11-20 08:51:46.4,null
5036,9,3432,제주,23,23,0,13403,2021-11-20 08:51:46.4,null
5037,47,14226,경남,79,79,0,13402,2021-11-20 08:51:46.4,null
5038,100,10539,경북,35,35,0,13401,2021-11-20 08:51:46.4,null
5039,25,4077,전남,66,66,0,13400,2021-11-20 08:51:46.399,null
5040,70,5908,전북,32,32,0,13399,2021-11-20 08:51:46.399,null
5041,74,11938,충남,74,73,1,13398,2021-11-20 08:51:46.399,null
5042,89,8519,충북,34,34,0,13397,2021-11-20 08:51:46.399,null
5043,69,7943,강원,59,59,0,13396,2021-11-20 08:51:46.399,null
5044,1061,123466,경기,993,988,5,13395,2021-11-20 08:51:46.398,null
5045,2,1445,세종,7,7,0,13394,2021-11-20 08:51:46.398,null
5046,57,5561,울산,5,5,0,13393,2021-11-20 08:51:46.398,null
5047,56,8086,대전,32,32,0,13392,2021-11-20 08:51:46.398,null
5048,29,5791,광주,39,39,0,13391,2021-11-20 08:51:46.398,null
5049,126,22400,인천,204,204,0,13390,2021-11-20 08:51:46.397,null
5050,296,18201,대구,61,61,0,13389,2021-11-20 08:51:46.397,null
5051,177,15231,부산,86,85,1,13388,2021-11-20 08:51:46.397,null
5052,941,139154,서울,1377,1372,5,13387,2021-11-20 08:51:46.397,null
5053,3244,412311,합계,3212,3194,18,13386,2021-11-20 08:51:46.396,null
5054,16,6388,검역,12,0,12,13385,2021-11-19 08:55:12.68,null
5055,9,3409,제주,31,31,0,13384,2021-11-19 08:55:12.68,null
5056,47,14147,경남,78,78,0,13383,2021-11-19 08:55:12.68,null
5057,100,10504,경북,49,49,0,13382,2021-11-19 08:55:12.68,null
5058,25,4011,전남,46,46,0,13381,2021-11-19 08:55:12.68,null
5059,70,5876,전북,24,24,0,13380,2021-11-19 08:55:12.679,null
5060,73,11864,충남,56,56,0,13379,2021-11-19 08:55:12.679,null
5061,88,8485,충북,20,20,0,13378,2021-11-19 08:55:12.679,null
5062,68,7884,강원,72,72,0,13377,2021-11-19 08:55:12.679,null
5063,1054,122473,경기,849,844,5,13376,2021-11-19 08:55:12.678,null
5064,2,1438,세종,3,3,0,13375,2021-11-19 08:55:12.678,null
5065,57,5556,울산,4,4,0,13374,2021-11-19 08:55:12.678,null
5066,56,8054,대전,53,53,0,13373,2021-11-19 08:55:12.678,null
5067,29,5752,광주,24,24,0,13372,2021-11-19 08:55:12.678,null
5068,125,22196,인천,188,187,1,13371,2021-11-19 08:55:12.677,null
5069,295,18140,대구,47,47,0,13370,2021-11-19 08:55:12.677,null
5070,175,15145,부산,77,76,1,13369,2021-11-19 08:55:12.677,null
5071,926,137777,서울,1401,1397,4,13368,2021-11-19 08:55:12.677,null
5072,3215,409099,합계,3034,3011,23,13367,2021-11-19 08:55:12.676,null
5073,16,6376,검역,7,0,7,13366,2021-11-18 08:33:17.725,null
5074,9,3378,제주,28,28,0,13365,2021-11-18 08:33:17.725,null
5075,46,14069,경남,98,98,0,13364,2021-11-18 08:33:17.725,null
5076,99,10455,경북,51,50,1,13363,2021-11-18 08:33:17.725,null
5077,25,3965,전남,40,40,0,13362,2021-11-18 08:33:17.725,null
5078,70,5852,전북,54,54,0,13361,2021-11-18 08:33:17.724,null
5079,72,11808,충남,82,80,2,13360,2021-11-18 08:33:17.724,null
5080,88,8465,충북,26,26,0,13359,2021-11-18 08:33:17.724,null
5081,68,7812,강원,62,61,1,13358,2021-11-18 08:33:17.724,null
5082,1047,121624,경기,967,965,2,13357,2021-11-18 08:33:17.723,null
5083,2,1435,세종,10,10,0,13356,2021-11-18 08:33:17.723,null
5084,57,5552,울산,10,9,1,13355,2021-11-18 08:33:17.723,null
5085,56,8001,대전,36,36,0,13354,2021-11-18 08:33:17.723,null
5086,29,5728,광주,34,34,0,13353,2021-11-18 08:33:17.723,null
5087,123,22008,인천,195,195,0,13352,2021-11-18 08:33:17.722,null
5088,293,18093,대구,73,73,0,13351,2021-11-18 08:33:17.722,null
5089,175,15068,부산,90,90,0,13350,2021-11-18 08:33:17.722,null
5090,912,136376,서울,1429,1423,6,13349,2021-11-18 08:33:17.722,null
5091,3187,406065,합계,3292,3272,20,13348,2021-11-18 08:33:17.722,null
5092,16,6369,검역,5,0,5,13347,2021-11-17 08:45:32.279,null
5093,8,3350,제주,23,23,0,13346,2021-11-17 08:45:32.278,null
5094,46,13971,경남,66,66,0,13345,2021-11-17 08:45:32.278,null
5095,98,10404,경북,26,26,0,13344,2021-11-17 08:45:32.278,null
5096,25,3925,전남,36,36,0,13343,2021-11-17 08:45:32.278,null
5097,70,5798,전북,50,50,0,13342,2021-11-17 08:45:32.278,null
5098,68,11726,충남,71,70,1,13341,2021-11-17 08:45:32.277,null
5099,88,8439,충북,28,28,0,13340,2021-11-17 08:45:32.277,null
5100,68,7750,강원,54,53,1,13339,2021-11-17 08:45:32.277,null
5101,1043,120658,경기,964,956,8,13338,2021-11-17 08:45:32.277,null
5102,2,1425,세종,16,16,0,13337,2021-11-17 08:45:32.276,null
5103,57,5542,울산,14,14,0,13336,2021-11-17 08:45:32.276,null
5104,56,7965,대전,46,46,0,13335,2021-11-17 08:45:32.276,null
5105,29,5694,광주,34,33,1,13334,2021-11-17 08:45:32.276,null
5106,121,21813,인천,159,157,2,13333,2021-11-17 08:45:32.275,null
5107,291,18020,대구,56,54,2,13332,2021-11-17 08:45:32.275,null
5108,174,14978,부산,103,103,0,13331,2021-11-17 08:45:32.275,null
5109,898,134948,서울,1436,1432,4,13330,2021-11-17 08:45:32.275,null
5110,3158,402775,합계,3187,3163,24,13329,2021-11-17 08:45:32.274,null
5111,16,6364,검역,1,0,1,13328,2021-11-16 08:46:07.652,null
5112,7,3327,제주,43,43,0,13327,2021-11-16 08:46:07.652,null
5113,46,13905,경남,45,45,0,13326,2021-11-16 08:46:07.652,null
5114,98,10378,경북,9,9,0,13325,2021-11-16 08:46:07.652,null
5115,25,3889,전남,29,29,0,13324,2021-11-16 08:46:07.651,null
5116,69,5748,전북,56,55,1,13323,2021-11-16 08:46:07.651,null
5117,68,11655,충남,42,42,0,13322,2021-11-16 08:46:07.651,null
5118,88,8411,충북,28,28,0,13321,2021-11-16 08:46:07.651,null
5119,68,7696,강원,51,51,0,13320,2021-11-16 08:46:07.65,null
5120,1036,119695,경기,658,653,5,13319,2021-11-16 08:46:07.65,null
5121,2,1409,세종,6,6,0,13318,2021-11-16 08:46:07.65,null
5122,57,5528,울산,9,9,0,13317,2021-11-16 08:46:07.65,null
5123,56,7920,대전,35,35,0,13316,2021-11-16 08:46:07.65,null
5124,29,5660,광주,11,11,0,13315,2021-11-16 08:46:07.649,null
5125,120,21654,인천,131,131,0,13314,2021-11-16 08:46:07.649,null
5126,290,17964,대구,38,38,0,13313,2021-11-16 08:46:07.649,null
5127,172,14875,부산,87,86,1,13312,2021-11-16 08:46:07.649,null
5128,890,133513,서울,846,839,7,13311,2021-11-16 08:46:07.648,null
5129,3137,399591,합계,2125,2110,15,13310,2021-11-16 08:46:07.648,null
5130,16,6363,검역,5,0,5,13309,2021-11-15 09:43:21.875,null
5131,7,3284,제주,10,10,0,13308,2021-11-15 09:43:21.875,null
5132,45,13860,경남,46,44,2,13307,2021-11-15 09:43:21.875,null
5133,98,10369,경북,34,34,0,13306,2021-11-15 09:43:21.874,null
5134,24,3860,전남,19,19,0,13305,2021-11-15 09:43:21.874,null
5135,69,5692,전북,38,38,0,13304,2021-11-15 09:43:21.874,null
5136,68,11613,충남,57,57,0,13303,2021-11-15 09:43:21.874,null
5137,87,8383,충북,18,18,0,13302,2021-11-15 09:43:21.873,null
5138,68,7645,강원,35,35,0,13301,2021-11-15 09:43:21.873,null
5139,1030,119036,경기,602,596,6,13300,2021-11-15 09:43:21.873,null
5140,2,1403,세종,1,1,0,13299,2021-11-15 09:43:21.873,null
5141,57,5519,울산,4,3,1,13298,2021-11-15 09:43:21.873,null
5142,56,7885,대전,33,33,0,13297,2021-11-15 09:43:21.872,null
5143,29,5649,광주,26,25,1,13296,2021-11-15 09:43:21.872,null
5144,119,21523,인천,102,102,0,13295,2021-11-15 09:43:21.872,null
5145,290,17926,대구,49,48,1,13294,2021-11-15 09:43:21.872,null
5146,171,14788,부산,68,67,1,13293,2021-11-15 09:43:21.871,null
5147,879,132668,서울,859,856,3,13292,2021-11-15 09:43:21.871,null
5148,3115,397466,합계,2006,1986,20,13291,2021-11-15 09:43:21.871,null
5149,16,6358,검역,3,0,3,13290,2021-11-14 09:40:13.21,null
5150,7,3274,제주,14,14,0,13289,2021-11-14 09:40:13.21,null
5151,45,13814,경남,44,44,0,13288,2021-11-14 09:40:13.21,null
5152,98,10335,경북,42,41,1,13287,2021-11-14 09:40:13.209,null
5153,24,3841,전남,26,26,0,13286,2021-11-14 09:40:13.209,null
5154,69,5654,전북,44,44,0,13285,2021-11-14 09:40:13.209,null
5155,68,11556,충남,54,53,1,13284,2021-11-14 09:40:13.209,null
5156,87,8365,충북,27,27,0,13283,2021-11-14 09:40:13.209,null
5157,68,7610,강원,31,31,0,13282,2021-11-14 09:40:13.208,null
5158,1023,118434,경기,800,797,3,13281,2021-11-14 09:40:13.208,null
5159,2,1402,세종,2,2,0,13280,2021-11-14 09:40:13.208,null
5160,57,5515,울산,7,7,0,13279,2021-11-14 09:40:13.208,null
5161,56,7852,대전,18,18,0,13278,2021-11-14 09:40:13.207,null
5162,29,5623,광주,19,19,0,13277,2021-11-14 09:40:13.207,null
5163,118,21421,인천,156,155,1,13276,2021-11-14 09:40:13.207,null
5164,289,17877,대구,72,72,0,13275,2021-11-14 09:40:13.207,null
5165,171,14720,부산,82,82,0,13274,2021-11-14 09:40:13.207,null
5166,876,131809,서울,978,969,9,13273,2021-11-14 09:40:13.206,null
5167,3103,395460,합계,2419,2401,18,13272,2021-11-14 09:40:13.206,null
5168,16,6355,검역,4,0,4,13271,2021-11-13 09:34:07.842,null
5169,5,3260,제주,15,15,0,13270,2021-11-13 09:34:07.842,null
5170,44,13770,경남,41,41,0,13269,2021-11-13 09:34:07.842,null
5171,97,10293,경북,35,35,0,13268,2021-11-13 09:34:07.842,null
5172,24,3815,전남,19,19,0,13267,2021-11-13 09:34:07.842,null
5173,69,5611,전북,59,59,0,13266,2021-11-13 09:34:07.841,null
5174,68,11502,충남,77,76,1,13265,2021-11-13 09:34:07.841,null
5175,87,8338,충북,23,23,0,13264,2021-11-13 09:34:07.841,null
5176,68,7579,강원,31,31,0,13263,2021-11-13 09:34:07.841,null
5177,1018,117634,경기,648,644,4,13262,2021-11-13 09:34:07.84,null
5178,2,1400,세종,1,1,0,13261,2021-11-13 09:34:07.84,null
5179,57,5508,울산,1,1,0,13260,2021-11-13 09:34:07.84,null
5180,56,7834,대전,32,32,0,13259,2021-11-13 09:34:07.84,null
5181,29,5604,광주,31,31,0,13258,2021-11-13 09:34:07.839,null
5182,118,21265,인천,166,165,1,13257,2021-11-13 09:34:07.839,null
5183,285,17805,대구,73,73,0,13256,2021-11-13 09:34:07.839,null
5184,171,14638,부산,64,64,0,13255,2021-11-13 09:34:07.839,null
5185,869,130831,서울,1005,1001,4,13254,2021-11-13 09:34:07.838,null
5186,3083,393042,합계,2325,2311,14,13253,2021-11-13 09:34:07.838,null
5187,16,6351,검역,4,0,4,13252,2021-11-12 09:27:26.293,null
5188,5,3245,제주,21,21,0,13251,2021-11-12 09:27:26.293,null
5189,44,13729,경남,68,68,0,13250,2021-11-12 09:27:26.293,null
5190,96,10258,경북,41,41,0,13249,2021-11-12 09:27:26.292,null
5191,22,3796,전남,15,15,0,13248,2021-11-12 09:27:26.292,null
5192,69,5553,전북,65,65,0,13247,2021-11-12 09:27:26.292,null
5193,68,11425,충남,59,59,0,13246,2021-11-12 09:27:26.292,null
5194,87,8315,충북,26,26,0,13245,2021-11-12 09:27:26.291,null
5195,68,7548,강원,30,30,0,13244,2021-11-12 09:27:26.291,null
5196,1003,116986,경기,791,790,1,13243,2021-11-12 09:27:26.291,null
5197,2,1399,세종,6,6,0,13242,2021-11-12 09:27:26.291,null
5198,57,5507,울산,4,4,0,13241,2021-11-12 09:27:26.291,null
5199,56,7802,대전,25,25,0,13240,2021-11-12 09:27:26.29,null
5200,29,5573,광주,11,11,0,13239,2021-11-12 09:27:26.29,null
5201,114,21099,인천,120,120,0,13238,2021-11-12 09:27:26.29,null
5202,284,17732,대구,70,70,0,13237,2021-11-12 09:27:26.29,null
5203,170,14574,부산,63,63,0,13236,2021-11-12 09:27:26.289,null
5204,861,129827,서울,949,944,5,13235,2021-11-12 09:27:26.289,null
5205,3051,390719,합계,2368,2358,10,13234,2021-11-12 09:27:26.289,null
5206,16,6347,검역,13,0,13,13233,2021-11-11 09:27:31.882,null
5207,5,3224,제주,14,14,0,13232,2021-11-11 09:27:31.882,null
5208,44,13661,경남,76,76,0,13231,2021-11-11 09:27:31.881,null
5209,96,10217,경북,33,33,0,13230,2021-11-11 09:27:31.881,null
5210,22,3781,전남,17,17,0,13229,2021-11-11 09:27:31.881,null
5211,69,5488,전북,39,39,0,13228,2021-11-11 09:27:31.881,null
5212,66,11366,충남,50,50,0,13227,2021-11-11 09:27:31.881,null
5213,87,8289,충북,34,34,0,13226,2021-11-11 09:27:31.88,null
5214,68,7518,강원,29,28,1,13225,2021-11-11 09:27:31.88,null
5215,996,116195,경기,821,816,5,13224,2021-11-11 09:27:31.88,null
5216,2,1393,세종,6,6,0,13223,2021-11-11 09:27:31.88,null
5217,57,5503,울산,20,20,0,13222,2021-11-11 09:27:31.88,null
5218,56,7777,대전,34,34,0,13221,2021-11-11 09:27:31.879,null
5219,29,5562,광주,32,32,0,13220,2021-11-11 09:27:31.879,null
5220,113,20979,인천,187,186,1,13219,2021-11-11 09:27:31.879,null
5221,283,17662,대구,42,42,0,13218,2021-11-11 09:27:31.879,null
5222,169,14511,부산,69,68,1,13217,2021-11-11 09:27:31.878,null
5223,855,128878,서울,1004,999,5,13216,2021-11-11 09:27:31.878,null
5224,3033,388351,합계,2520,2494,26,13215,2021-11-11 09:27:31.878,null
5225,16,6334,검역,3,0,3,13214,2021-11-10 09:28:47.491,null
5226,5,3210,제주,11,11,0,13213,2021-11-10 09:28:47.491,null
5227,44,13585,경남,60,60,0,13212,2021-11-10 09:28:47.491,null
5228,95,10184,경북,36,36,0,13211,2021-11-10 09:28:47.491,null
5229,22,3764,전남,7,7,0,13210,2021-11-10 09:28:47.49,null
5230,69,5449,전북,36,35,1,13209,2021-11-10 09:28:47.49,null
5231,66,11316,충남,58,57,1,13208,2021-11-10 09:28:47.49,null
5232,87,8255,충북,31,31,0,13207,2021-11-10 09:28:47.49,null
5233,68,7489,강원,23,23,0,13206,2021-11-10 09:28:47.49,null
5234,989,115374,경기,867,863,4,13205,2021-11-10 09:28:47.489,null
5235,2,1387,세종,4,4,0,13204,2021-11-10 09:28:47.489,null
5236,57,5483,울산,5,5,0,13203,2021-11-10 09:28:47.489,null
5237,56,7743,대전,23,23,0,13202,2021-11-10 09:28:47.489,null
5238,29,5530,광주,22,22,0,13201,2021-11-10 09:28:47.488,null
5239,113,20792,인천,159,159,0,13200,2021-11-10 09:28:47.488,null
5240,281,17620,대구,33,33,0,13199,2021-11-10 09:28:47.488,null
5241,169,14442,부산,74,73,1,13198,2021-11-10 09:28:47.487,null
5242,844,127874,서울,973,967,6,13197,2021-11-10 09:28:47.487,null
5243,3012,385831,합계,2425,2409,16,13196,2021-11-10 09:28:47.487,null
5244,16,6331,검역,5,0,5,13195,2021-11-09 09:24:31.121,null
5245,5,3199,제주,20,20,0,13194,2021-11-09 09:24:31.121,null
5246,44,13525,경남,77,76,1,13193,2021-11-09 09:24:31.121,null
5247,95,10148,경북,48,48,0,13192,2021-11-09 09:24:31.121,null
5248,22,3757,전남,21,21,0,13191,2021-11-09 09:24:31.12,null
5249,69,5413,전북,12,11,1,13190,2021-11-09 09:24:31.12,null
5250,66,11258,충남,60,60,0,13189,2021-11-09 09:24:31.12,null
5251,86,8224,충북,17,17,0,13188,2021-11-09 09:24:31.12,null
5252,68,7466,강원,21,21,0,13187,2021-11-09 09:24:31.12,null
5253,982,114508,경기,528,524,4,13186,2021-11-09 09:24:31.119,null
5254,2,1383,세종,3,3,0,13185,2021-11-09 09:24:31.119,null
5255,56,5478,울산,4,4,0,13184,2021-11-09 09:24:31.119,null
5256,56,7720,대전,25,24,1,13183,2021-11-09 09:24:31.119,null
5257,29,5508,광주,11,11,0,13182,2021-11-09 09:24:31.119,null
5258,112,20633,인천,111,110,1,13181,2021-11-09 09:24:31.119,null
5259,281,17587,대구,44,43,1,13180,2021-11-09 09:24:31.119,null
5260,169,14368,부산,46,46,0,13179,2021-11-09 09:24:31.118,null
5261,840,126901,서울,662,659,3,13178,2021-11-09 09:24:31.118,null
5262,2998,383407,합계,1715,1698,17,13177,2021-11-09 09:24:31.118,null
5263,16,6326,검역,4,0,4,13176,2021-11-08 09:29:46.818,null
5264,4,3179,제주,16,16,0,13175,2021-11-08 09:29:46.818,null
5265,44,13448,경남,40,39,1,13174,2021-11-08 09:29:46.818,null
5266,95,10100,경북,60,57,3,13173,2021-11-08 09:29:46.817,null
5267,22,3736,전남,17,17,0,13172,2021-11-08 09:29:46.817,null
5268,69,5401,전북,21,21,0,13171,2021-11-08 09:29:46.817,null
5269,65,11198,충남,62,62,0,13170,2021-11-08 09:29:46.817,null
5270,85,8207,충북,35,33,2,13169,2021-11-08 09:29:46.817,null
5271,68,7445,강원,30,30,0,13168,2021-11-08 09:29:46.817,null
5272,976,113980,경기,544,538,6,13167,2021-11-08 09:29:46.816,null
5273,2,1380,세종,1,1,0,13166,2021-11-08 09:29:46.816,null
5274,56,5474,울산,5,5,0,13165,2021-11-08 09:29:46.816,null
5275,55,7695,대전,22,22,0,13164,2021-11-08 09:29:46.816,null
5276,29,5497,광주,28,28,0,13163,2021-11-08 09:29:46.816,null
5277,112,20522,인천,98,97,1,13162,2021-11-08 09:29:46.816,null
5278,280,17543,대구,34,34,0,13161,2021-11-08 09:29:46.815,null
5279,169,14322,부산,34,33,1,13160,2021-11-08 09:29:46.815,null
5280,833,126241,서울,709,700,9,13159,2021-11-08 09:29:46.815,null
5281,2980,381694,합계,1760,1733,27,13158,2021-11-08 09:29:46.815,null
5282,16,6322,검역,2,0,2,13157,2021-11-07 09:29:23.84,null
5283,4,3163,제주,14,14,0,13156,2021-11-07 09:29:23.84,null
5284,44,13408,경남,46,44,2,13155,2021-11-07 09:29:23.84,null
5285,95,10040,경북,94,94,0,13154,2021-11-07 09:29:23.84,null
5286,22,3719,전남,31,31,0,13153,2021-11-07 09:29:23.839,null
5287,69,5380,전북,22,22,0,13152,2021-11-07 09:29:23.839,null
5288,65,11136,충남,66,66,0,13151,2021-11-07 09:29:23.839,null
5289,85,8172,충북,54,53,1,13150,2021-11-07 09:29:23.839,null
5290,67,7415,강원,42,41,1,13149,2021-11-07 09:29:23.839,null
5291,971,113436,경기,703,699,4,13148,2021-11-07 09:29:23.839,null
5292,2,1379,세종,2,2,0,13147,2021-11-07 09:29:23.839,null
5293,56,5469,울산,1,1,0,13146,2021-11-07 09:29:23.838,null
5294,55,7673,대전,23,23,0,13145,2021-11-07 09:29:23.838,null
5295,29,5469,광주,20,19,1,13144,2021-11-07 09:29:23.838,null
5296,111,20424,인천,161,158,3,13143,2021-11-07 09:29:23.838,null
5297,280,17509,대구,55,55,0,13142,2021-11-07 09:29:23.838,null
5298,168,14288,부산,40,40,0,13141,2021-11-07 09:29:23.838,null
5299,828,125533,서울,848,842,6,13140,2021-11-07 09:29:23.838,null
5300,2967,379935,합계,2224,2204,20,13139,2021-11-07 09:29:23.837,null
5301,16,6320,검역,8,0,8,13138,2021-11-06 09:53:06.903,null
5302,4,3149,제주,4,4,0,13137,2021-11-06 09:53:06.902,null
5303,44,13362,경남,73,73,0,13136,2021-11-06 09:53:06.902,null
5304,95,9946,경북,35,33,2,13135,2021-11-06 09:53:06.902,null
5305,22,3688,전남,40,40,0,13134,2021-11-06 09:53:06.902,null
5306,69,5358,전북,35,35,0,13133,2021-11-06 09:53:06.902,null
5307,65,11070,충남,65,62,3,13132,2021-11-06 09:53:06.902,null
5308,85,8118,충북,43,43,0,13131,2021-11-06 09:53:06.902,null
5309,67,7373,강원,42,42,0,13130,2021-11-06 09:53:06.901,null
5310,968,112733,경기,693,687,6,13129,2021-11-06 09:53:06.901,null
5311,2,1377,세종,2,1,1,13128,2021-11-06 09:53:06.901,null
5312,56,5468,울산,12,12,0,13127,2021-11-06 09:53:06.901,null
5313,55,7650,대전,21,21,0,13126,2021-11-06 09:53:06.901,null
5314,29,5449,광주,18,16,2,13125,2021-11-06 09:53:06.901,null
5315,111,20264,인천,144,142,2,13124,2021-11-06 09:53:06.9,null
5316,278,17454,대구,38,38,0,13123,2021-11-06 09:53:06.9,null
5317,168,14248,부산,59,58,1,13122,2021-11-06 09:53:06.9,null
5318,822,124685,서울,916,912,4,13121,2021-11-06 09:53:06.9,null
5319,2956,377712,합계,2248,2219,29,13120,2021-11-06 09:53:06.9,null
5320,16,6312,검역,5,0,5,13119,2021-11-05 09:28:22.121,null
5321,3,3145,제주,7,6,1,13118,2021-11-05 09:28:22.121,null
5322,44,13289,경남,33,33,0,13117,2021-11-05 09:28:22.121,null
5323,95,9911,경북,84,84,0,13116,2021-11-05 09:28:22.12,null
5324,22,3648,전남,15,15,0,13115,2021-11-05 09:28:22.12,null
5325,67,5323,전북,16,16,0,13114,2021-11-05 09:28:22.12,null
5326,64,11005,충남,110,106,4,13113,2021-11-05 09:28:22.12,null
5327,85,8075,충북,35,35,0,13112,2021-11-05 09:28:22.12,null
5328,67,7331,강원,22,22,0,13111,2021-11-05 09:28:22.12,null
5329,961,112040,경기,742,740,2,13110,2021-11-05 09:28:22.119,null
5330,2,1375,세종,2,2,0,13109,2021-11-05 09:28:22.119,null
5331,56,5456,울산,5,5,0,13108,2021-11-05 09:28:22.119,null
5332,55,7629,대전,24,24,0,13107,2021-11-05 09:28:22.119,null
5333,29,5431,광주,12,11,1,13106,2021-11-05 09:28:22.119,null
5334,110,20120,인천,153,152,1,13105,2021-11-05 09:28:22.119,null
5335,275,17416,대구,43,43,0,13104,2021-11-05 09:28:22.118,null
5336,167,14189,부산,56,56,0,13103,2021-11-05 09:28:22.118,null
5337,818,123769,서울,980,974,6,13102,2021-11-05 09:28:22.118,null
5338,2936,375464,합계,2344,2324,20,13101,2021-11-05 09:28:22.118,null
5339,16,6307,검역,11,0,11,13100,2021-11-04 09:28:21.585,null
5340,3,3138,제주,17,16,1,13099,2021-11-04 09:28:21.585,null
5341,43,13256,경남,36,36,0,13098,2021-11-04 09:28:21.585,null
5342,95,9827,경북,39,38,1,13097,2021-11-04 09:28:21.585,null
5343,22,3633,전남,17,17,0,13096,2021-11-04 09:28:21.585,null
5344,66,5307,전북,38,38,0,13095,2021-11-04 09:28:21.585,null
5345,62,10895,충남,88,88,0,13094,2021-11-04 09:28:21.584,null
5346,85,8040,충북,47,47,0,13093,2021-11-04 09:28:21.584,null
5347,67,7309,강원,39,39,0,13092,2021-11-04 09:28:21.584,null
5348,954,111298,경기,873,868,5,13091,2021-11-04 09:28:21.584,null
5349,2,1373,세종,0,0,0,13090,2021-11-04 09:28:21.584,null
5350,56,5451,울산,4,4,0,13089,2021-11-04 09:28:21.584,null
5351,55,7605,대전,17,17,0,13088,2021-11-04 09:28:21.584,null
5352,29,5419,광주,14,12,2,13087,2021-11-04 09:28:21.583,null
5353,109,19967,인천,171,168,3,13086,2021-11-04 09:28:21.583,null
5354,272,17373,대구,66,66,0,13085,2021-11-04 09:28:21.583,null
5355,166,14133,부산,59,59,0,13084,2021-11-04 09:28:21.583,null
5356,814,122789,서울,946,944,2,13083,2021-11-04 09:28:21.583,null
5357,2916,373120,합계,2482,2457,25,13082,2021-11-04 09:28:21.583,null
5358,16,6296,검역,8,0,8,13081,2021-11-03 14:22:54.776,null
5359,2,3121,제주,17,17,0,13080,2021-11-03 14:22:54.776,null
5360,42,13220,경남,108,108,0,13079,2021-11-03 14:22:54.776,null
5361,95,9788,경북,31,31,0,13078,2021-11-03 14:22:54.776,null
5362,22,3616,전남,21,21,0,13077,2021-11-03 14:22:54.775,null
5363,66,5269,전북,43,43,0,13076,2021-11-03 14:22:54.775,null
5364,61,10807,충남,91,91,0,13075,2021-11-03 14:22:54.775,null
5365,84,7993,충북,48,47,1,13074,2021-11-03 14:22:54.775,null
5366,67,7270,강원,29,29,0,13073,2021-11-03 14:22:54.775,null
5367,946,110427,경기,899,895,4,13072,2021-11-03 14:22:54.775,null
5368,2,1373,세종,1,1,0,13071,2021-11-03 14:22:54.774,null
5369,56,5447,울산,7,6,1,13070,2021-11-03 14:22:54.774,null
5370,55,7588,대전,19,19,0,13069,2021-11-03 14:22:54.774,null
5371,29,5405,광주,12,11,1,13068,2021-11-03 14:22:54.774,null
5372,109,19796,인천,183,181,2,13067,2021-11-03 14:22:54.774,null
5373,268,17307,대구,66,66,0,13066,2021-11-03 14:22:54.774,null
5374,165,14074,부산,80,77,3,13065,2021-11-03 14:22:54.773,null
5375,807,121843,서울,1004,997,7,13064,2021-11-03 14:22:54.773,null
5376,2892,370640,합계,2667,2640,27,13063,2021-11-03 14:22:54.773,null
5377,16,6288,검역,1,0,1,13043,2021-11-02 09:30:50.554,null
5378,2,3104,제주,2,2,0,13042,2021-11-02 09:30:50.554,null
5379,41,13112,경남,54,54,0,13041,2021-11-02 09:30:50.554,null
5380,95,9757,경북,21,21,0,13040,2021-11-02 09:30:50.554,null
5381,22,3595,전남,34,34,0,13039,2021-11-02 09:30:50.553,null
5382,66,5226,전북,14,12,2,13038,2021-11-02 09:30:50.553,null
5383,61,10716,충남,69,69,0,13037,2021-11-02 09:30:50.553,null
5384,83,7945,충북,24,24,0,13036,2021-11-02 09:30:50.553,null
5385,67,7241,강원,29,29,0,13035,2021-11-02 09:30:50.553,null
5386,939,109528,경기,501,499,2,13034,2021-11-02 09:30:50.553,null
5387,2,1372,세종,5,5,0,13033,2021-11-02 09:30:50.552,null
5388,56,5440,울산,7,7,0,13032,2021-11-02 09:30:50.552,null
5389,55,7569,대전,28,28,0,13031,2021-11-02 09:30:50.552,null
5390,29,5393,광주,17,14,3,13030,2021-11-02 09:30:50.552,null
5391,109,19613,인천,113,112,1,13029,2021-11-02 09:30:50.552,null
5392,265,17241,대구,42,42,0,13028,2021-11-02 09:30:50.552,null
5393,164,13994,부산,28,28,0,13027,2021-11-02 09:30:50.551,null
5394,802,120840,서울,600,598,2,13026,2021-11-02 09:30:50.551,null
5395,2874,367974,합계,1589,1578,11,13025,2021-11-02 09:30:50.551,null
5396,16,6287,검역,5,0,5,13024,2021-11-01 06:56:46.4,null
5397,2,3102,제주,2,2,0,13023,2021-11-01 06:56:46.4,null
5398,41,13058,경남,50,50,0,13022,2021-11-01 06:56:46.4,null
5399,95,9736,경북,27,26,1,13021,2021-11-01 06:56:46.4,null
5400,22,3561,전남,18,17,1,13020,2021-11-01 06:56:46.399,null
5401,66,5213,전북,26,26,0,13019,2021-11-01 06:56:46.399,null
5402,60,10647,충남,47,46,1,13018,2021-11-01 06:56:46.399,null
5403,83,7921,충북,21,21,0,13017,2021-11-01 06:56:46.399,null
5404,67,7212,강원,13,13,0,13016,2021-11-01 06:56:46.399,null
5405,934,109027,경기,564,560,4,13015,2021-11-01 06:56:46.399,null
5406,2,1367,세종,2,2,0,13014,2021-11-01 06:56:46.398,null
5407,56,5433,울산,12,12,0,13013,2021-11-01 06:56:46.398,null
5408,55,7541,대전,9,9,0,13012,2021-11-01 06:56:46.398,null
5409,29,5376,광주,5,4,1,13011,2021-11-01 06:56:46.398,null
5410,109,19500,인천,127,127,0,13010,2021-11-01 06:56:46.398,null
5411,261,17199,대구,57,57,0,13009,2021-11-01 06:56:46.398,null
5412,161,13966,부산,55,55,0,13008,2021-11-01 06:56:46.398,null
5413,799,120240,서울,646,639,7,13007,2021-11-01 06:56:46.397,null
5414,2858,366386,합계,1686,1666,20,13006,2021-11-01 06:56:46.397,null
5415,16,6282,검역,4,0,4,13005,2021-10-31 09:24:32.643,null
5416,2,3100,제주,1,1,0,13004,2021-10-31 09:24:32.643,null
5417,41,13008,경남,61,61,0,13003,2021-10-31 09:24:32.642,null
5418,95,9709,경북,56,56,0,13002,2021-10-31 09:24:32.642,null
5419,22,3543,전남,30,30,0,13001,2021-10-31 09:24:32.642,null
5420,66,5187,전북,21,21,0,13000,2021-10-31 09:24:32.642,null
5421,59,10600,충남,62,62,0,12999,2021-10-31 09:24:32.642,null
5422,83,7900,충북,27,27,0,12998,2021-10-31 09:24:32.642,null
5423,67,7199,강원,23,23,0,12997,2021-10-31 09:24:32.641,null
5424,931,108463,경기,701,700,1,12996,2021-10-31 09:24:32.641,null
5425,2,1365,세종,4,4,0,12995,2021-10-31 09:24:32.641,null
5426,56,5421,울산,5,5,0,12994,2021-10-31 09:24:32.641,null
5427,54,7532,대전,11,11,0,12993,2021-10-31 09:24:32.641,null
5428,29,5371,광주,23,23,0,12992,2021-10-31 09:24:32.641,null
5429,108,19373,인천,157,157,0,12991,2021-10-31 09:24:32.64,null
5430,261,17142,대구,57,57,0,12990,2021-10-31 09:24:32.64,null
5431,161,13911,부산,58,58,0,12989,2021-10-31 09:24:32.64,null
5432,796,119594,서울,760,756,4,12988,2021-10-31 09:24:32.64,null
5433,2849,364700,합계,2061,2052,9,12987,2021-10-31 09:24:32.64,null
5434,16,6278,검역,4,0,4,12986,2021-10-30 10:09:25.412,null
5435,2,3099,제주,9,9,0,12985,2021-10-30 10:09:25.412,null
5436,40,12947,경남,173,173,0,12984,2021-10-30 10:09:25.412,null
5437,95,9653,경북,40,40,0,12983,2021-10-30 10:09:25.412,null
5438,21,3513,전남,12,12,0,12982,2021-10-30 10:09:25.412,null
5439,66,5166,전북,26,26,0,12981,2021-10-30 10:09:25.412,null
5440,59,10538,충남,56,56,0,12980,2021-10-30 10:09:25.411,null
5441,82,7873,충북,46,46,0,12979,2021-10-30 10:09:25.411,null
5442,67,7176,강원,25,25,0,12978,2021-10-30 10:09:25.411,null
5443,927,107762,경기,719,713,6,12977,2021-10-30 10:09:25.411,null
5444,2,1361,세종,4,4,0,12976,2021-10-30 10:09:25.411,null
5445,56,5416,울산,3,3,0,12975,2021-10-30 10:09:25.411,null
5446,54,7521,대전,7,7,0,12974,2021-10-30 10:09:25.41,null
5447,29,5348,광주,16,15,1,12973,2021-10-30 10:09:25.41,null
5448,107,19216,인천,123,122,1,12972,2021-10-30 10:09:25.41,null
5449,259,17085,대구,90,89,1,12971,2021-10-30 10:09:25.41,null
5450,160,13853,부산,45,45,0,12970,2021-10-30 10:09:25.41,null
5451,788,118834,서울,706,704,2,12969,2021-10-30 10:09:25.409,null
5452,2830,362639,합계,2104,2089,15,12968,2021-10-30 10:09:25.409,null
5453,16,6274,검역,8,0,8,12967,2021-10-29 09:32:27.526,null
5454,2,3090,제주,4,3,1,12966,2021-10-29 09:32:27.526,null
5455,40,12774,경남,34,33,1,12965,2021-10-29 09:32:27.526,null
5456,95,9613,경북,42,42,0,12964,2021-10-29 09:32:27.526,null
5457,21,3501,전남,13,12,1,12963,2021-10-29 09:32:27.526,null
5458,66,5140,전북,56,55,1,12962,2021-10-29 09:32:27.526,null
5459,59,10482,충남,68,67,1,12961,2021-10-29 09:32:27.526,null
5460,82,7827,충북,35,34,1,12960,2021-10-29 09:32:27.525,null
5461,66,7151,강원,21,21,0,12959,2021-10-29 09:32:27.525,null
5462,919,107044,경기,762,753,9,12958,2021-10-29 09:32:27.525,null
5463,2,1357,세종,1,1,0,12957,2021-10-29 09:32:27.525,null
5464,56,5413,울산,4,4,0,12956,2021-10-29 09:32:27.524,null
5465,54,7514,대전,9,9,0,12955,2021-10-29 09:32:27.524,null
5466,29,5332,광주,5,3,2,12954,2021-10-29 09:32:27.524,null
5467,107,19093,인천,132,130,2,12953,2021-10-29 09:32:27.524,null
5468,258,16995,대구,117,116,1,12952,2021-10-29 09:32:27.524,null
5469,159,13808,부산,43,42,1,12951,2021-10-29 09:32:27.523,null
5470,786,118128,서울,770,769,1,12950,2021-10-29 09:32:27.523,null
5471,2817,360536,합계,2124,2094,30,12949,2021-10-29 09:32:27.523,null
5472,16,6266,검역,8,0,8,12948,2021-10-28 09:36:23.525,null
5473,2,3086,제주,4,4,0,12947,2021-10-28 09:36:23.525,null
5474,40,12740,경남,35,34,1,12946,2021-10-28 09:36:23.524,null
5475,95,9571,경북,41,40,1,12945,2021-10-28 09:36:23.524,null
5476,21,3488,전남,12,12,0,12944,2021-10-28 09:36:23.524,null
5477,66,5084,전북,41,41,0,12943,2021-10-28 09:36:23.524,null
5478,59,10414,충남,82,82,0,12942,2021-10-28 09:36:23.524,null
5479,82,7792,충북,54,54,0,12941,2021-10-28 09:36:23.524,null
5480,66,7130,강원,22,22,0,12940,2021-10-28 09:36:23.523,null
5481,914,106282,경기,708,707,1,12939,2021-10-28 09:36:23.523,null
5482,2,1356,세종,2,2,0,12938,2021-10-28 09:36:23.523,null
5483,56,5409,울산,6,6,0,12937,2021-10-28 09:36:23.523,null
5484,54,7505,대전,6,6,0,12936,2021-10-28 09:36:23.523,null
5485,29,5327,광주,7,7,0,12935,2021-10-28 09:36:23.523,null
5486,107,18961,인천,137,136,1,12934,2021-10-28 09:36:23.522,null
5487,258,16878,대구,106,106,0,12933,2021-10-28 09:36:23.522,null
5488,159,13765,부산,52,51,1,12932,2021-10-28 09:36:23.522,null
5489,782,117358,서울,788,785,3,12931,2021-10-28 09:36:23.522,null
5490,2808,358412,합계,2111,2095,16,12930,2021-10-28 09:36:23.522,null
5491,16,6258,검역,6,0,6,12929,2021-10-27 10:15:49.773,null
5492,2,3082,제주,7,7,0,12928,2021-10-27 10:15:49.772,null
5493,40,12705,경남,45,44,1,12927,2021-10-27 10:15:49.772,null
5494,95,9530,경북,42,42,0,12926,2021-10-27 10:15:49.772,null
5495,21,3476,전남,6,6,0,12925,2021-10-27 10:15:49.772,null
5496,65,5043,전북,30,30,0,12924,2021-10-27 10:15:49.772,null
5497,59,10332,충남,59,58,1,12923,2021-10-27 10:15:49.772,null
5498,82,7739,충북,29,29,0,12922,2021-10-27 10:15:49.771,null
5499,66,7108,강원,19,19,0,12921,2021-10-27 10:15:49.771,null
5500,911,105575,경기,740,734,6,12920,2021-10-27 10:15:49.771,null
5501,2,1354,세종,1,1,0,12919,2021-10-27 10:15:49.771,null
5502,56,5403,울산,8,7,1,12918,2021-10-27 10:15:49.771,null
5503,54,7499,대전,15,15,0,12917,2021-10-27 10:15:49.771,null
5504,29,5320,광주,9,9,0,12916,2021-10-27 10:15:49.77,null
5505,106,18824,인천,125,125,0,12915,2021-10-27 10:15:49.77,null
5506,256,16772,대구,39,39,0,12914,2021-10-27 10:15:49.77,null
5507,158,13713,부산,43,42,1,12913,2021-10-27 10:15:49.77,null
5508,779,116572,서울,729,723,6,12912,2021-10-27 10:15:49.77,null
5509,2797,356305,합계,1952,1930,22,12911,2021-10-27 10:15:49.769,null
5510,16,6252,검역,8,0,8,12910,2021-10-26 11:00:51.783,null
5511,2,3075,제주,6,6,0,12909,2021-10-26 11:00:51.783,null
5512,40,12660,경남,29,27,2,12908,2021-10-26 11:00:51.783,null
5513,95,9488,경북,20,20,0,12907,2021-10-26 11:00:51.783,null
5514,21,3470,전남,6,6,0,12906,2021-10-26 11:00:51.783,null
5515,65,5013,전북,41,41,0,12905,2021-10-26 11:00:51.783,null
5516,59,10273,충남,40,40,0,12904,2021-10-26 11:00:51.783,null
5517,82,7710,충북,32,32,0,12903,2021-10-26 11:00:51.782,null
5518,66,7089,강원,25,24,1,12902,2021-10-26 11:00:51.782,null
5519,909,104836,경기,431,428,3,12901,2021-10-26 11:00:51.782,null
5520,2,1353,세종,6,6,0,12900,2021-10-26 11:00:51.782,null
5521,56,5395,울산,9,9,0,12899,2021-10-26 11:00:51.782,null
5522,54,7484,대전,13,13,0,12898,2021-10-26 11:00:51.782,null
5523,29,5311,광주,5,5,0,12897,2021-10-26 11:00:51.781,null
5524,105,18699,인천,74,74,0,12896,2021-10-26 11:00:51.781,null
5525,254,16733,대구,61,61,0,12895,2021-10-26 11:00:51.781,null
5526,157,13670,부산,33,33,0,12894,2021-10-26 11:00:51.781,null
5527,776,115844,서울,427,421,6,12893,2021-10-26 11:00:51.781,null
5528,2788,354355,합계,1266,1246,20,12892,2021-10-26 11:00:51.78,null
5529,16,6244,검역,8,0,8,12891,2021-10-25 09:57:05.561,null
5530,2,3069,제주,11,11,0,12890,2021-10-25 09:57:05.561,null
5531,40,12631,경남,18,16,2,12889,2021-10-25 09:57:05.561,null
5532,95,9468,경북,16,16,0,12888,2021-10-25 09:57:05.561,null
5533,21,3464,전남,5,4,1,12887,2021-10-25 09:57:05.561,null
5534,65,4972,전북,24,24,0,12886,2021-10-25 09:57:05.561,null
5535,59,10233,충남,27,26,1,12885,2021-10-25 09:57:05.561,null
5536,82,7678,충북,42,41,1,12884,2021-10-25 09:57:05.56,null
5537,66,7064,강원,20,20,0,12883,2021-10-25 09:57:05.56,null
5538,903,104405,경기,401,397,4,12882,2021-10-25 09:57:05.56,null
5539,2,1347,세종,0,0,0,12881,2021-10-25 09:57:05.56,null
5540,56,5386,울산,4,4,0,12880,2021-10-25 09:57:05.56,null
5541,54,7471,대전,4,4,0,12879,2021-10-25 09:57:05.56,null
5542,29,5306,광주,3,3,0,12878,2021-10-25 09:57:05.56,null
5543,104,18625,인천,96,95,1,12877,2021-10-25 09:57:05.559,null
5544,253,16672,대구,32,32,0,12876,2021-10-25 09:57:05.559,null
5545,157,13637,부산,24,23,1,12875,2021-10-25 09:57:05.559,null
5546,769,115417,서울,455,451,4,12874,2021-10-25 09:57:05.559,null
5547,2773,353089,합계,1190,1167,23,12873,2021-10-25 09:57:05.559,null
5548,16,6236,검역,7,0,7,12872,2021-10-24 09:42:33.197,null
5549,2,3058,제주,8,8,0,12871,2021-10-24 09:42:33.197,null
5550,40,12613,경남,27,26,1,12870,2021-10-24 09:42:33.197,null
5551,95,9452,경북,24,24,0,12869,2021-10-24 09:42:33.197,null
5552,21,3459,전남,9,9,0,12868,2021-10-24 09:42:33.196,null
5553,65,4948,전북,10,10,0,12867,2021-10-24 09:42:33.196,null
5554,59,10206,충남,64,62,2,12866,2021-10-24 09:42:33.196,null
5555,82,7636,충북,39,38,1,12865,2021-10-24 09:42:33.196,null
5556,66,7044,강원,13,13,0,12864,2021-10-24 09:42:33.196,null
5557,901,104004,경기,521,516,5,12863,2021-10-24 09:42:33.196,null
5558,2,1347,세종,0,0,0,12862,2021-10-24 09:42:33.195,null
5559,56,5382,울산,3,2,1,12861,2021-10-24 09:42:33.195,null
5560,54,7467,대전,8,8,0,12860,2021-10-24 09:42:33.195,null
5561,29,5303,광주,4,4,0,12859,2021-10-24 09:42:33.195,null
5562,104,18529,인천,103,99,4,12858,2021-10-24 09:42:33.195,null
5563,253,16640,대구,31,30,1,12857,2021-10-24 09:42:33.195,null
5564,157,13613,부산,32,32,0,12856,2021-10-24 09:42:33.194,null
5565,764,114962,서울,520,514,6,12855,2021-10-24 09:42:33.194,null
5566,2766,351899,합계,1423,1395,28,12854,2021-10-24 09:42:33.194,null
5567,16,6229,검역,4,0,4,12853,2021-10-23 10:06:56.35,null
5568,2,3050,제주,3,3,0,12852,2021-10-23 10:06:56.35,null
5569,40,12586,경남,72,71,1,12851,2021-10-23 10:06:56.35,null
5570,95,9428,경북,35,35,0,12850,2021-10-23 10:06:56.35,null
5571,21,3450,전남,5,5,0,12849,2021-10-23 10:06:56.349,null
5572,65,4938,전북,19,18,1,12848,2021-10-23 10:06:56.349,null
5573,59,10142,충남,42,42,0,12847,2021-10-23 10:06:56.349,null
5574,82,7597,충북,47,46,1,12846,2021-10-23 10:06:56.349,null
5575,66,7031,강원,20,20,0,12845,2021-10-23 10:06:56.349,null
5576,893,103483,경기,518,512,6,12844,2021-10-23 10:06:56.349,null
5577,1,1347,세종,2,2,0,12843,2021-10-23 10:06:56.348,null
5578,56,5379,울산,6,6,0,12842,2021-10-23 10:06:56.348,null
5579,54,7459,대전,8,8,0,12841,2021-10-23 10:06:56.348,null
5580,29,5299,광주,9,7,2,12840,2021-10-23 10:06:56.348,null
5581,103,18426,인천,106,106,0,12839,2021-10-23 10:06:56.348,null
5582,252,16609,대구,21,21,0,12838,2021-10-23 10:06:56.348,null
5583,155,13581,부산,40,39,1,12837,2021-10-23 10:06:56.348,null
5584,756,114442,서울,551,546,5,12836,2021-10-23 10:06:56.347,null
5585,2745,350476,합계,1508,1487,21,12835,2021-10-23 10:06:56.347,null
5586,16,6225,검역,2,0,2,12834,2021-10-22 09:43:27.122,null
5587,2,3047,제주,6,6,0,12833,2021-10-22 09:43:27.122,null
5588,39,12514,경남,34,33,1,12832,2021-10-22 09:43:27.122,null
5589,95,9393,경북,45,44,1,12831,2021-10-22 09:43:27.122,null
5590,21,3445,전남,15,15,0,12830,2021-10-22 09:43:27.121,null
5591,65,4919,전북,16,16,0,12829,2021-10-22 09:43:27.121,null
5592,59,10100,충남,27,27,0,12828,2021-10-22 09:43:27.121,null
5593,81,7551,충북,42,40,2,12827,2021-10-22 09:43:27.121,null
5594,66,7011,강원,18,18,0,12826,2021-10-22 09:43:27.121,null
5595,888,102965,경기,518,512,6,12825,2021-10-22 09:43:27.121,null
5596,1,1345,세종,1,1,0,12824,2021-10-22 09:43:27.121,null
5597,56,5373,울산,3,2,1,12823,2021-10-22 09:43:27.12,null
5598,54,7451,대전,5,5,0,12822,2021-10-22 09:43:27.12,null
5599,29,5290,광주,3,3,0,12821,2021-10-22 09:43:27.12,null
5600,102,18320,인천,121,120,1,12820,2021-10-22 09:43:27.12,null
5601,250,16588,대구,21,21,0,12819,2021-10-22 09:43:27.12,null
5602,155,13541,부산,44,44,0,12818,2021-10-22 09:43:27.12,null
5603,746,113891,서울,519,513,6,12817,2021-10-22 09:43:27.119,null
5604,2725,348969,합계,1440,1420,20,12816,2021-10-22 09:43:27.119,null
5605,16,6223,검역,2,0,2,12815,2021-10-21 09:51:31.193,null
5606,2,3041,제주,6,6,0,12814,2021-10-21 09:51:31.193,null
5607,39,12480,경남,20,19,1,12813,2021-10-21 09:51:31.193,null
5608,94,9348,경북,35,35,0,12812,2021-10-21 09:51:31.193,null
5609,21,3430,전남,12,12,0,12811,2021-10-21 09:51:31.192,null
5610,65,4903,전북,10,10,0,12810,2021-10-21 09:51:31.192,null
5611,59,10073,충남,44,44,0,12809,2021-10-21 09:51:31.192,null
5612,81,7509,충북,57,57,0,12808,2021-10-21 09:51:31.192,null
5613,66,6993,강원,31,31,0,12807,2021-10-21 09:51:31.191,null
5614,881,102447,경기,526,523,3,12806,2021-10-21 09:51:31.191,null
5615,1,1344,세종,8,8,0,12805,2021-10-21 09:51:31.19,null
5616,56,5370,울산,1,1,0,12804,2021-10-21 09:51:31.19,null
5617,54,7446,대전,8,8,0,12803,2021-10-21 09:51:31.19,null
5618,29,5287,광주,15,15,0,12802,2021-10-21 09:51:31.19,null
5619,100,18199,인천,105,104,1,12801,2021-10-21 09:51:31.19,null
5620,249,16567,대구,26,26,0,12800,2021-10-21 09:51:31.19,null
5621,155,13497,부산,29,29,0,12799,2021-10-21 09:51:31.19,null
5622,741,113372,서울,506,502,4,12798,2021-10-21 09:51:31.189,null
5623,2709,347529,합계,1441,1430,11,12797,2021-10-21 09:51:31.189,null
5624,16,6221,검역,0,0,0,12796,2021-10-20 09:46:14.047,null
5625,2,3035,제주,3,3,0,12795,2021-10-20 09:46:14.047,null
5626,39,12460,경남,33,32,1,12794,2021-10-20 09:46:14.046,null
5627,93,9313,경북,75,75,0,12793,2021-10-20 09:46:14.046,null
5628,21,3418,전남,9,9,0,12792,2021-10-20 09:46:14.046,null
5629,65,4893,전북,9,9,0,12791,2021-10-20 09:46:14.046,null
5630,59,10029,충남,43,42,1,12790,2021-10-20 09:46:14.046,null
5631,81,7452,충북,69,67,2,12789,2021-10-20 09:46:14.046,null
5632,66,6962,강원,27,27,0,12788,2021-10-20 09:46:14.045,null
5633,877,101921,경기,588,582,6,12787,2021-10-20 09:46:14.045,null
5634,1,1336,세종,3,3,0,12786,2021-10-20 09:46:14.045,null
5635,56,5369,울산,7,6,1,12785,2021-10-20 09:46:14.045,null
5636,53,7438,대전,9,9,0,12784,2021-10-20 09:46:14.045,null
5637,29,5272,광주,12,12,0,12783,2021-10-20 09:46:14.044,null
5638,99,18094,인천,109,109,0,12782,2021-10-20 09:46:14.044,null
5639,249,16541,대구,36,35,1,12781,2021-10-20 09:46:14.044,null
5640,155,13468,부산,35,35,0,12780,2021-10-20 09:46:14.044,null
5641,737,112866,서울,504,501,3,12779,2021-10-20 09:46:14.044,null
5642,2698,346088,합계,1571,1556,15,12778,2021-10-20 09:46:14.043,null
5643,16,6221,검역,5,0,5,12777,2021-10-19 09:45:35.604,null
5644,2,3032,제주,5,5,0,12776,2021-10-19 09:45:35.604,null
5645,39,12427,경남,20,19,1,12775,2021-10-19 09:45:35.604,null
5646,93,9238,경북,42,41,1,12774,2021-10-19 09:45:35.604,null
5647,21,3409,전남,14,14,0,12773,2021-10-19 09:45:35.604,null
5648,65,4884,전북,14,14,0,12772,2021-10-19 09:45:35.604,null
5649,58,9986,충남,40,39,1,12771,2021-10-19 09:45:35.603,null
5650,81,7383,충북,42,42,0,12770,2021-10-19 09:45:35.603,null
5651,66,6935,강원,7,7,0,12769,2021-10-19 09:45:35.603,null
5652,874,101333,경기,401,393,8,12768,2021-10-19 09:45:35.603,null
5653,1,1333,세종,0,0,0,12767,2021-10-19 09:45:35.603,null
5654,56,5362,울산,0,0,0,12766,2021-10-19 09:45:35.603,null
5655,53,7429,대전,15,15,0,12765,2021-10-19 09:45:35.602,null
5656,29,5260,광주,3,3,0,12764,2021-10-19 09:45:35.602,null
5657,99,17985,인천,93,88,5,12763,2021-10-19 09:45:35.602,null
5658,249,16505,대구,35,34,1,12762,2021-10-19 09:45:35.602,null
5659,155,13433,부산,39,38,1,12761,2021-10-19 09:45:35.602,null
5660,732,112363,서울,298,296,2,12760,2021-10-19 09:45:35.602,null
5661,2689,344518,합계,1073,1048,25,12759,2021-10-19 09:45:35.601,null
5662,16,6216,검역,0,0,0,12758,2021-10-18 09:44:59.323,null
5663,2,3027,제주,6,6,0,12757,2021-10-18 09:44:59.323,null
5664,39,12407,경남,29,28,1,12756,2021-10-18 09:44:59.322,null
5665,91,9196,경북,18,18,0,12755,2021-10-18 09:44:59.322,null
5666,21,3395,전남,9,9,0,12754,2021-10-18 09:44:59.322,null
5667,65,4870,전북,18,17,1,12753,2021-10-18 09:44:59.322,null
5668,58,9946,충남,33,33,0,12752,2021-10-18 09:44:59.322,null
5669,81,7341,충북,30,29,1,12751,2021-10-18 09:44:59.321,null
5670,66,6928,강원,8,8,0,12750,2021-10-18 09:44:59.321,null
5671,869,100932,경기,365,358,7,12749,2021-10-18 09:44:59.321,null
5672,1,1333,세종,2,2,0,12748,2021-10-18 09:44:59.321,null
5673,56,5362,울산,3,3,0,12747,2021-10-18 09:44:59.321,null
5674,52,7414,대전,5,5,0,12746,2021-10-18 09:44:59.32,null
5675,29,5257,광주,4,2,2,12745,2021-10-18 09:44:59.32,null
5676,99,17892,인천,85,84,1,12744,2021-10-18 09:44:59.32,null
5677,247,16470,대구,45,41,4,12743,2021-10-18 09:44:59.32,null
5678,155,13394,부산,35,35,0,12742,2021-10-18 09:44:59.319,null
5679,721,112065,서울,355,352,3,12741,2021-10-18 09:44:59.319,null
5680,2668,343445,합계,1050,1030,20,12740,2021-10-18 09:44:59.319,null
5681,16,6216,검역,8,0,8,12739,2021-10-17 10:09:13.848,null
5682,2,3021,제주,5,5,0,12738,2021-10-17 10:09:13.848,null
5683,38,12378,경남,30,29,1,12737,2021-10-17 10:09:13.848,null
5684,91,9178,경북,28,28,0,12736,2021-10-17 10:09:13.848,null
5685,21,3386,전남,22,22,0,12735,2021-10-17 10:09:13.848,null
5686,65,4852,전북,15,15,0,12734,2021-10-17 10:09:13.848,null
5687,58,9913,충남,44,43,1,12733,2021-10-17 10:09:13.847,null
5688,81,7312,충북,41,41,0,12732,2021-10-17 10:09:13.847,null
5689,66,6920,강원,24,24,0,12731,2021-10-17 10:09:13.847,null
5690,866,100567,경기,491,489,2,12730,2021-10-17 10:09:13.847,null
5691,1,1331,세종,0,0,0,12729,2021-10-17 10:09:13.847,null
5692,56,5359,울산,4,4,0,12728,2021-10-17 10:09:13.847,null
5693,52,7409,대전,8,8,0,12727,2021-10-17 10:09:13.846,null
5694,29,5253,광주,9,8,1,12726,2021-10-17 10:09:13.846,null
5695,99,17807,인천,109,109,0,12725,2021-10-17 10:09:13.846,null
5696,247,16425,대구,40,40,0,12724,2021-10-17 10:09:13.846,null
5697,155,13359,부산,36,35,1,12723,2021-10-17 10:09:13.846,null
5698,717,111710,서울,506,503,3,12722,2021-10-17 10:09:13.846,null
5699,2660,342396,합계,1420,1403,17,12721,2021-10-17 10:09:13.845,null
5700,16,6208,검역,7,0,7,12720,2021-10-16 09:53:29.857,null
5701,2,3016,제주,7,6,1,12719,2021-10-16 09:53:29.857,null
5702,38,12348,경남,17,16,1,12718,2021-10-16 09:53:29.857,null
5703,91,9150,경북,52,49,3,12717,2021-10-16 09:53:29.857,null
5704,21,3364,전남,24,24,0,12716,2021-10-16 09:53:29.856,null
5705,65,4837,전북,16,16,0,12715,2021-10-16 09:53:29.856,null
5706,58,9869,충남,39,38,1,12714,2021-10-16 09:53:29.856,null
5707,81,7272,충북,69,68,1,12713,2021-10-16 09:53:29.856,null
5708,66,6896,강원,19,19,0,12712,2021-10-16 09:53:29.856,null
5709,860,100076,경기,587,579,8,12711,2021-10-16 09:53:29.856,null
5710,1,1331,세종,1,1,0,12710,2021-10-16 09:53:29.855,null
5711,56,5355,울산,7,6,1,12709,2021-10-16 09:53:29.855,null
5712,52,7401,대전,9,9,0,12708,2021-10-16 09:53:29.855,null
5713,29,5244,광주,6,6,0,12707,2021-10-16 09:53:29.855,null
5714,98,17698,인천,103,103,0,12706,2021-10-16 09:53:29.855,null
5715,246,16385,대구,47,47,0,12705,2021-10-16 09:53:29.855,null
5716,155,13323,부산,22,22,0,12704,2021-10-16 09:53:29.855,null
5717,709,111205,서울,586,585,1,12703,2021-10-16 09:53:29.854,null
5718,2644,340978,합계,1618,1594,24,12702,2021-10-16 09:53:29.854,null
5719,16,6201,검역,3,0,3,12701,2021-10-15 09:43:09.269,null
5720,2,3009,제주,10,10,0,12700,2021-10-15 09:43:09.268,null
5721,38,12331,경남,13,12,1,12699,2021-10-15 09:43:09.268,null
5722,91,9098,경북,34,34,0,12698,2021-10-15 09:43:09.268,null
5723,21,3340,전남,24,24,0,12697,2021-10-15 09:43:09.268,null
5724,65,4821,전북,11,11,0,12696,2021-10-15 09:43:09.268,null
5725,58,9830,충남,33,33,0,12695,2021-10-15 09:43:09.268,null
5726,81,7203,충북,48,48,0,12694,2021-10-15 09:43:09.268,null
5727,64,6877,강원,21,21,0,12693,2021-10-15 09:43:09.267,null
5728,853,99489,경기,611,606,5,12692,2021-10-15 09:43:09.267,null
5729,1,1330,세종,3,2,1,12691,2021-10-15 09:43:09.267,null
5730,56,5348,울산,8,8,0,12690,2021-10-15 09:43:09.267,null
5731,52,7392,대전,12,12,0,12689,2021-10-15 09:43:09.267,null
5732,29,5238,광주,6,5,1,12688,2021-10-15 09:43:09.267,null
5733,96,17595,인천,96,95,1,12687,2021-10-15 09:43:09.267,null
5734,246,16338,대구,38,37,1,12686,2021-10-15 09:43:09.266,null
5735,155,13301,부산,32,32,0,12685,2021-10-15 09:43:09.266,null
5736,702,110620,서울,681,680,1,12684,2021-10-15 09:43:09.266,null
5737,2626,339361,합계,1684,1670,14,12683,2021-10-15 09:43:09.266,null
5738,15,6198,검역,1,0,1,12682,2021-10-14 09:38:05.704,null
5739,2,2999,제주,9,8,1,12681,2021-10-14 09:38:05.704,null
5740,38,12318,경남,35,33,2,12680,2021-10-14 09:38:05.704,null
5741,91,9064,경북,45,45,0,12679,2021-10-14 09:38:05.704,null
5742,21,3316,전남,19,19,0,12678,2021-10-14 09:38:05.704,null
5743,64,4810,전북,16,16,0,12677,2021-10-14 09:38:05.703,null
5744,58,9797,충남,47,47,0,12676,2021-10-14 09:38:05.703,2021-10-15 11:26:34.163
5745,80,7155,충북,48,47,1,12675,2021-10-14 09:38:05.703,null
5746,64,6856,강원,22,22,0,12674,2021-10-14 09:38:05.703,null
5747,851,98878,경기,690,684,6,12673,2021-10-14 09:38:05.703,null
5748,1,1327,세종,3,3,0,12672,2021-10-14 09:38:05.703,null
5749,56,5340,울산,6,6,0,12671,2021-10-14 09:38:05.703,null
5750,51,7380,대전,6,6,0,12670,2021-10-14 09:38:05.702,null
5751,29,5232,광주,10,10,0,12669,2021-10-14 09:38:05.702,null
5752,96,17499,인천,142,141,1,12668,2021-10-14 09:38:05.702,null
5753,245,16300,대구,46,45,1,12667,2021-10-14 09:38:05.702,null
5754,155,13269,부산,47,47,0,12666,2021-10-14 09:38:05.702,null
5755,701,109939,서울,748,745,3,12665,2021-10-14 09:38:05.702,2021-10-15 11:26:18.253
5756,2618,337677,합계,1940,1924,16,12664,2021-10-14 09:38:05.701,2021-10-15 11:26:46.762
5757,15,6197,검역,5,0,5,12663,2021-10-13 09:48:05.982,null
5758,2,2990,제주,11,11,0,12662,2021-10-13 09:48:05.982,null
5759,38,12283,경남,30,29,1,12661,2021-10-13 09:48:05.982,null
5760,91,9019,경북,41,41,0,12660,2021-10-13 09:48:05.982,null
5761,21,3297,전남,16,16,0,12659,2021-10-13 09:48:05.982,null
5762,64,4794,전북,13,13,0,12658,2021-10-13 09:48:05.982,null
5763,58,9750,충남,34,33,1,12657,2021-10-13 09:48:05.981,2021-10-15 11:25:28.46
5764,80,7107,충북,88,88,0,12656,2021-10-13 09:48:05.981,null
5765,64,6834,강원,17,17,0,12655,2021-10-13 09:48:05.981,null
5766,845,98188,경기,509,506,3,12654,2021-10-13 09:48:05.981,null
5767,1,1324,세종,3,3,0,12653,2021-10-13 09:48:05.981,null
5768,56,5334,울산,7,7,0,12652,2021-10-13 09:48:05.981,null
5769,51,7374,대전,21,21,0,12651,2021-10-13 09:48:05.98,null
5770,29,5222,광주,14,14,0,12650,2021-10-13 09:48:05.98,null
5771,94,17357,인천,86,86,0,12649,2021-10-13 09:48:05.98,null
5772,245,16254,대구,66,65,1,12648,2021-10-13 09:48:05.98,null
5773,155,13222,부산,40,40,0,12647,2021-10-13 09:48:05.98,null
5774,696,109195,서울,583,581,2,12646,2021-10-13 09:48:05.98,null
5775,2605,335741,합계,1584,1571,13,12645,2021-10-13 09:48:05.979,2021-10-15 11:25:43.702
5776,15,6192,검역,3,0,3,12644,2021-10-12 10:42:20.237,null
5777,2,2979,제주,7,7,0,12643,2021-10-12 10:42:20.237,null
5778,37,12253,경남,17,17,0,12642,2021-10-12 10:42:20.237,null
5779,91,8978,경북,24,24,0,12641,2021-10-12 10:42:20.237,null
5780,21,3281,전남,17,17,0,12640,2021-10-12 10:42:20.237,null
5781,64,4781,전북,23,23,0,12639,2021-10-12 10:42:20.237,null
5782,58,9716,충남,57,55,2,12638,2021-10-12 10:42:20.236,2021-10-15 11:22:36.946
5783,79,7019,충북,69,69,0,12637,2021-10-12 10:42:20.236,null
5784,64,6817,강원,28,28,0,12636,2021-10-12 10:42:20.236,null
5785,841,97679,경기,411,406,5,12635,2021-10-12 10:42:20.236,null
5786,1,1321,세종,6,6,0,12634,2021-10-12 10:42:20.236,null
5787,56,5327,울산,17,17,0,12633,2021-10-12 10:42:20.236,null
5788,50,7353,대전,23,23,0,12632,2021-10-12 10:42:20.236,null
5789,29,5208,광주,7,7,0,12631,2021-10-12 10:42:20.235,null
5790,92,17271,인천,81,81,0,12630,2021-10-12 10:42:20.235,null
5791,245,16188,대구,50,50,0,12629,2021-10-12 10:42:20.235,null
5792,155,13182,부산,25,25,0,12628,2021-10-12 10:42:20.235,null
5793,694,108612,서울,482,479,3,12627,2021-10-12 10:42:20.235,2021-10-13 11:20:18.831
5794,2594,334157,합계,1347,1334,13,12626,2021-10-12 10:42:20.234,2021-10-15 11:22:55.535
5795,15,6189,검역,6,0,6,12625,2021-10-11 09:41:58.367,null
5796,2,2972,제주,8,8,0,12624,2021-10-11 09:41:58.367,null
5797,37,12236,경남,34,33,1,12623,2021-10-11 09:41:58.367,null
5798,91,8954,경북,30,30,0,12622,2021-10-11 09:41:58.367,null
5799,21,3264,전남,11,11,0,12621,2021-10-11 09:41:58.366,null
5800,64,4758,전북,20,20,0,12620,2021-10-11 09:41:58.366,null
5801,58,9659,충남,25,24,1,12619,2021-10-11 09:41:58.366,2021-10-15 11:21:15.566
5802,79,6950,충북,60,60,0,12618,2021-10-11 09:41:58.366,null
5803,64,6789,강원,17,17,0,12617,2021-10-11 09:41:58.366,null
5804,837,97268,경기,359,358,1,12616,2021-10-11 09:41:58.366,null
5805,1,1315,세종,3,3,0,12615,2021-10-11 09:41:58.366,null
5806,56,5310,울산,11,11,0,12614,2021-10-11 09:41:58.365,null
5807,50,7330,대전,22,22,0,12613,2021-10-11 09:41:58.365,null
5808,29,5201,광주,14,13,1,12612,2021-10-11 09:41:58.365,null
5809,91,17190,인천,72,72,0,12611,2021-10-11 09:41:58.365,null
5810,245,16138,대구,45,44,1,12610,2021-10-11 09:41:58.365,null
5811,155,13157,부산,49,49,0,12609,2021-10-11 09:41:58.365,null
5812,688,108130,서울,511,509,2,12608,2021-10-11 09:41:58.365,2021-10-13 11:19:41.137
5813,2583,332810,합계,1297,1284,13,12607,2021-10-11 09:41:58.364,2021-10-15 11:21:31.481
5814,15,6183,검역,11,0,11,12606,2021-10-10 09:44:55.862,null
5815,2,2964,제주,7,7,0,12605,2021-10-10 09:44:55.862,null
5816,37,12202,경남,39,34,5,12604,2021-10-10 09:44:55.862,null
5817,91,8924,경북,45,45,0,12603,2021-10-10 09:44:55.862,null
5818,21,3253,전남,5,5,0,12602,2021-10-10 09:44:55.862,null
5819,64,4738,전북,10,10,0,12601,2021-10-10 09:44:55.861,null
5820,58,9634,충남,31,30,1,12600,2021-10-10 09:44:55.861,2021-10-15 11:20:32.743
5821,79,6890,충북,75,72,3,12599,2021-10-10 09:44:55.861,null
5822,64,6772,강원,18,18,0,12598,2021-10-10 09:44:55.861,null
5823,834,96909,경기,550,541,9,12597,2021-10-10 09:44:55.861,null
5824,1,1312,세종,4,4,0,12596,2021-10-10 09:44:55.861,null
5825,56,5299,울산,9,9,0,12595,2021-10-10 09:44:55.861,null
5826,50,7308,대전,10,10,0,12594,2021-10-10 09:44:55.86,null
5827,29,5187,광주,23,23,0,12593,2021-10-10 09:44:55.86,null
5828,91,17118,인천,95,94,1,12592,2021-10-10 09:44:55.86,null
5829,245,16093,대구,48,48,0,12591,2021-10-10 09:44:55.86,null
5830,155,13108,부산,31,31,0,12590,2021-10-10 09:44:55.86,null
5831,683,107619,서울,583,579,4,12589,2021-10-10 09:44:55.86,2021-10-13 11:18:55.148
5832,2575,331513,합계,1594,1560,34,12588,2021-10-10 09:44:55.859,2021-10-15 11:20:48.161
5833,15,6172,검역,6,0,6,12587,2021-10-09 09:55:47.508,null
5834,2,2957,제주,26,26,0,12586,2021-10-09 09:55:47.508,null
5835,37,12163,경남,73,71,2,12585,2021-10-09 09:55:47.507,null
5836,91,8879,경북,39,38,1,12584,2021-10-09 09:55:47.507,null
5837,21,3248,전남,14,14,0,12583,2021-10-09 09:55:47.507,null
5838,62,4728,전북,19,19,0,12582,2021-10-09 09:55:47.507,null
5839,58,9603,충남,58,54,4,12581,2021-10-09 09:55:47.507,2021-10-15 11:19:33.391
5840,79,6815,충북,64,64,0,12580,2021-10-09 09:55:47.507,null
5841,63,6754,강원,28,28,0,12579,2021-10-09 09:55:47.506,null
5842,829,96359,경기,638,629,9,12578,2021-10-09 09:55:47.506,null
5843,1,1308,세종,4,4,0,12577,2021-10-09 09:55:47.506,null
5844,56,5290,울산,13,12,1,12576,2021-10-09 09:55:47.506,null
5845,50,7298,대전,30,30,0,12575,2021-10-09 09:55:47.506,null
5846,29,5164,광주,18,17,1,12574,2021-10-09 09:55:47.506,null
5847,91,17023,인천,131,131,0,12573,2021-10-09 09:55:47.506,null
5848,243,16045,대구,50,50,0,12572,2021-10-09 09:55:47.505,null
5849,155,13077,부산,30,30,0,12571,2021-10-09 09:55:47.505,null
5850,678,107036,서울,712,707,5,12570,2021-10-09 09:55:47.505,2021-10-13 11:17:56.658
5851,2560,329919,합계,1953,1924,29,12569,2021-10-09 09:55:47.505,2021-10-15 11:19:50.369
5852,15,6166,검역,14,0,14,12568,2021-10-08 09:59:04.922,null
5853,2,2931,제주,9,9,0,12567,2021-10-08 09:59:04.921,null
5854,37,12090,경남,55,54,1,12566,2021-10-08 09:59:04.921,null
5855,91,8840,경북,77,77,0,12565,2021-10-08 09:59:04.921,null
5856,21,3234,전남,17,17,0,12564,2021-10-08 09:59:04.921,null
5857,62,4709,전북,22,22,0,12563,2021-10-08 09:59:04.921,null
5858,58,9545,충남,61,59,2,12562,2021-10-08 09:59:04.921,2021-10-15 11:16:01.056
5859,79,6751,충북,64,64,0,12561,2021-10-08 09:59:04.92,null
5860,63,6726,강원,33,32,1,12560,2021-10-08 09:59:04.92,null
5861,827,95721,경기,758,752,6,12559,2021-10-08 09:59:04.92,2021-10-09 10:36:34.511
5862,1,1304,세종,10,10,0,12558,2021-10-08 09:59:04.92,null
5863,56,5277,울산,16,16,0,12557,2021-10-08 09:59:04.92,null
5864,50,7268,대전,31,30,1,12556,2021-10-08 09:59:04.92,null
5865,29,5146,광주,25,25,0,12555,2021-10-08 09:59:04.92,null
5866,91,16892,인천,128,125,3,12554,2021-10-08 09:59:04.919,null
5867,243,15995,대구,45,45,0,12553,2021-10-08 09:59:04.919,null
5868,155,13047,부산,34,34,0,12552,2021-10-08 09:59:04.919,null
5869,674,106324,서울,773,770,3,12551,2021-10-08 09:59:04.919,2021-10-13 11:17:11.851
5870,2554,327966,합계,2175,2144,31,12550,2021-10-08 09:59:04.919,2021-10-15 11:16:25.155
5871,15,6152,검역,13,0,13,12549,2021-10-07 09:58:17.3,null
5872,2,2922,제주,19,9,0,12548,2021-10-07 09:58:17.299,2021-10-08 10:32:49.974
5873,37,12035,경남,96,95,1,12547,2021-10-07 09:58:17.299,null
5874,91,8763,경북,55,54,1,12546,2021-10-07 09:58:17.299,null
5875,21,3217,전남,18,18,0,12545,2021-10-07 09:58:17.299,null
5876,62,4687,전북,24,24,0,12544,2021-10-07 09:58:17.299,null
5877,58,9485,충남,52,52,0,12543,2021-10-07 09:58:17.299,null
5878,79,6687,충북,74,74,0,12542,2021-10-07 09:58:17.299,null
5879,63,6693,강원,29,29,0,12541,2021-10-07 09:58:17.298,null
5880,823,94962,경기,855,850,5,12540,2021-10-07 09:58:17.298,2021-10-09 10:40:57.882
5881,1,1294,세종,11,11,0,12539,2021-10-07 09:58:17.298,null
5882,56,5261,울산,14,14,0,12538,2021-10-07 09:58:17.298,null
5883,49,7237,대전,30,29,1,12537,2021-10-07 09:58:17.298,null
5884,29,5121,광주,13,13,0,12536,2021-10-07 09:58:17.298,null
5885,91,16764,인천,200,198,2,12535,2021-10-07 09:58:17.297,null
5886,243,15950,대구,46,46,0,12534,2021-10-07 09:58:17.297,null
5887,155,13013,부산,49,49,0,12533,2021-10-07 09:58:17.297,null
5888,669,105549,서울,834,830,4,12532,2021-10-07 09:58:17.297,2021-10-13 11:16:30.3
5889,2544,325792,합계,2425,2398,27,12531,2021-10-07 09:58:17.297,2021-10-13 11:16:46.293
5890,15,6139,검역,11,0,11,12530,2021-10-06 09:56:34.943,null
5891,2,2913,제주,4,4,0,12529,2021-10-06 09:56:34.943,2021-10-08 10:31:08.142
5892,37,11939,경남,120,120,0,12528,2021-10-06 09:56:34.943,null
5893,91,8708,경북,55,55,0,12527,2021-10-06 09:56:34.943,null
5894,21,3199,전남,13,12,1,12526,2021-10-06 09:56:34.943,null
5895,61,4663,전북,20,20,0,12525,2021-10-06 09:56:34.942,null
5896,58,9433,충남,69,68,1,12524,2021-10-06 09:56:34.942,null
5897,79,6613,충북,38,38,0,12523,2021-10-06 09:56:34.942,null
5898,63,6664,강원,31,31,0,12522,2021-10-06 09:56:34.942,null
5899,821,94107,경기,685,680,5,12521,2021-10-06 09:56:34.942,null
5900,1,1283,세종,5,5,0,12520,2021-10-06 09:56:34.942,null
5901,55,5247,울산,4,4,0,12519,2021-10-06 09:56:34.941,null
5902,49,7207,대전,31,31,0,12518,2021-10-06 09:56:34.941,null
5903,29,5108,광주,16,16,0,12517,2021-10-06 09:56:34.941,null
5904,90,16564,인천,133,130,3,12516,2021-10-06 09:56:34.941,null
5905,243,15904,대구,64,64,0,12515,2021-10-06 09:56:34.941,null
5906,155,12964,부산,38,38,0,12514,2021-10-06 09:56:34.941,null
5907,666,104715,서울,690,685,5,12513,2021-10-06 09:56:34.94,2021-10-13 11:15:53.308
5908,2536,323370,합계,2027,2001,26,12512,2021-10-06 09:56:34.94,2021-10-13 11:16:07.264
5909,15,6128,검역,8,0,8,12511,2021-10-05 09:55:20.397,null
5910,2,2909,제주,5,5,0,12510,2021-10-05 09:55:20.397,null
5911,37,11819,경남,70,70,0,12509,2021-10-05 09:55:20.397,null
5912,91,8653,경북,57,57,0,12508,2021-10-05 09:55:20.397,null
5913,21,3186,전남,13,13,0,12507,2021-10-05 09:55:20.396,null
5914,61,4643,전북,23,23,0,12506,2021-10-05 09:55:20.396,null
5915,58,9364,충남,34,33,1,12505,2021-10-05 09:55:20.396,null
5916,78,6575,충북,44,44,0,12504,2021-10-05 09:55:20.396,2021-10-06 10:14:24.134
5917,63,6633,강원,24,24,0,12503,2021-10-05 09:55:20.395,null
5918,815,93422,경기,497,496,1,12502,2021-10-05 09:55:20.395,null
5919,1,1278,세종,10,10,0,12501,2021-10-05 09:55:20.395,null
5920,55,5243,울산,12,11,1,12500,2021-10-05 09:55:20.395,null
5921,49,7176,대전,39,39,0,12499,2021-10-05 09:55:20.395,null
5922,29,5092,광주,15,14,1,12498,2021-10-05 09:55:20.394,null
5923,90,16431,인천,106,105,1,12497,2021-10-05 09:55:20.394,null
5924,242,15840,대구,50,49,1,12496,2021-10-05 09:55:20.394,null
5925,155,12926,부산,47,46,1,12495,2021-10-05 09:55:20.394,null
5926,662,104025,서울,521,518,3,12494,2021-10-05 09:55:20.394,2021-10-13 11:15:18.137
5927,2524,321340,합계,1574,1555,19,12493,2021-10-05 09:55:20.393,2021-10-13 11:15:33.501
5928,15,6120,검역,9,0,9,12492,2021-10-04 09:58:41.471,null
5929,2,2904,제주,7,7,0,12491,2021-10-04 09:58:41.471,null
5930,37,11749,경남,47,47,0,12490,2021-10-04 09:58:41.471,null
5931,91,8596,경북,60,60,0,12489,2021-10-04 09:58:41.471,null
5932,21,3173,전남,13,13,0,12488,2021-10-04 09:58:41.471,null
5933,61,4620,전북,21,21,0,12487,2021-10-04 09:58:41.471,null
5934,58,9330,충남,42,42,0,12486,2021-10-04 09:58:41.47,null
5935,78,6531,충북,44,44,0,12485,2021-10-04 09:58:41.47,2021-10-06 10:12:55.113
5936,63,6609,강원,37,37,0,12484,2021-10-04 09:58:41.47,null
5937,811,92925,경기,534,530,4,12483,2021-10-04 09:58:41.47,null
5938,1,1268,세종,3,3,0,12482,2021-10-04 09:58:41.47,null
5939,55,5231,울산,5,5,0,12481,2021-10-04 09:58:41.47,null
5940,49,7137,대전,38,38,0,12480,2021-10-04 09:58:41.47,null
5941,29,5077,광주,13,13,0,12479,2021-10-04 09:58:41.469,null
5942,89,16325,인천,120,118,2,12478,2021-10-04 09:58:41.469,null
5943,242,15790,대구,68,67,1,12477,2021-10-04 09:58:41.469,null
5944,155,12879,부산,37,37,0,12476,2021-10-04 09:58:41.469,null
5945,656,103504,서울,572,568,4,12475,2021-10-04 09:58:41.469,2021-10-13 11:14:13.761
5946,2513,319763,합계,1670,1650,20,12474,2021-10-04 09:58:41.468,2021-10-13 11:14:43.261
5947,15,6111,검역,6,0,6,12473,2021-10-03 10:19:19.211,null
5948,2,2897,제주,5,5,0,12472,2021-10-03 10:19:19.21,null
5949,37,11702,경남,65,64,1,12471,2021-10-03 10:19:19.21,null
5950,91,8536,경북,97,96,1,12470,2021-10-03 10:19:19.21,null
5951,21,3160,전남,25,25,0,12469,2021-10-03 10:19:19.21,null
5952,61,4599,전북,29,29,0,12468,2021-10-03 10:19:19.21,null
5953,58,9288,충남,44,44,0,12467,2021-10-03 10:19:19.21,null
5954,78,6487,충북,44,41,3,12466,2021-10-03 10:19:19.21,null
5955,63,6572,강원,50,50,0,12465,2021-10-03 10:19:19.209,null
5956,808,92391,경기,678,671,7,12464,2021-10-03 10:19:19.209,null
5957,1,1265,세종,7,7,0,12463,2021-10-03 10:19:19.209,null
5958,55,5226,울산,18,17,1,12462,2021-10-03 10:19:19.209,null
5959,48,7099,대전,41,41,0,12461,2021-10-03 10:19:19.209,null
5960,29,5064,광주,22,22,0,12460,2021-10-03 10:19:19.209,null
5961,88,16205,인천,128,126,2,12459,2021-10-03 10:19:19.209,null
5962,242,15722,대구,58,55,3,12458,2021-10-03 10:19:19.208,null
5963,155,12842,부산,33,33,0,12457,2021-10-03 10:19:19.208,null
5964,655,102933,서울,736,732,4,12456,2021-10-03 10:19:19.208,2021-10-13 11:13:27.114
5965,2507,318100,합계,2085,2057,28,12455,2021-10-03 10:19:19.208,2021-10-09 10:54:51.091
5966,15,6105,검역,7,0,7,12454,2021-10-02 09:53:51.598,null
5967,2,2892,제주,8,8,0,12453,2021-10-02 09:53:51.597,null
5968,37,11637,경남,108,106,2,12452,2021-10-02 09:53:51.597,null
5969,91,8439,경북,56,55,1,12451,2021-10-02 09:53:51.597,null
5970,21,3135,전남,22,22,0,12450,2021-10-02 09:53:51.597,null
5971,61,4570,전북,23,23,0,12449,2021-10-02 09:53:51.597,null
5972,58,9244,충남,51,48,3,12448,2021-10-02 09:53:51.597,null
5973,78,6443,충북,60,58,2,12447,2021-10-02 09:53:51.596,null
5974,63,6522,강원,33,33,0,12446,2021-10-02 09:53:51.596,null
5975,807,91713,경기,759,757,2,12445,2021-10-02 09:53:51.596,null
5976,1,1258,세종,11,11,0,12444,2021-10-02 09:53:51.596,null
5977,55,5208,울산,19,19,0,12443,2021-10-02 09:53:51.596,null
5978,48,7058,대전,35,35,0,12442,2021-10-02 09:53:51.596,null
5979,29,5042,광주,25,25,0,12441,2021-10-02 09:53:51.595,null
5980,88,16077,인천,116,114,2,12440,2021-10-02 09:53:51.595,null
5981,242,15664,대구,80,80,0,12439,2021-10-02 09:53:51.595,null
5982,155,12809,부산,42,42,0,12438,2021-10-02 09:53:51.595,null
5983,653,102198,서울,792,784,8,12437,2021-10-02 09:53:51.595,2021-10-13 11:12:11.382
5984,2504,316014,합계,2247,2220,27,12436,2021-10-02 09:53:51.594,2021-10-13 11:12:29.374
5985,15,6098,검역,7,0,7,12435,2021-10-01 09:58:12.096,null
5986,2,2884,제주,9,9,0,12434,2021-10-01 09:58:12.096,null
5987,37,11529,경남,69,68,1,12433,2021-10-01 09:58:12.096,null
5988,91,8383,경북,60,59,1,12432,2021-10-01 09:58:12.095,null
5989,21,3113,전남,29,29,0,12431,2021-10-01 09:58:12.095,null
5990,61,4547,전북,32,32,0,12430,2021-10-01 09:58:12.095,null
5991,57,9193,충남,60,59,1,12429,2021-10-01 09:58:12.095,null
5992,78,6383,충북,39,39,0,12428,2021-10-01 09:58:12.095,2021-10-02 10:08:50.932
5993,63,6489,강원,52,52,0,12427,2021-10-01 09:58:12.095,null
5994,806,90954,경기,825,817,8,12426,2021-10-01 09:58:12.094,null
5995,1,1247,세종,8,7,1,12425,2021-10-01 09:58:12.094,null
5996,55,5189,울산,24,24,0,12424,2021-10-01 09:58:12.094,null
5997,47,7023,대전,38,36,2,12423,2021-10-01 09:58:12.094,null
5998,29,5017,광주,28,27,1,12422,2021-10-01 09:58:12.094,null
5999,88,15961,인천,159,156,3,12421,2021-10-01 09:58:12.094,null
6000,242,15584,대구,85,84,1,12420,2021-10-01 09:58:12.093,null
6001,155,12767,부산,46,46,0,12419,2021-10-01 09:58:12.093,null
6002,649,101406,서울,914,905,9,12418,2021-10-01 09:58:12.093,2021-10-13 11:11:35.435
6003,2497,313767,합계,2484,2449,35,12417,2021-10-01 09:58:12.093,2021-10-13 11:11:10.857
6004,15,6091,검역,9,0,9,12416,2021-09-30 09:59:13.156,null
6005,2,2875,제주,15,15,0,12415,2021-09-30 09:59:13.156,null
6006,37,11460,경남,67,67,0,12414,2021-09-30 09:59:13.156,2021-10-01 10:32:20.953
6007,91,8323,경북,52,52,0,12413,2021-09-30 09:59:13.156,null
6008,21,3084,전남,24,24,0,12412,2021-09-30 09:59:13.156,null
6009,61,4515,전북,35,35,0,12411,2021-09-30 09:59:13.156,null
6010,56,9133,충남,60,55,5,12410,2021-09-30 09:59:13.155,null
6011,77,6344,충북,61,61,0,12409,2021-09-30 09:59:13.155,2021-10-02 10:07:49.288
6012,62,6437,강원,32,32,0,12408,2021-09-30 09:59:13.155,null
6013,803,90129,경기,884,879,5,12407,2021-09-30 09:59:13.155,2021-10-01 10:42:42.547
6014,1,1239,세종,14,14,0,12406,2021-09-30 09:59:13.155,null
6015,52,5165,울산,27,27,0,12405,2021-09-30 09:59:13.154,null
6016,46,6985,대전,36,35,1,12404,2021-09-30 09:59:13.154,null
6017,29,4989,광주,32,31,1,12403,2021-09-30 09:59:13.154,null
6018,88,15802,인천,148,148,0,12402,2021-09-30 09:59:13.153,null
6019,242,15499,대구,73,73,0,12401,2021-09-30 09:59:13.153,null
6020,155,12721,부산,49,49,0,12400,2021-09-30 09:59:13.152,null
6021,643,100492,서울,945,941,4,12399,2021-09-30 09:59:13.152,2021-10-13 11:09:51.807
6022,2481,311283,합계,2563,2538,25,12398,2021-09-30 09:59:13.152,2021-10-13 11:10:08.879
6023,15,6082,검역,9,0,9,12397,2021-09-29 09:58:31.731,null
6024,2,2860,제주,5,5,0,12396,2021-09-29 09:58:31.73,null
6025,37,11393,경남,84,81,3,12395,2021-09-29 09:58:31.73,null
6026,91,8271,경북,88,88,0,12394,2021-09-29 09:58:31.73,null
6027,21,3060,전남,23,23,0,12393,2021-09-29 09:58:31.73,null
6028,61,4480,전북,41,41,0,12392,2021-09-29 09:58:31.73,null
6029,56,9073,충남,77,75,2,12391,2021-09-29 09:58:31.73,null
6030,77,6283,충북,84,83,1,12390,2021-09-29 09:58:31.73,2021-10-02 10:06:51.764
6031,62,6405,강원,20,20,0,12389,2021-09-29 09:58:31.729,null
6032,800,89245,경기,990,988,2,12388,2021-09-29 09:58:31.729,2021-10-01 10:40:37.939
6033,1,1225,세종,10,10,0,12387,2021-09-29 09:58:31.729,null
6034,52,5138,울산,27,27,0,12386,2021-09-29 09:58:31.729,null
6035,46,6949,대전,29,28,1,12385,2021-09-29 09:58:31.729,null
6036,29,4957,광주,28,28,0,12384,2021-09-29 09:58:31.729,null
6037,88,15654,인천,154,151,3,12383,2021-09-29 09:58:31.728,null
6038,242,15426,대구,109,108,1,12382,2021-09-29 09:58:31.728,null
6039,155,12672,부산,52,52,0,12381,2021-09-29 09:58:31.728,null
6040,639,99547,서울,1051,1047,4,12380,2021-09-29 09:58:31.728,2021-10-13 11:08:45.971
6041,2474,308720,합계,2881,2855,26,12379,2021-09-29 09:58:31.728,2021-10-13 11:09:13.529
6042,14,6073,검역,3,0,3,12378,2021-09-28 09:58:10.417,2021-09-29 11:05:50.174
6043,2,2855,제주,7,7,0,12377,2021-09-28 09:58:10.417,null
6044,36,11309,경남,67,63,4,12376,2021-09-28 09:58:10.417,null
6045,91,8183,경북,75,73,2,12375,2021-09-28 09:58:10.416,null
6046,21,3037,전남,18,18,0,12374,2021-09-28 09:58:10.416,null
6047,61,4439,전북,42,42,0,12373,2021-09-28 09:58:10.416,null
6048,56,8996,충남,48,46,2,12372,2021-09-28 09:58:10.416,null
6049,77,6199,충북,59,59,0,12371,2021-09-28 09:58:10.416,2021-10-02 10:05:49.077
6050,62,6385,강원,26,26,0,12370,2021-09-28 09:58:10.416,null
6051,798,88255,경기,721,718,3,12369,2021-09-28 09:58:10.415,null
6052,1,1215,세종,4,4,0,12368,2021-09-28 09:58:10.415,null
6053,52,5111,울산,17,17,0,12367,2021-09-28 09:58:10.415,null
6054,45,6920,대전,54,54,0,12366,2021-09-28 09:58:10.415,null
6055,29,4929,광주,28,28,0,12365,2021-09-28 09:58:10.415,null
6056,87,15500,인천,123,123,0,12364,2021-09-28 09:58:10.415,null
6057,242,15317,대구,126,126,0,12363,2021-09-28 09:58:10.415,null
6058,155,12620,부산,29,29,0,12362,2021-09-28 09:58:10.414,null
6059,635,98496,서울,842,837,5,12361,2021-09-28 09:58:10.414,2021-09-29 10:51:39.958
6060,2464,305839,합계,2289,2270,19,12360,2021-09-28 09:58:10.414,2021-10-02 10:05:17.544
6061,14,6070,검역,12,0,12,12359,2021-09-27 10:09:11.871,2021-09-29 11:04:55.342
6062,2,2848,제주,9,9,0,12358,2021-09-27 10:09:11.871,null
6063,36,11242,경남,101,101,0,12357,2021-09-27 10:09:11.871,null
6064,91,8108,경북,71,71,0,12356,2021-09-27 10:09:11.871,null
6065,21,3019,전남,16,16,0,12355,2021-09-27 10:09:11.87,null
6066,61,4397,전북,43,43,0,12354,2021-09-27 10:09:11.87,null
6067,56,8948,충남,78,74,4,12353,2021-09-27 10:09:11.87,null
6068,76,6140,충북,63,62,1,12352,2021-09-27 10:09:11.87,2021-10-02 10:04:38.063
6069,62,6359,강원,40,40,0,12351,2021-09-27 10:09:11.869,null
6070,795,87534,경기,755,755,0,12350,2021-09-27 10:09:11.869,null
6071,1,1211,세종,14,12,2,12349,2021-09-27 10:09:11.869,null
6072,52,5094,울산,20,19,1,12348,2021-09-27 10:09:11.868,null
6073,44,6866,대전,51,51,0,12347,2021-09-27 10:09:11.868,null
6074,29,4901,광주,28,27,1,12346,2021-09-27 10:09:11.868,null
6075,86,15377,인천,145,145,0,12345,2021-09-27 10:09:11.868,null
6076,242,15191,대구,115,115,0,12344,2021-09-27 10:09:11.868,null
6077,155,12591,부산,43,42,1,12343,2021-09-27 10:09:11.867,null
6078,633,97654,서울,778,773,5,12342,2021-09-27 10:09:11.867,2021-09-29 10:50:40.079
6079,2456,303550,합계,2382,2355,27,12341,2021-09-27 10:09:11.867,2021-10-02 10:04:04.341
6080,14,6058,검역,10,0,9,12340,2021-09-26 09:43:44.896,2021-09-29 11:03:43.21
6081,2,2839,제주,7,6,1,12339,2021-09-26 09:43:44.896,null
6082,36,11141,경남,73,72,1,12338,2021-09-26 09:43:44.896,null
6083,91,8037,경북,85,85,0,12337,2021-09-26 09:43:44.896,null
6084,21,3003,전남,25,25,0,12336,2021-09-26 09:43:44.895,null
6085,61,4354,전북,48,47,1,12335,2021-09-26 09:43:44.895,2021-09-27 15:09:52.695
6086,56,8870,충남,75,74,1,12334,2021-09-26 09:43:44.895,null
6087,75,6077,충북,51,49,2,12333,2021-09-26 09:43:44.895,null
6088,62,6319,강원,47,47,0,12332,2021-09-26 09:43:44.895,null
6089,794,86779,경기,931,922,9,12331,2021-09-26 09:43:44.895,null
6090,1,1197,세종,8,8,0,12330,2021-09-26 09:43:44.895,null
6091,49,5074,울산,27,27,0,12329,2021-09-26 09:43:44.894,null
6092,44,6815,대전,53,53,0,12328,2021-09-26 09:43:44.894,null
6093,29,4873,광주,40,39,1,12327,2021-09-26 09:43:44.894,null
6094,86,15232,인천,173,168,5,12326,2021-09-26 09:43:44.894,2021-09-27 15:02:56.024
6095,242,15076,대구,143,143,0,12325,2021-09-26 09:43:44.894,null
6096,155,12548,부산,46,46,0,12324,2021-09-26 09:43:44.894,null
6097,632,96876,서울,928,923,5,12323,2021-09-26 09:43:44.893,2021-09-29 10:49:50.131
6098,2450,301168,합계,2770,2734,35,12322,2021-09-26 09:43:44.893,2021-09-29 11:03:08.582
6099,14,6049,검역,8,0,8,12321,2021-09-25 10:49:42.516,null
6100,2,2832,제주,15,15,0,12320,2021-09-25 10:49:42.515,null
6101,36,11068,경남,47,46,1,12319,2021-09-25 10:49:42.515,null
6102,91,7952,경북,58,57,1,12318,2021-09-25 10:49:42.515,null
6103,21,2978,전남,28,28,0,12317,2021-09-25 10:49:42.515,null
6104,60,4306,전북,65,65,0,12316,2021-09-25 10:49:42.515,2021-09-27 15:00:42.669
6105,56,8795,충남,93,91,2,12315,2021-09-25 10:49:42.515,null
6106,74,6026,충북,60,59,1,12314,2021-09-25 10:49:42.514,null
6107,62,6272,강원,57,56,1,12313,2021-09-25 10:49:42.514,null
6108,790,85848,경기,1102,1094,8,12312,2021-09-25 10:49:42.514,null
6109,1,1189,세종,10,10,0,12311,2021-09-25 10:49:42.514,null
6110,48,5047,울산,26,26,0,12310,2021-09-25 10:49:42.514,null
6111,44,6762,대전,80,79,1,12309,2021-09-25 10:49:42.514,null
6112,29,4833,광주,30,30,0,12308,2021-09-25 10:49:42.513,null
6113,86,15059,인천,201,201,0,12307,2021-09-25 10:49:42.513,null
6114,242,14933,대구,118,118,0,12306,2021-09-25 10:49:42.513,null
6115,155,12502,부산,51,51,0,12305,2021-09-25 10:49:42.513,null
6116,630,95948,서울,1222,1217,5,12304,2021-09-25 10:49:42.513,2021-09-29 10:47:57.914
6117,2441,298399,합계,3271,3243,28,12303,2021-09-25 10:49:42.512,2021-09-29 10:48:40.954
6118,14,6041,검역,7,0,7,12302,2021-09-24 09:54:05.541,null
6119,2,2817,제주,14,14,0,12301,2021-09-24 09:54:05.541,null
6120,36,11021,경남,38,37,1,12300,2021-09-24 09:54:05.541,null
6121,90,7894,경북,46,45,1,12299,2021-09-24 09:54:05.541,null
6122,20,2950,전남,17,17,0,12298,2021-09-24 09:54:05.54,null
6123,60,4241,전북,62,62,0,12297,2021-09-24 09:54:05.54,null
6124,56,8702,충남,75,75,0,12296,2021-09-24 09:54:05.54,null
6125,74,5966,충북,60,60,0,12295,2021-09-24 09:54:05.54,null
6126,62,6215,강원,43,43,0,12294,2021-09-24 09:54:05.54,null
6127,789,84746,경기,708,704,4,12293,2021-09-24 09:54:05.539,null
6128,1,1179,세종,14,14,0,12292,2021-09-24 09:54:05.539,2021-09-25 14:20:27.03
6129,48,5021,울산,30,30,0,12291,2021-09-24 09:54:05.539,null
6130,44,6682,대전,71,71,0,12290,2021-09-24 09:54:05.539,null
6131,29,4803,광주,42,42,0,12289,2021-09-24 09:54:05.539,null
6132,85,14858,인천,140,140,0,12288,2021-09-24 09:54:05.538,null
6133,242,14815,대구,128,128,0,12287,2021-09-24 09:54:05.538,null
6134,155,12451,부산,30,29,1,12286,2021-09-24 09:54:05.538,null
6135,627,94726,서울,905,901,4,12285,2021-09-24 09:54:05.538,2021-09-29 10:46:57.046
6136,2434,295128,합계,2430,2412,18,12284,2021-09-24 09:54:05.537,2021-09-29 10:46:12.631
6137,14,6034,검역,3,0,3,12283,2021-09-23 10:05:32.115,null
6138,2,2803,제주,9,9,0,12282,2021-09-23 10:05:32.115,null
6139,36,10983,경남,28,28,0,12281,2021-09-23 10:05:32.115,null
6140,90,7848,경북,21,20,1,12280,2021-09-23 10:05:32.115,null
6141,20,2933,전남,15,14,1,12279,2021-09-23 10:05:32.114,null
6142,60,4179,전북,40,40,0,12278,2021-09-23 10:05:32.114,null
6143,56,8627,충남,54,54,0,12277,2021-09-23 10:05:32.114,null
6144,74,5906,충북,25,24,1,12276,2021-09-23 10:05:32.114,null
6145,62,6172,강원,31,30,1,12275,2021-09-23 10:05:32.114,null
6146,789,84038,경기,548,544,4,12274,2021-09-23 10:05:32.114,null
6147,1,1165,세종,10,9,1,12273,2021-09-23 10:05:32.114,null
6148,46,4991,울산,23,22,1,12272,2021-09-23 10:05:32.113,null
6149,44,6611,대전,43,43,0,12271,2021-09-23 10:05:32.113,null
6150,29,4761,광주,36,36,0,12270,2021-09-23 10:05:32.113,null
6151,84,14718,인천,107,107,0,12269,2021-09-23 10:05:32.113,2021-09-24 11:25:05.556
6152,240,14687,대구,53,53,0,12268,2021-09-23 10:05:32.113,null
6153,155,12421,부산,24,24,0,12267,2021-09-23 10:05:32.112,null
6154,625,93821,서울,645,640,5,12266,2021-09-23 10:05:32.112,null
6155,2427,292698,합계,1715,1697,18,12265,2021-09-23 10:05:32.112,2021-09-24 11:25:58.475
6156,14,6031,검역,6,0,6,12264,2021-09-22 09:36:17.291,null
6157,2,2794,제주,5,5,0,12263,2021-09-22 09:36:17.291,null
6158,36,10955,경남,29,29,0,12262,2021-09-22 09:36:17.291,null
6159,90,7827,경북,28,27,1,12261,2021-09-22 09:36:17.29,null
6160,20,2918,전남,23,23,0,12260,2021-09-22 09:36:17.29,null
6161,60,4139,전북,27,26,1,12259,2021-09-22 09:36:17.29,null
6162,56,8573,충남,62,61,1,12258,2021-09-22 09:36:17.29,null
6163,74,5881,충북,27,26,1,12257,2021-09-22 09:36:17.29,null
6164,62,6141,강원,33,33,0,12256,2021-09-22 09:36:17.29,null
6165,786,83490,경기,529,528,1,12255,2021-09-22 09:36:17.29,null
6166,1,1155,세종,4,4,0,12254,2021-09-22 09:36:17.289,null
6167,46,4968,울산,20,20,0,12253,2021-09-22 09:36:17.289,null
6168,44,6568,대전,16,16,0,12252,2021-09-22 09:36:17.289,null
6169,29,4725,광주,40,40,0,12251,2021-09-22 09:36:17.289,null
6170,84,14611,인천,148,145,3,12250,2021-09-22 09:36:17.289,null
6171,239,14634,대구,41,41,0,12249,2021-09-22 09:36:17.289,null
6172,155,12397,부산,38,38,0,12248,2021-09-22 09:36:17.289,null
6173,621,93176,서울,644,641,3,12247,2021-09-22 09:36:17.288,null
6174,2419,290983,합계,1720,1703,17,12246,2021-09-22 09:36:17.288,null
6175,14,6025,검역,14,0,14,12245,2021-09-21 09:43:41.335,null
6176,2,2789,제주,7,7,0,12244,2021-09-21 09:43:41.335,null
6177,36,10926,경남,26,26,0,12243,2021-09-21 09:43:41.335,null
6178,90,7799,경북,27,27,0,12242,2021-09-21 09:43:41.335,null
6179,20,2895,전남,7,7,0,12241,2021-09-21 09:43:41.334,null
6180,60,4112,전북,31,31,0,12240,2021-09-21 09:43:41.334,null
6181,56,8511,충남,45,44,1,12239,2021-09-21 09:43:41.334,null
6182,74,5854,충북,27,23,4,12238,2021-09-21 09:43:41.334,null
6183,62,6108,강원,39,39,0,12237,2021-09-21 09:43:41.334,null
6184,785,82961,경기,502,499,3,12236,2021-09-21 09:43:41.334,null
6185,1,1151,세종,4,4,0,12235,2021-09-21 09:43:41.334,null
6186,46,4948,울산,16,15,1,12234,2021-09-21 09:43:41.333,null
6187,44,6552,대전,44,43,1,12233,2021-09-21 09:43:41.333,null
6188,29,4685,광주,40,39,1,12232,2021-09-21 09:43:41.333,null
6189,83,14463,인천,133,130,3,12231,2021-09-21 09:43:41.333,null
6190,238,14593,대구,46,46,0,12230,2021-09-21 09:43:41.333,null
6191,153,12359,부산,45,44,1,12229,2021-09-21 09:43:41.333,null
6192,620,92532,서울,676,673,3,12228,2021-09-21 09:43:41.332,null
6193,2413,289263,합계,1729,1697,32,12227,2021-09-21 09:43:41.332,null
6194,14,6011,검역,7,0,7,12226,2021-09-20 09:44:41.418,null
6195,2,2782,제주,10,8,2,12225,2021-09-20 09:44:41.418,null
6196,36,10900,경남,32,30,2,12224,2021-09-20 09:44:41.417,null
6197,90,7772,경북,37,35,2,12223,2021-09-20 09:44:41.417,null
6198,20,2888,전남,6,6,0,12222,2021-09-20 09:44:41.417,null
6199,60,4082,전북,38,38,0,12221,2021-09-20 09:44:41.417,null
6200,56,8466,충남,34,33,1,12220,2021-09-20 09:44:41.417,null
6201,74,5827,충북,36,35,1,12219,2021-09-20 09:44:41.417,null
6202,62,6069,강원,28,28,0,12218,2021-09-20 09:44:41.416,2021-09-21 09:45:03.878
6203,784,82459,경기,507,503,4,12217,2021-09-20 09:44:41.416,null
6204,1,1147,세종,9,9,0,12216,2021-09-20 09:44:41.416,null
6205,46,4932,울산,15,14,1,12215,2021-09-20 09:44:41.416,null
6206,44,6508,대전,49,49,0,12214,2021-09-20 09:44:41.416,null
6207,29,4645,광주,35,32,3,12213,2021-09-20 09:44:41.416,null
6208,83,14330,인천,96,96,0,12212,2021-09-20 09:44:41.415,null
6209,237,14547,대구,35,35,0,12211,2021-09-20 09:44:41.415,null
6210,153,12314,부산,47,47,0,12210,2021-09-20 09:44:41.415,null
6211,618,91856,서울,583,578,5,12209,2021-09-20 09:44:41.415,null
6212,2409,287535,합계,1604,1576,28,12208,2021-09-20 09:44:41.415,2021-09-21 09:44:37.045
6213,13,6004,검역,7,0,7,12207,2021-09-19 09:36:37.792,null
6214,2,2772,제주,6,6,0,12206,2021-09-19 09:36:37.792,null
6215,36,10868,경남,22,21,1,12205,2021-09-19 09:36:37.791,null
6216,89,7735,경북,41,39,2,12204,2021-09-19 09:36:37.791,null
6217,20,2882,전남,12,11,1,12203,2021-09-19 09:36:37.791,null
6218,60,4043,전북,20,20,0,12202,2021-09-19 09:36:37.791,2021-09-21 09:45:50.135
6219,56,8432,충남,47,41,6,12201,2021-09-19 09:36:37.791,null
6220,74,5791,충북,35,32,3,12200,2021-09-19 09:36:37.791,null
6221,62,6041,강원,46,46,0,12199,2021-09-19 09:36:37.79,null
6222,784,81952,경기,547,544,3,12198,2021-09-19 09:36:37.79,null
6223,1,1138,세종,8,8,0,12197,2021-09-19 09:36:37.79,null
6224,46,4917,울산,30,30,0,12196,2021-09-19 09:36:37.79,null
6225,44,6459,대전,48,48,0,12195,2021-09-19 09:36:37.79,null
6226,29,4610,광주,22,21,1,12194,2021-09-19 09:36:37.79,null
6227,82,14234,인천,183,180,3,12193,2021-09-19 09:36:37.789,null
6228,236,14512,대구,47,47,0,12192,2021-09-19 09:36:37.789,null
6229,153,12267,부산,46,44,2,12191,2021-09-19 09:36:37.789,null
6230,617,91273,서울,742,732,10,12190,2021-09-19 09:36:37.789,null
6231,2404,285930,합계,1909,1870,39,12189,2021-09-19 09:36:37.789,2021-09-21 09:45:32.255
6232,13,5997,검역,11,0,11,12188,2021-09-18 09:58:56.235,null
6233,2,2766,제주,3,3,0,12187,2021-09-18 09:58:56.235,null
6234,36,10846,경남,43,43,0,12186,2021-09-18 09:58:56.235,null
6235,89,7694,경북,24,22,2,12185,2021-09-18 09:58:56.235,null
6236,20,2870,전남,7,6,1,12184,2021-09-18 09:58:56.234,null
6237,60,4023,전북,73,72,1,12183,2021-09-18 09:58:56.234,null
6238,55,8385,충남,73,71,2,12182,2021-09-18 09:58:56.234,null
6239,74,5756,충북,41,39,2,12181,2021-09-18 09:58:56.234,null
6240,62,5995,강원,48,48,0,12180,2021-09-18 09:58:56.234,null
6241,780,81405,경기,674,665,9,12179,2021-09-18 09:58:56.234,null
6242,1,1130,세종,12,12,0,12178,2021-09-18 09:58:56.234,null
6243,45,4887,울산,34,33,1,12177,2021-09-18 09:58:56.233,null
6244,43,6411,대전,44,43,1,12176,2021-09-18 09:58:56.233,null
6245,29,4588,광주,27,25,2,12175,2021-09-18 09:58:56.233,null
6246,82,14051,인천,147,145,2,12174,2021-09-18 09:58:56.233,null
6247,234,14465,대구,71,71,0,12173,2021-09-18 09:58:56.233,null
6248,153,12221,부산,52,49,3,12172,2021-09-18 09:58:56.233,null
6249,616,90532,서울,703,700,3,12171,2021-09-18 09:58:56.232,null
6250,2394,284022,합계,2087,2047,40,12170,2021-09-18 09:58:56.232,null
6251,13,5986,검역,16,0,16,12169,2021-09-17 10:17:17.459,null
6252,2,2763,제주,9,9,0,12168,2021-09-17 10:17:17.459,null
6253,36,10803,경남,35,35,0,12167,2021-09-17 10:17:17.459,null
6254,89,7670,경북,38,36,2,12166,2021-09-17 10:17:17.458,null
6255,20,2863,전남,13,13,0,12165,2021-09-17 10:17:17.458,null
6256,60,3950,전북,36,36,0,12164,2021-09-17 10:17:17.458,null
6257,55,8312,충남,56,55,1,12163,2021-09-17 10:17:17.458,null
6258,74,5715,충북,37,36,1,12162,2021-09-17 10:17:17.458,null
6259,62,5947,강원,39,39,0,12161,2021-09-17 10:17:17.458,null
6260,778,80733,경기,659,655,4,12160,2021-09-17 10:17:17.457,2021-09-18 15:21:20.676
6261,1,1118,세종,12,12,0,12159,2021-09-17 10:17:17.457,null
6262,45,4853,울산,17,17,0,12158,2021-09-17 10:17:17.457,null
6263,43,6367,대전,43,43,0,12157,2021-09-17 10:17:17.457,null
6264,29,4561,광주,21,21,0,12156,2021-09-17 10:17:17.457,null
6265,82,13904,인천,141,139,2,12155,2021-09-17 10:17:17.457,null
6266,233,14394,대구,38,38,0,12154,2021-09-17 10:17:17.456,null
6267,153,12169,부산,52,51,1,12153,2021-09-17 10:17:17.456,null
6268,614,89829,서울,746,738,8,12152,2021-09-17 10:17:17.456,null
6269,2389,281934,합계,2008,1973,35,12151,2021-09-17 10:17:17.456,2021-09-18 15:20:57.103
6270,13,5970,검역,7,0,7,12150,2021-09-16 09:54:50.604,2021-09-16 10:11:33.897
6271,2,2754,제주,11,11,0,12149,2021-09-16 09:54:50.604,2021-09-16 10:11:33.897
6272,36,10768,경남,33,32,1,12148,2021-09-16 09:54:50.604,2021-09-16 10:11:33.897
6273,89,7632,경북,33,31,2,12147,2021-09-16 09:54:50.604,2021-09-16 10:11:33.897
6274,20,2850,전남,8,8,0,12146,2021-09-16 09:54:50.603,2021-09-16 10:11:33.897
6275,60,3914,전북,20,20,0,12145,2021-09-16 09:54:50.603,2021-09-16 10:11:33.897
6276,55,8256,충남,50,47,3,12144,2021-09-16 09:54:50.603,2021-09-16 10:11:33.897
6277,74,5678,충북,41,40,1,12143,2021-09-16 09:54:50.603,2021-09-16 10:11:33.897
6278,62,5908,강원,36,36,0,12142,2021-09-16 09:54:50.603,2021-09-16 10:11:33.897
6279,777,80075,경기,656,652,4,12141,2021-09-16 09:54:50.602,2021-09-16 10:11:33.897
6280,1,1106,세종,7,7,0,12140,2021-09-16 09:54:50.602,2021-09-16 10:11:33.897
6281,45,4836,울산,31,31,0,12139,2021-09-16 09:54:50.602,2021-09-16 10:11:33.897
6282,42,6324,대전,36,36,0,12138,2021-09-16 09:54:50.602,2021-09-16 10:11:33.897
6283,29,4540,광주,13,13,0,12137,2021-09-16 09:54:50.602,2021-09-16 10:11:33.897
6284,82,13763,인천,137,137,0,12136,2021-09-16 09:54:50.602,2021-09-16 10:11:33.897
6285,232,14356,대구,47,47,0,12135,2021-09-16 09:54:50.602,2021-09-16 10:11:33.897
6286,153,12117,부산,58,56,2,12134,2021-09-16 09:54:50.601,2021-09-16 10:11:33.897
6287,614,89083,서울,719,717,2,12133,2021-09-16 09:54:50.601,2021-09-16 10:11:33.897
6288,2386,279930,합계,1943,1921,22,12132,2021-09-16 09:54:50.601,2021-09-16 10:11:33.897
6289,13,5963,검역,5,0,5,12131,2021-09-15 10:14:08.780,2021-09-16 10:11:33.897
6290,2,2743,제주,6,6,0,12130,2021-09-15 10:14:08.780,2021-09-16 10:11:33.897
6291,36,10735,경남,28,28,0,12129,2021-09-15 10:14:08.780,2021-09-16 10:11:33.897
6292,89,7599,경북,22,21,1,12128,2021-09-15 10:14:08.780,2021-09-16 10:11:33.897
6293,20,2842,전남,5,5,0,12127,2021-09-15 10:14:08.780,2021-09-16 10:11:33.897
6294,60,3894,전북,16,16,0,12126,2021-09-15 10:14:08.780,2021-09-16 10:11:33.897
6295,55,8206,충남,85,80,5,12125,2021-09-15 10:14:08.779,2021-09-16 10:11:33.897
6296,74,5637,충북,37,37,0,12124,2021-09-15 10:14:08.779,2021-09-16 10:11:33.897
6297,62,5872,강원,29,29,0,12123,2021-09-15 10:14:08.779,2021-09-16 10:11:33.897
6298,775,79420,경기,691,688,3,12122,2021-09-15 10:14:08.779,2021-09-16 10:11:33.897
6299,1,1099,세종,8,8,0,12121,2021-09-15 10:14:08.779,2021-09-16 10:11:33.897
6300,44,4805,울산,31,31,0,12120,2021-09-15 10:14:08.779,2021-09-16 10:11:33.897
6301,42,6288,대전,37,37,0,12119,2021-09-15 10:14:08.779,2021-09-16 10:11:33.897
6302,28,4527,광주,38,36,2,12118,2021-09-15 10:14:08.778,2021-09-16 10:11:33.897
6303,82,13626,인천,164,164,0,12117,2021-09-15 10:14:08.778,2021-09-16 10:11:33.897
6304,232,14309,대구,27,27,0,12116,2021-09-15 10:14:08.778,2021-09-16 10:11:33.897
6305,153,12059,부산,43,40,3,12115,2021-09-15 10:14:08.778,2021-09-16 10:11:33.897
6306,612,88364,서울,808,804,4,12114,2021-09-15 10:14:08.778,2021-09-16 10:11:33.897
6307,2380,277989,합계,2080,2057,23,12113,2021-09-15 10:14:08.777,2021-09-16 10:11:33.897
6308,13,5958,검역,6,0,6,12112,2021-09-14 09:57:59.826,2021-09-16 10:11:33.897
6309,2,2737,제주,12,12,0,12111,2021-09-14 09:57:59.826,2021-09-16 10:11:33.897
6310,36,10707,경남,22,21,1,12110,2021-09-14 09:57:59.825,2021-09-16 10:11:33.897
6311,89,7577,경북,15,14,1,12109,2021-09-14 09:57:59.825,2021-09-16 10:11:33.897
6312,20,2837,전남,1,1,0,12108,2021-09-14 09:57:59.825,2021-09-16 10:11:33.897
6313,60,3878,전북,17,17,0,12107,2021-09-14 09:57:59.825,2021-09-16 10:11:33.897
6314,55,8121,충남,59,57,2,12106,2021-09-14 09:57:59.825,2021-09-16 10:11:33.897
6315,74,5600,충북,21,21,0,12105,2021-09-14 09:57:59.825,2021-09-16 10:11:33.897
6316,61,5843,강원,21,21,0,12104,2021-09-14 09:57:59.824,2021-09-16 10:11:33.897
6317,772,78730,경기,463,454,9,12103,2021-09-14 09:57:59.824,2021-09-16 10:11:33.897
6318,1,1091,세종,21,19,2,12102,2021-09-14 09:57:59.824,2021-09-16 10:11:33.897
6319,43,4774,울산,35,35,0,12101,2021-09-14 09:57:59.824,2021-09-16 10:11:33.897
6320,41,6251,대전,41,40,1,12100,2021-09-14 09:57:59.824,2021-09-16 10:11:33.897
6321,27,4489,광주,35,34,1,12099,2021-09-14 09:57:59.824,2021-09-16 10:11:33.897
6322,81,13462,인천,124,124,0,12098,2021-09-14 09:57:59.823,2021-09-16 10:11:33.897
6323,231,14282,대구,27,26,1,12097,2021-09-14 09:57:59.823,2021-09-16 10:11:33.897
6324,153,12016,부산,38,38,0,12096,2021-09-14 09:57:59.823,2021-09-16 10:11:33.897
6325,608,87556,서울,539,529,10,12095,2021-09-14 09:57:59.823,2021-09-16 10:11:33.897
6326,2367,275910,합계,1497,1463,34,12094,2021-09-14 09:57:59.823,2021-09-16 10:11:33.897
6327,13,5952,검역,10,0,10,12093,2021-09-13 09:38:20.761,2021-09-16 10:11:33.897
6328,2,2725,제주,4,4,0,12092,2021-09-13 09:38:20.761,2021-09-16 10:11:33.897
6329,36,10685,경남,23,21,2,12091,2021-09-13 09:38:20.761,2021-09-16 10:11:33.897
6330,89,7562,경북,25,25,0,12090,2021-09-13 09:38:20.761,2021-09-16 10:11:33.897
6331,20,2836,전남,5,5,0,12089,2021-09-13 09:38:20.760,2021-09-16 10:11:33.897
6332,60,3861,전북,10,10,0,12088,2021-09-13 09:38:20.760,2021-09-16 10:11:33.897
6333,55,8062,충남,58,58,0,12087,2021-09-13 09:38:20.760,2021-09-16 10:11:33.897
6334,74,5579,충북,35,33,2,12086,2021-09-13 09:38:20.760,2021-09-16 10:11:33.897
6335,61,5822,강원,14,13,1,12085,2021-09-13 09:38:20.760,2021-09-16 10:11:33.897
6336,768,78267,경기,402,395,7,12084,2021-09-13 09:38:20.760,2021-09-16 10:11:33.897
6337,1,1070,세종,4,4,0,12083,2021-09-13 09:38:20.759,2021-09-16 10:11:33.897
6338,43,4739,울산,17,17,0,12082,2021-09-13 09:38:20.759,2021-09-16 10:11:33.897
6339,41,6210,대전,39,39,0,12081,2021-09-13 09:38:20.759,2021-09-16 10:11:33.897
6340,27,4454,광주,14,14,0,12080,2021-09-13 09:38:20.759,2021-09-16 10:11:33.897
6341,80,13338,인천,151,151,0,12079,2021-09-13 09:38:20.759,2021-09-16 10:11:33.897
6342,230,14255,대구,31,31,0,12078,2021-09-13 09:38:20.759,2021-09-16 10:11:33.897
6343,153,11978,부산,35,35,0,12077,2021-09-13 09:38:20.759,2021-09-16 10:11:33.897
6344,607,87017,서울,556,554,2,12076,2021-09-13 09:38:20.758,2021-09-16 10:11:33.897
6345,2360,274413,합계,1433,1409,24,12075,2021-09-13 09:38:20.758,2021-09-16 10:11:33.897
6346,13,5942,검역,8,0,8,12074,2021-09-12 09:40:51.753,2021-09-16 10:11:33.897
6347,2,2721,제주,4,3,1,12073,2021-09-12 09:40:51.753,2021-09-16 10:11:33.897
6348,36,10662,경남,46,44,2,12072,2021-09-12 09:40:51.752,2021-09-16 10:11:33.897
6349,89,7537,경북,20,19,1,12071,2021-09-12 09:40:51.752,2021-09-16 10:11:33.897
6350,19,2831,전남,11,11,0,12070,2021-09-12 09:40:51.752,2021-09-16 10:11:33.897
6351,60,3851,전북,14,14,0,12069,2021-09-12 09:40:51.752,2021-09-16 10:11:33.897
6352,55,8004,충남,79,77,2,12068,2021-09-12 09:40:51.752,2021-09-16 10:11:33.897
6353,74,5544,충북,45,43,2,12067,2021-09-12 09:40:51.752,2021-09-16 10:11:33.897
6354,61,5808,강원,19,17,2,12066,2021-09-12 09:40:51.752,2021-09-16 10:11:33.897
6355,768,77865,경기,488,481,7,12065,2021-09-12 09:40:51.751,2021-09-16 10:11:33.897
6356,1,1066,세종,4,4,0,12064,2021-09-12 09:40:51.751,2021-09-16 10:11:33.897
6357,43,4722,울산,34,34,0,12063,2021-09-12 09:40:51.751,2021-09-16 10:11:33.897
6358,41,6171,대전,45,45,0,12062,2021-09-12 09:40:51.751,2021-09-16 10:11:33.897
6359,27,4440,광주,27,26,1,12061,2021-09-12 09:40:51.751,2021-09-16 10:11:33.897
6360,80,13187,인천,148,146,2,12060,2021-09-12 09:40:51.751,2021-09-16 10:11:33.897
6361,230,14224,대구,62,62,0,12059,2021-09-12 09:40:51.750,2021-09-16 10:11:33.897
6362,153,11943,부산,43,43,0,12058,2021-09-12 09:40:51.750,2021-09-16 10:11:33.897
6363,607,86461,서울,658,656,2,12057,2021-09-12 09:40:51.750,2021-09-16 10:11:33.897
6364,2359,272979,합계,1755,1725,30,12056,2021-09-12 09:40:51.750,2021-09-16 10:11:33.897
6365,13,5934,검역,19,0,19,12055,2021-09-11 09:35:39.572,2021-09-16 10:11:33.897
6366,2,2717,제주,6,6,0,12054,2021-09-11 09:35:39.572,2021-09-16 10:11:33.897
6367,36,10616,경남,38,36,2,12053,2021-09-11 09:35:39.572,2021-09-16 10:11:33.897
6368,89,7517,경북,34,33,1,12052,2021-09-11 09:35:39.571,2021-09-16 10:11:33.897
6369,19,2820,전남,25,24,1,12051,2021-09-11 09:35:39.571,2021-09-16 10:11:33.897
6370,60,3837,전북,17,15,2,12050,2021-09-11 09:35:39.571,2021-09-16 10:11:33.897
6371,55,7925,충남,92,92,0,12049,2021-09-11 09:35:39.571,2021-09-16 10:11:33.897
6372,74,5499,충북,30,29,1,12048,2021-09-11 09:35:39.571,2021-09-16 10:11:33.897
6373,61,5789,강원,34,33,1,12047,2021-09-11 09:35:39.571,2021-09-16 10:11:33.897
6374,767,77377,경기,572,559,13,12046,2021-09-11 09:35:39.570,2021-09-16 10:11:33.897
6375,1,1062,세종,9,9,0,12045,2021-09-11 09:35:39.570,2021-09-16 10:11:33.897
6376,43,4688,울산,31,29,2,12044,2021-09-11 09:35:39.570,2021-09-16 10:11:33.897
6377,41,6126,대전,65,65,0,12043,2021-09-11 09:35:39.570,2021-09-16 10:11:33.897
6378,27,4413,광주,21,21,0,12042,2021-09-11 09:35:39.570,2021-09-16 10:11:33.897
6379,80,13039,인천,132,131,1,12041,2021-09-11 09:35:39.570,2021-09-16 10:11:33.897
6380,230,14162,대구,45,42,3,12040,2021-09-11 09:35:39.569,2021-09-16 10:11:33.897
6381,153,11900,부산,35,35,0,12039,2021-09-11 09:35:39.569,2021-09-16 10:11:33.897
6382,607,85803,서울,659,656,3,12038,2021-09-11 09:35:39.569,2021-09-16 10:11:33.897
6383,2358,271224,합계,1864,1815,49,12037,2021-09-11 09:35:39.569,2021-09-16 10:11:33.897
6384,13,5915,검역,8,0,8,11400,2021-09-10 09:00:00.000,2021-09-16 10:11:33.897
6385,2,2711,제주,17,17,0,11399,2021-09-10 09:00:00.000,2021-09-16 10:11:33.897
6386,36,10578,경남,45,44,1,11398,2021-09-10 09:00:00.000,2021-09-16 10:11:33.897
6387,89,7483,경북,28,27,1,11397,2021-09-10 09:00:00.000,2021-09-16 10:11:33.897
6388,19,2795,전남,21,20,1,11396,2021-09-10 09:00:00.000,2021-09-16 10:11:33.897
6389,60,3820,전북,25,24,1,11395,2021-09-10 09:00:00.000,2021-09-16 10:11:33.897
6390,55,7833,충남,79,77,2,11394,2021-09-10 09:00:00.000,2021-09-16 10:11:33.897
6391,74,5469,충북,32,30,2,11393,2021-09-10 09:00:00.000,2021-09-16 10:11:33.897
6392,61,5755,강원,33,33,0,11392,2021-09-10 09:00:00.000,2021-09-16 10:11:33.897
6393,764,76805,경기,613,603,10,11391,2021-09-10 09:00:00.000,2021-09-16 10:11:33.897
6394,1,1053,세종,5,4,1,11390,2021-09-10 09:00:00.000,2021-09-16 10:11:33.897
6395,42,4657,울산,41,40,1,11389,2021-09-10 09:00:00.000,2021-09-16 10:11:33.897
6396,40,6061,대전,48,48,0,11388,2021-09-10 09:00:00.000,2021-09-16 10:11:33.897
6397,26,4392,광주,25,25,0,11387,2021-09-10 09:00:00.000,2021-09-16 10:11:33.897
6398,80,12907,인천,120,117,3,11386,2021-09-10 09:00:00.000,2021-09-16 10:11:33.897
6399,230,14117,대구,44,44,0,11385,2021-09-10 09:00:00.000,2021-09-16 10:11:33.897
6400,153,11865,부산,38,38,0,11384,2021-09-10 09:00:00.000,2021-09-16 10:11:33.897
6401,603,85144,서울,670,666,4,11383,2021-09-10 09:00:00.000,2021-09-16 10:11:33.897
6402,2348,269360,합계,1892,1857,35,11382,2021-09-10 09:00:00.000,2021-09-16 10:11:33.897
6403,13,5907,검역,11,0,11,11381,2021-09-09 09:00:00.000,2021-09-16 10:11:33.897
6404,2,2694,제주,23,23,0,11380,2021-09-09 09:00:00.000,2021-09-16 10:11:33.897
6405,36,10533,경남,77,75,2,11379,2021-09-09 09:00:00.000,2021-09-16 10:11:33.897
6406,89,7455,경북,33,33,0,11378,2021-09-09 09:00:00.000,2021-09-16 10:11:33.897
6407,19,2774,전남,22,22,0,11377,2021-09-09 09:00:00.000,2021-09-16 10:11:33.897
6408,60,3795,전북,26,25,1,11376,2021-09-09 09:00:00.000,2021-09-16 10:11:33.897
6409,55,7754,충남,152,148,4,11375,2021-09-09 09:00:00.000,2021-09-16 10:11:33.897
6410,74,5437,충북,33,33,0,11374,2021-09-09 09:00:00.000,2021-09-16 10:11:33.897
6411,61,5722,강원,33,32,1,11373,2021-09-09 09:00:00.000,2021-09-16 10:11:33.897
6412,763,76192,경기,643,639,4,11372,2021-09-09 09:00:00.000,2021-09-16 10:11:33.897
6413,1,1048,세종,6,6,0,11371,2021-09-09 09:00:00.000,2021-09-16 10:11:33.897
6414,42,4616,울산,70,70,0,11370,2021-09-09 09:00:00.000,2021-09-16 10:11:33.897
6415,40,6013,대전,38,38,0,11369,2021-09-09 09:00:00.000,2021-09-16 10:11:33.897
6416,26,4367,광주,22,22,0,11368,2021-09-09 09:00:00.000,2021-09-16 10:11:33.897
6417,80,12787,인천,108,108,0,11367,2021-09-09 09:00:00.000,2021-09-16 10:11:33.897
6418,230,14073,대구,50,49,1,11366,2021-09-09 09:00:00.000,2021-09-16 10:11:33.897
6419,153,11827,부산,35,35,0,11365,2021-09-09 09:00:00.000,2021-09-16 10:11:33.897
6420,599,84474,서울,667,660,7,11364,2021-09-09 09:00:00.000,2021-09-16 10:11:33.897
6421,2343,267468,합계,2049,2018,31,11363,2021-09-09 09:00:00.000,2021-09-16 10:11:33.897
6422,13,5896,검역,9,0,9,11362,2021-09-08 09:00:00.000,2021-09-16 10:11:33.897
6423,2,2671,제주,9,8,1,11361,2021-09-08 09:00:00.000,2021-09-16 10:11:33.897
6424,35,10456,경남,70,69,1,11360,2021-09-08 09:00:00.000,2021-09-16 10:11:33.897
6425,89,7422,경북,25,24,1,11359,2021-09-08 09:00:00.000,2021-09-16 10:11:33.897
6426,19,2752,전남,22,22,0,11358,2021-09-08 09:00:00.000,2021-09-16 10:11:33.897
6427,60,3769,전북,32,30,2,11357,2021-09-08 09:00:00.000,2021-09-16 10:11:33.897
6428,55,7602,충남,84,84,0,11356,2021-09-08 09:00:00.000,2021-09-16 10:11:33.897
6429,74,5404,충북,39,39,0,11355,2021-09-08 09:00:00.000,2021-09-16 10:11:33.897
6430,61,5689,강원,33,33,0,11354,2021-09-08 09:00:00.000,2021-09-16 10:11:33.897
6431,761,75549,경기,703,691,12,11353,2021-09-08 09:00:00.000,2021-09-16 10:11:33.897
6432,1,1042,세종,8,7,1,11352,2021-09-08 09:00:00.000,2021-09-16 10:11:33.897
6433,42,4546,울산,49,47,2,11351,2021-09-08 09:00:00.000,2021-09-16 10:11:33.897
6434,39,5975,대전,39,39,0,11350,2021-09-08 09:00:00.000,2021-09-16 10:11:33.897
6435,25,4345,광주,43,43,0,11349,2021-09-08 09:00:00.000,2021-09-16 10:11:33.897
6436,80,12679,인천,120,120,0,11348,2021-09-08 09:00:00.000,2021-09-16 10:11:33.897
6437,229,14023,대구,61,60,1,11347,2021-09-08 09:00:00.000,2021-09-16 10:11:33.897
6438,152,11792,부산,31,31,0,11346,2021-09-08 09:00:00.000,2021-09-16 10:11:33.897
6439,597,83807,서울,671,665,6,11345,2021-09-08 09:00:00.000,2021-09-16 10:11:33.897
6440,2334,265419,합계,2048,2012,36,11344,2021-09-08 09:00:00.000,2021-09-16 10:11:33.897
6441,2330,263371,합계,1597,1563,34,11343,2021-09-07 09:00:00.000,2021-09-16 10:11:33.897
6442,595,83136,서울,482,477,5,11342,2021-09-07 09:00:00.000,2021-09-16 10:11:33.897
6443,152,11761,부산,35,35,0,11341,2021-09-07 09:00:00.000,2021-09-16 10:11:33.897
6444,229,13962,대구,38,38,0,11340,2021-09-07 09:00:00.000,2021-09-16 10:11:33.897
6445,80,12559,인천,87,87,0,11339,2021-09-07 09:00:00.000,2021-09-16 10:11:33.897
6446,25,4302,광주,34,34,0,11338,2021-09-07 09:00:00.000,2021-09-16 10:11:33.897
6447,39,5936,대전,34,34,0,11337,2021-09-07 09:00:00.000,2021-09-16 10:11:33.897
6448,42,4497,울산,47,45,2,11336,2021-09-07 09:00:00.000,2021-09-16 10:11:33.897
6449,1,1034,세종,5,5,0,11335,2021-09-07 09:00:00.000,2021-09-16 10:11:33.897
6450,760,74846,경기,481,474,7,11334,2021-09-07 09:00:00.000,2021-09-16 10:11:33.897
6451,61,5656,강원,22,22,0,11333,2021-09-07 09:00:00.000,2021-09-16 10:11:33.897
6452,74,5365,충북,36,34,2,11332,2021-09-07 09:00:00.000,2021-09-16 10:11:33.897
6453,55,7518,충남,85,81,4,11331,2021-09-07 09:00:00.000,2021-09-16 10:11:33.897
6454,60,3737,전북,30,30,0,11330,2021-09-07 09:00:00.000,2021-09-16 10:11:33.897
6455,19,2730,전남,35,34,1,11329,2021-09-07 09:00:00.000,2021-09-16 10:11:33.897
6456,89,7397,경북,45,45,0,11328,2021-09-07 09:00:00.000,2021-09-16 10:11:33.897
6457,34,10386,경남,87,84,3,11327,2021-09-07 09:00:00.000,2021-09-16 10:11:33.897
6458,2,2662,제주,5,4,1,11326,2021-09-07 09:00:00.000,2021-09-16 10:11:33.897
6459,13,5887,검역,9,0,9,11325,2021-09-07 09:00:00.000,2021-09-16 10:11:33.897
6460,2327,261774,합계,1375,1351,24,11324,2021-09-06 09:00:00.000,2021-09-16 10:11:33.897
6461,593,82654,서울,464,462,2,11323,2021-09-06 09:00:00.000,2021-09-16 10:11:33.897
6462,152,11726,부산,52,51,1,11322,2021-09-06 09:00:00.000,2021-09-16 10:11:33.897
6463,229,13924,대구,43,42,1,11321,2021-09-06 09:00:00.000,2021-09-16 10:11:33.897
6464,80,12472,인천,83,80,3,11320,2021-09-06 09:00:00.000,2021-09-16 10:11:33.897
6465,25,4268,광주,28,27,1,11319,2021-09-06 09:00:00.000,2021-09-16 10:11:33.897
6466,39,5902,대전,30,29,1,11318,2021-09-06 09:00:00.000,2021-09-16 10:11:33.897
6467,42,4450,울산,39,38,1,11317,2021-09-06 09:00:00.000,2021-09-16 10:11:33.897
6468,1,1029,세종,4,4,0,11316,2021-09-06 09:00:00.000,2021-09-16 10:11:33.897
6469,759,74365,경기,400,398,2,11315,2021-09-06 09:00:00.000,2021-09-16 10:11:33.897
6470,61,5634,강원,25,23,2,11314,2021-09-06 09:00:00.000,2021-09-16 10:11:33.897
6471,74,5329,충북,24,22,2,11313,2021-09-06 09:00:00.000,2021-09-16 10:11:33.897
6472,55,7433,충남,62,61,1,11312,2021-09-06 09:00:00.000,2021-09-16 10:11:33.897
6473,60,3707,전북,7,7,0,11311,2021-09-06 09:00:00.000,2021-09-16 10:11:33.897
6474,19,2695,전남,4,4,0,11310,2021-09-06 09:00:00.000,2021-09-16 10:11:33.897
6475,89,7352,경북,38,37,1,11309,2021-09-06 09:00:00.000,2021-09-16 10:11:33.897
6476,34,10299,경남,57,57,0,11308,2021-09-06 09:00:00.000,2021-09-16 10:11:33.897
6477,2,2657,제주,9,9,0,11307,2021-09-06 09:00:00.000,2021-09-16 10:11:33.897
6478,13,5878,검역,6,0,6,11306,2021-09-06 09:00:00.000,2021-09-16 10:11:33.897
6479,2321,260400,합계,1490,1460,29,11305,2021-09-05 09:00:00.000,2021-09-16 10:11:33.897
6480,592,82190,서울,508,505,3,11304,2021-09-05 09:00:00.000,2021-09-16 10:11:33.897
6481,151,11674,부산,39,38,1,11303,2021-09-05 09:00:00.000,2021-09-16 10:11:33.897
6482,229,13881,대구,20,20,0,11302,2021-09-05 09:00:00.000,2021-09-16 10:11:33.897
6483,79,12389,인천,100,98,2,11301,2021-09-05 09:00:00.000,2021-09-16 10:11:33.897
6484,25,4240,광주,39,38,1,11300,2021-09-05 09:00:00.000,2021-09-16 10:11:33.897
6485,39,5872,대전,38,38,0,11299,2021-09-05 09:00:00.000,2021-09-16 10:11:33.897
6486,42,4411,울산,41,41,0,11298,2021-09-05 09:00:00.000,2021-09-16 10:11:33.897
6487,1,1025,세종,3,3,0,11297,2021-09-05 09:00:00.000,2021-09-16 10:11:33.897
6488,757,73965,경기,448,441,7,11296,2021-09-05 09:00:00.000,2021-09-16 10:11:33.897
6489,60,5609,강원,24,22,2,11295,2021-09-05 09:00:00.000,2021-09-16 10:11:33.897
6490,74,5305,충북,17,17,0,11294,2021-09-05 09:00:00.000,2021-09-16 10:11:33.897
6491,55,7371,충남,73,73,0,11293,2021-09-05 09:00:00.000,2021-09-16 10:11:33.897
6492,60,3700,전북,14,14,0,11292,2021-09-05 09:00:00.000,2021-09-16 10:11:33.897
6493,19,2691,전남,16,15,1,11291,2021-09-05 09:00:00.000,2021-09-16 10:11:33.897
6494,89,7314,경북,42,39,3,11290,2021-09-05 09:00:00.000,2021-09-16 10:11:33.897
6495,34,10242,경남,52,52,0,11289,2021-09-05 09:00:00.000,2021-09-16 10:11:33.897
6496,2,2648,제주,7,7,0,11288,2021-09-05 09:00:00.000,2021-09-16 10:11:33.897
6497,13,5872,검역,9,0,9,11287,2021-09-05 09:00:00.000,2021-09-16 10:11:33.897
6498,2315,258909,합계,1803,1775,28,11286,2021-09-04 09:00:00.000,2021-09-16 10:11:33.897
6499,590,81682,서울,565,563,2,11285,2021-09-04 09:00:00.000,2021-09-16 10:11:33.897
6500,151,11635,부산,51,49,2,11284,2021-09-04 09:00:00.000,2021-09-16 10:11:33.897
6501,229,13861,대구,42,41,1,11283,2021-09-04 09:00:00.000,2021-09-16 10:11:33.897
6502,78,12289,인천,98,98,0,11282,2021-09-04 09:00:00.000,2021-09-16 10:11:33.897
6503,25,4201,광주,26,24,2,11281,2021-09-04 09:00:00.000,2021-09-16 10:11:33.897
6504,39,5834,대전,50,50,0,11280,2021-09-04 09:00:00.000,2021-09-16 10:11:33.897
6505,42,4370,울산,47,47,0,11279,2021-09-04 09:00:00.000,2021-09-16 10:11:33.897
6506,1,1022,세종,8,8,0,11278,2021-09-04 09:00:00.000,2021-09-16 10:11:33.897
6507,755,73517,경기,580,576,4,11277,2021-09-04 09:00:00.000,2021-09-16 10:11:33.897
6508,60,5585,강원,45,45,0,11276,2021-09-04 09:00:00.000,2021-09-16 10:11:33.897
6509,73,5288,충북,30,28,2,11275,2021-09-04 09:00:00.000,2021-09-16 10:11:33.897
6510,55,7298,충남,99,97,2,11274,2021-09-04 09:00:00.000,2021-09-16 10:11:33.897
6511,60,3686,전북,26,25,1,11273,2021-09-04 09:00:00.000,2021-09-16 10:11:33.897
6512,19,2675,전남,30,28,2,11272,2021-09-04 09:00:00.000,2021-09-16 10:11:33.897
6513,89,7272,경북,40,39,1,11271,2021-09-04 09:00:00.000,2021-09-16 10:11:33.897
6514,34,10190,경남,52,49,3,11270,2021-09-04 09:00:00.000,2021-09-16 10:11:33.897
6515,2,2641,제주,8,8,0,11269,2021-09-04 09:00:00.000,2021-09-16 10:11:33.897
6516,13,5863,검역,6,0,6,11268,2021-09-04 09:00:00.000,2021-09-16 10:11:33.897
6517,2308,257106,합계,1708,1674,34,11267,2021-09-03 09:00:00.000,2021-09-16 10:11:33.897
6518,588,81117,서울,542,540,2,11266,2021-09-03 09:00:00.000,2021-09-16 10:11:33.897
6519,150,11584,부산,58,58,0,11265,2021-09-03 09:00:00.000,2021-09-16 10:11:33.897
6520,228,13819,대구,52,52,0,11264,2021-09-03 09:00:00.000,2021-09-16 10:11:33.897
6521,77,12191,인천,118,115,3,11263,2021-09-03 09:00:00.000,2021-09-16 10:11:33.897
6522,25,4175,광주,43,41,2,11262,2021-09-03 09:00:00.000,2021-09-16 10:11:33.897
6523,38,5784,대전,46,45,1,11261,2021-09-03 09:00:00.000,2021-09-16 10:11:33.897
6524,42,4323,울산,35,35,0,11260,2021-09-03 09:00:00.000,2021-09-16 10:11:33.897
6525,1,1014,세종,4,4,0,11259,2021-09-03 09:00:00.000,2021-09-16 10:11:33.897
6526,754,72937,경기,520,512,8,11258,2021-09-03 09:00:00.000,2021-09-16 10:11:33.897
6527,60,5540,강원,18,18,0,11257,2021-09-03 09:00:00.000,2021-09-16 10:11:33.897
6528,73,5258,충북,30,30,0,11256,2021-09-03 09:00:00.000,2021-09-16 10:11:33.897
6529,55,7199,충남,81,77,4,11255,2021-09-03 09:00:00.000,2021-09-16 10:11:33.897
6530,60,3660,전북,28,28,0,11254,2021-09-03 09:00:00.000,2021-09-16 10:11:33.897
6531,19,2645,전남,15,15,0,11253,2021-09-03 09:00:00.000,2021-09-16 10:11:33.897
6532,89,7232,경북,46,45,1,11252,2021-09-03 09:00:00.000,2021-09-16 10:11:33.897
6533,34,10138,경남,51,49,2,11251,2021-09-03 09:00:00.000,2021-09-16 10:11:33.897
6534,2,2633,제주,10,10,0,11250,2021-09-03 09:00:00.000,2021-09-16 10:11:33.897
6535,13,5857,검역,11,0,11,11249,2021-09-03 09:00:00.000,2021-09-16 10:11:33.897
6536,2303,255399,합계,1960,1926,34,11248,2021-09-02 09:00:00.000,2021-09-16 10:11:33.897
6537,587,80575,서울,559,555,4,11247,2021-09-02 09:00:00.000,2021-09-16 10:11:33.897
6538,150,11526,부산,71,69,2,11246,2021-09-02 09:00:00.000,2021-09-16 10:11:33.897
6539,228,13767,대구,66,66,0,11245,2021-09-02 09:00:00.000,2021-09-16 10:11:33.897
6540,77,12073,인천,123,120,3,11244,2021-09-02 09:00:00.000,2021-09-16 10:11:33.897
6541,25,4132,광주,42,40,2,11243,2021-09-02 09:00:00.000,2021-09-16 10:11:33.897
6542,36,5738,대전,61,60,1,11242,2021-09-02 09:00:00.000,2021-09-16 10:11:33.897
6543,42,4288,울산,42,42,0,11241,2021-09-02 09:00:00.000,2021-09-16 10:11:33.897
6544,1,1010,세종,910,7,0,11240,2021-09-02 09:00:00.000,2021-09-16 10:11:33.897
6545,753,72417,경기,697,387,10,11239,2021-09-02 09:00:00.000,2021-09-16 10:11:33.897
6546,60,5522,강원,27,25,2,11238,2021-09-02 09:00:00.000,2021-09-16 10:11:33.897
6547,73,5228,충북,27,27,0,11237,2021-09-02 09:00:00.000,2021-09-16 10:11:33.897
6548,55,7118,충남,95,93,2,11236,2021-09-02 09:00:00.000,2021-09-16 10:11:33.897
6549,60,3632,전북,18,18,0,11235,2021-09-02 09:00:00.000,2021-09-16 10:11:33.897
6550,19,2630,전남,13,12,1,11234,2021-09-02 09:00:00.000,2021-09-16 10:11:33.897
6551,89,7186,경북,42,41,1,11233,2021-09-02 09:00:00.000,2021-09-16 10:11:33.897
6552,33,10087,경남,54,53,1,11232,2021-09-02 09:00:00.000,2021-09-16 10:11:33.897
6553,2,2623,제주,11,11,0,11231,2021-09-02 09:00:00.000,2021-09-16 10:11:33.897
6554,13,5846,검역,5,0,5,11230,2021-09-02 09:00:00.000,2021-09-16 10:11:33.897
6555,2292,253439,합계,2024,1991,33,11229,2021-09-01 09:00:00.000,2021-09-16 10:11:33.897
6556,584,80016,서울,665,662,3,11228,2021-09-01 09:00:00.000,2021-09-16 10:11:33.897
6557,149,11455,부산,69,68,1,11227,2021-09-01 09:00:00.000,2021-09-16 10:11:33.897
6558,228,13701,대구,55,54,1,11226,2021-09-01 09:00:00.000,2021-09-16 10:11:33.897
6559,77,11950,인천,123,123,0,11225,2021-09-01 09:00:00.000,2021-09-16 10:11:33.897
6560,25,4090,광주,37,35,2,11224,2021-09-01 09:00:00.000,2021-09-16 10:11:33.897
6561,36,5677,대전,30,30,0,11223,2021-09-01 09:00:00.000,2021-09-16 10:11:33.897
6562,42,4246,울산,71,68,3,11222,2021-09-01 09:00:00.000,2021-09-16 10:11:33.897
6563,1,100,세종,-893,10,0,11221,2021-09-01 09:00:00.000,2021-09-16 10:11:33.897
6564,750,71720,경기,639,630,9,11220,2021-09-01 09:00:00.000,2021-09-16 10:11:33.897
6565,59,5495,강원,35,35,0,11219,2021-09-01 09:00:00.000,2021-09-16 10:11:33.897
6566,73,5201,충북,49,49,0,11218,2021-09-01 09:00:00.000,2021-09-16 10:11:33.897
6567,55,7023,충남,86,86,0,11217,2021-09-01 09:00:00.000,2021-09-16 10:11:33.897
6568,60,3614,전북,26,23,3,11216,2021-09-01 09:00:00.000,2021-09-16 10:11:33.897
6569,19,2617,전남,17,17,0,11215,2021-09-01 09:00:00.000,2021-09-16 10:11:33.897
6570,88,7144,경북,44,44,0,11214,2021-09-01 09:00:00.000,2021-09-16 10:11:33.897
6571,31,10033,경남,53,48,5,11213,2021-09-01 09:00:00.000,2021-09-16 10:11:33.897
6572,2,2612,제주,10,9,1,11212,2021-09-01 09:00:00.000,2021-09-16 10:11:33.897
6573,13,5841,검역,5,0,5,11211,2021-09-01 09:00:00.000,2021-09-16 10:11:33.897
6574,2285,251416,합계,1371,1332,39,11210,2021-08-31 09:00:00.000,2021-09-16 10:11:33.897
6575,583,79352,서울,456,452,4,11209,2021-08-31 09:00:00.000,2021-09-16 10:11:33.897
6576,148,11386,부산,44,44,0,11208,2021-08-31 09:00:00.000,2021-09-16 10:11:33.897
6577,227,13646,대구,51,50,1,11207,2021-08-31 09:00:00.000,2021-09-16 10:11:33.897
6578,77,11827,인천,73,72,1,11206,2021-08-31 09:00:00.000,2021-09-16 10:11:33.897
6579,25,4053,광주,19,17,2,11205,2021-08-31 09:00:00.000,2021-09-16 10:11:33.897
6580,36,5647,대전,34,34,0,11204,2021-08-31 09:00:00.000,2021-09-16 10:11:33.897
6581,41,4175,울산,24,24,0,11203,2021-08-31 09:00:00.000,2021-09-16 10:11:33.897
6582,1,993,세종,8,8,0,11202,2021-08-31 09:00:00.000,2021-09-16 10:11:33.897
6583,747,71081,경기,433,419,14,11201,2021-08-31 09:00:00.000,2021-09-16 10:11:33.897
6584,59,5460,강원,30,29,1,11200,2021-08-31 09:00:00.000,2021-09-16 10:11:33.897
6585,73,5152,충북,15,15,0,11199,2021-08-31 09:00:00.000,2021-09-16 10:11:33.897
6586,55,6937,충남,38,37,1,11198,2021-08-31 09:00:00.000,2021-09-16 10:11:33.897
6587,60,3588,전북,26,26,0,11197,2021-08-31 09:00:00.000,2021-09-16 10:11:33.897
6588,19,2600,전남,14,13,1,11196,2021-08-31 09:00:00.000,2021-09-16 10:11:33.897
6589,88,7100,경북,27,27,0,11195,2021-08-31 09:00:00.000,2021-09-16 10:11:33.897
6590,31,9980,경남,56,56,0,11194,2021-08-31 09:00:00.000,2021-09-16 10:11:33.897
6591,2,2602,제주,9,8,1,11193,2021-08-31 09:00:00.000,2021-09-16 10:11:33.897
6592,13,5836,검역,13,0,13,11192,2021-08-31 09:00:00.000,2021-09-16 10:11:33.897
6593,2284,250045,합계,1485,1424,61,11191,2021-08-30 09:00:00.000,2021-09-16 10:11:33.897
6594,582,78896,서울,442,434,8,11190,2021-08-30 09:00:00.000,2021-09-16 10:11:33.897
6595,148,11342,부산,57,55,2,11189,2021-08-30 09:00:00.000,2021-09-16 10:11:33.897
6596,227,13595,대구,85,83,2,11188,2021-08-30 09:00:00.000,2021-09-16 10:11:33.897
6597,77,11754,인천,64,63,1,11187,2021-08-30 09:00:00.000,2021-09-16 10:11:33.897
6598,25,4034,광주,30,29,1,11186,2021-08-30 09:00:00.000,2021-09-16 10:11:33.897
6599,36,5613,대전,29,29,0,11185,2021-08-30 09:00:00.000,2021-09-16 10:11:33.897
6600,41,4151,울산,36,35,1,11184,2021-08-30 09:00:00.000,2021-09-16 10:11:33.897
6601,1,985,세종,8,8,0,11183,2021-08-30 09:00:00.000,2021-09-16 10:11:33.897
6602,747,70648,경기,408,402,6,11182,2021-08-30 09:00:00.000,2021-09-16 10:11:33.897
6603,59,5430,강원,29,29,0,11181,2021-08-30 09:00:00.000,2021-09-16 10:11:33.897
6604,73,5137,충북,38,36,2,11180,2021-08-30 09:00:00.000,2021-09-16 10:11:33.897
6605,55,6899,충남,60,57,3,11179,2021-08-30 09:00:00.000,2021-09-16 10:11:33.897
6606,60,3562,전북,26,25,1,11178,2021-08-30 09:00:00.000,2021-09-16 10:11:33.897
6607,19,2586,전남,29,27,2,11177,2021-08-30 09:00:00.000,2021-09-16 10:11:33.897
6608,88,7073,경북,41,39,2,11176,2021-08-30 09:00:00.000,2021-09-16 10:11:33.897
6609,31,9924,경남,62,61,1,11175,2021-08-30 09:00:00.000,2021-09-16 10:11:33.897
6610,2,2593,제주,12,12,0,11174,2021-08-30 09:00:00.000,2021-09-16 10:11:33.897
6611,13,5823,검역,29,0,29,11173,2021-08-30 09:00:00.000,2021-09-16 10:11:33.897
6612,2279,248560,합계,1619,1576,43,11172,2021-08-29 09:00:00.000,2021-09-16 10:11:33.897
6613,581,78454,서울,517,508,9,11171,2021-08-29 09:00:00.000,2021-09-16 10:11:33.897
6614,148,11285,부산,64,64,0,11170,2021-08-29 09:00:00.000,2021-09-16 10:11:33.897
6615,227,13510,대구,57,56,1,11169,2021-08-29 09:00:00.000,2021-09-16 10:11:33.897
6616,77,11690,인천,93,91,2,11168,2021-08-29 09:00:00.000,2021-09-16 10:11:33.897
6617,25,4004,광주,22,22,0,11167,2021-08-29 09:00:00.000,2021-09-16 10:11:33.897
6618,36,5584,대전,18,18,0,11166,2021-08-29 09:00:00.000,2021-09-16 10:11:33.897
6619,41,4115,울산,36,36,0,11165,2021-08-29 09:00:00.000,2021-09-16 10:11:33.897
6620,1,977,세종,2,2,0,11164,2021-08-29 09:00:00.000,2021-09-16 10:11:33.897
6621,745,70240,경기,480,469,11,11163,2021-08-29 09:00:00.000,2021-09-16 10:11:33.897
6622,59,5401,강원,35,35,0,11162,2021-08-29 09:00:00.000,2021-09-16 10:11:33.897
6623,73,5099,충북,30,30,0,11161,2021-08-29 09:00:00.000,2021-09-16 10:11:33.897
6624,53,6839,충남,77,75,2,11160,2021-08-29 09:00:00.000,2021-09-16 10:11:33.897
6625,60,3536,전북,28,26,2,11159,2021-08-29 09:00:00.000,2021-09-16 10:11:33.897
6626,19,2557,전남,28,28,0,11158,2021-08-29 09:00:00.000,2021-09-16 10:11:33.897
6627,88,7032,경북,54,52,2,11157,2021-08-29 09:00:00.000,2021-09-16 10:11:33.897
6628,31,9862,경남,53,52,1,11156,2021-08-29 09:00:00.000,2021-09-16 10:11:33.897
6629,2,2581,제주,13,12,1,11155,2021-08-29 09:00:00.000,2021-09-16 10:11:33.897
6630,13,5794,검역,12,0,12,11154,2021-08-29 09:00:00.000,2021-09-16 10:11:33.897
6631,2276,246941,합계,1791,1736,55,11153,2021-08-28 09:00:00.000,2021-09-16 10:11:33.897
6632,581,77937,서울,569,559,10,11152,2021-08-28 09:00:00.000,2021-09-16 10:11:33.897
6633,148,11221,부산,76,75,1,11151,2021-08-28 09:00:00.000,2021-09-16 10:11:33.897
6634,227,13453,대구,76,76,0,11150,2021-08-28 09:00:00.000,2021-09-16 10:11:33.897
6635,76,11597,인천,95,91,4,11149,2021-08-28 09:00:00.000,2021-09-16 10:11:33.897
6636,25,3982,광주,20,18,2,11148,2021-08-28 09:00:00.000,2021-09-16 10:11:33.897
6637,36,5566,대전,46,46,0,11147,2021-08-28 09:00:00.000,2021-09-16 10:11:33.897
6638,41,4079,울산,22,21,1,11146,2021-08-28 09:00:00.000,2021-09-16 10:11:33.897
6639,1,975,세종,12,12,0,11145,2021-08-28 09:00:00.000,2021-09-16 10:11:33.897
6640,743,69760,경기,542,532,10,11144,2021-08-28 09:00:00.000,2021-09-16 10:11:33.897
6641,59,5366,강원,41,39,2,11143,2021-08-28 09:00:00.000,2021-09-16 10:11:33.897
6642,73,5069,충북,45,44,1,11142,2021-08-28 09:00:00.000,2021-09-16 10:11:33.897
6643,53,6762,충남,63,61,2,11141,2021-08-28 09:00:00.000,2021-09-16 10:11:33.897
6644,60,3508,전북,26,21,5,11140,2021-08-28 09:00:00.000,2021-09-16 10:11:33.897
6645,19,2529,전남,26,24,2,11139,2021-08-28 09:00:00.000,2021-09-16 10:11:33.897
6646,88,6978,경북,47,46,1,11138,2021-08-28 09:00:00.000,2021-09-16 10:11:33.897
6647,31,9809,경남,53,52,1,11137,2021-08-28 09:00:00.000,2021-09-16 10:11:33.897
6648,2,2568,제주,21,19,2,11136,2021-08-28 09:00:00.000,2021-09-16 10:11:33.897
6649,13,5782,검역,11,0,11,11135,2021-08-28 09:00:00.000,2021-09-16 10:11:33.897
6650,2265,245150,합계,1837,1809,28,11134,2021-08-27 09:00:00.000,2021-09-16 10:11:33.897
6651,579,77368,서울,556,552,4,11133,2021-08-27 09:00:00.000,2021-09-16 10:11:33.897
6652,146,11145,부산,68,68,0,11132,2021-08-27 09:00:00.000,2021-09-16 10:11:33.897
6653,225,13377,대구,90,89,1,11131,2021-08-27 09:00:00.000,2021-09-16 10:11:33.897
6654,75,11502,인천,97,96,1,11130,2021-08-27 09:00:00.000,2021-09-16 10:11:33.897
6655,25,3962,광주,14,12,2,11129,2021-08-27 09:00:00.000,2021-09-16 10:11:33.897
6656,36,5520,대전,57,57,0,11128,2021-08-27 09:00:00.000,2021-09-16 10:11:33.897
6657,41,4057,울산,20,20,0,11127,2021-08-27 09:00:00.000,2021-09-16 10:11:33.897
6658,1,963,세종,9,9,0,11126,2021-08-27 09:00:00.000,2021-09-16 10:11:33.897
6659,740,69218,경기,548,546,2,11125,2021-08-27 09:00:00.000,2021-09-16 10:11:33.897
6660,59,5325,강원,57,56,1,11124,2021-08-27 09:00:00.000,2021-09-16 10:11:33.897
6661,73,5024,충북,33,32,1,11123,2021-08-27 09:00:00.000,2021-09-16 10:11:33.897
6662,52,6699,충남,60,60,0,11122,2021-08-27 09:00:00.000,2021-09-16 10:11:33.897
6663,60,3482,전북,41,38,3,11121,2021-08-27 09:00:00.000,2021-09-16 10:11:33.897
6664,19,2503,전남,16,16,0,11120,2021-08-27 09:00:00.000,2021-09-16 10:11:33.897
6665,88,6931,경북,65,62,3,11119,2021-08-27 09:00:00.000,2021-09-16 10:11:33.897
6666,31,9756,경남,73,73,0,11118,2021-08-27 09:00:00.000,2021-09-16 10:11:33.897
6667,2,2547,제주,23,23,0,11117,2021-08-27 09:00:00.000,2021-09-16 10:11:33.897
6668,13,5771,검역,10,0,10,11116,2021-08-27 09:00:00.000,2021-09-16 10:11:33.897
6669,2257,243313,합계,1882,1829,53,11115,2021-08-26 09:00:00.000,2021-09-16 10:11:33.897
6670,578,76812,서울,570,566,4,11114,2021-08-26 09:00:00.000,2021-09-16 10:11:33.897
6671,144,11077,부산,78,77,1,11113,2021-08-26 09:00:00.000,2021-09-16 10:11:33.897
6672,225,13287,대구,95,93,2,11112,2021-08-26 09:00:00.000,2021-09-16 10:11:33.897
6673,75,11405,인천,102,98,4,11111,2021-08-26 09:00:00.000,2021-09-16 10:11:33.897
6674,25,3948,광주,29,29,0,11110,2021-08-26 09:00:00.000,2021-09-16 10:11:33.897
6675,36,5463,대전,50,50,0,11109,2021-08-26 09:00:00.000,2021-09-16 10:11:33.897
6676,41,4037,울산,40,40,0,11108,2021-08-26 09:00:00.000,2021-09-16 10:11:33.897
6677,1,954,세종,10,10,0,11107,2021-08-26 09:00:00.000,2021-09-16 10:11:33.897
6678,737,68670,경기,514,504,10,11106,2021-08-26 09:00:00.000,2021-09-16 10:11:33.897
6679,59,5268,강원,26,25,1,11105,2021-08-26 09:00:00.000,2021-09-16 10:11:33.897
6680,72,4991,충북,38,37,1,11104,2021-08-26 09:00:00.000,2021-09-16 10:11:33.897
6681,52,6639,충남,92,91,1,11103,2021-08-26 09:00:00.000,2021-09-16 10:11:33.897
6682,60,3441,전북,45,43,2,11102,2021-08-26 09:00:00.000,2021-09-16 10:11:33.897
6683,19,2487,전남,8,8,0,11101,2021-08-26 09:00:00.000,2021-09-16 10:11:33.897
6684,88,6866,경북,64,64,0,11100,2021-08-26 09:00:00.000,2021-09-16 10:11:33.897
6685,30,9683,경남,68,64,4,11099,2021-08-26 09:00:00.000,2021-09-16 10:11:33.897
6686,2,2524,제주,30,30,0,11098,2021-08-26 09:00:00.000,2021-09-16 10:11:33.897
6687,13,5761,검역,23,0,23,11097,2021-08-26 09:00:00.000,2021-09-16 10:11:33.897
6688,2237,241431,합계,2154,2113,41,11096,2021-08-25 09:00:00.000,2021-09-16 10:11:33.897
6689,575,76242,서울,677,673,4,11095,2021-08-25 09:00:00.000,2021-09-16 10:11:33.897
6690,139,10999,부산,86,86,0,11094,2021-08-25 09:00:00.000,2021-09-16 10:11:33.897
6691,225,13192,대구,101,99,2,11093,2021-08-25 09:00:00.000,2021-09-16 10:11:33.897
6692,73,11303,인천,119,116,3,11092,2021-08-25 09:00:00.000,2021-09-16 10:11:33.897
6693,25,3919,광주,23,23,0,11091,2021-08-25 09:00:00.000,2021-09-16 10:11:33.897
6694,34,5413,대전,64,64,0,11090,2021-08-25 09:00:00.000,2021-09-16 10:11:33.897
6695,41,3997,울산,38,35,3,11089,2021-08-25 09:00:00.000,2021-09-16 10:11:33.897
6696,1,944,세종,16,16,0,11088,2021-08-25 09:00:00.000,2021-09-16 10:11:33.897
6697,730,68156,경기,587,579,8,11087,2021-08-25 09:00:00.000,2021-09-16 10:11:33.897
6698,59,5242,강원,46,46,0,11086,2021-08-25 09:00:00.000,2021-09-16 10:11:33.897
6699,72,4953,충북,59,59,0,11085,2021-08-25 09:00:00.000,2021-09-16 10:11:33.897
6700,51,6547,충남,76,74,2,11084,2021-08-25 09:00:00.000,2021-09-16 10:11:33.897
6701,60,3396,전북,40,38,2,11083,2021-08-25 09:00:00.000,2021-09-16 10:11:33.897
6702,19,2479,전남,8,7,1,11082,2021-08-25 09:00:00.000,2021-09-16 10:11:33.897
6703,88,6802,경북,71,69,2,11081,2021-08-25 09:00:00.000,2021-09-16 10:11:33.897
6704,30,9615,경남,104,102,2,11080,2021-08-25 09:00:00.000,2021-09-16 10:11:33.897
6705,2,2494,제주,27,27,0,11079,2021-08-25 09:00:00.000,2021-09-16 10:11:33.897
6706,13,5738,검역,12,0,12,11078,2021-08-25 09:00:00.000,2021-09-16 10:11:33.897
6707,2228,239277,합계,1507,1469,38,11077,2021-08-24 09:00:00.000,2021-09-16 10:11:33.897
6708,574,75565,서울,436,428,8,11076,2021-08-24 09:00:00.000,2021-09-16 10:11:33.897
6709,136,10913,부산,61,58,3,11075,2021-08-24 09:00:00.000,2021-09-16 10:11:33.897
6710,224,13091,대구,73,72,1,11074,2021-08-24 09:00:00.000,2021-09-16 10:11:33.897
6711,73,11184,인천,63,62,1,11073,2021-08-24 09:00:00.000,2021-09-16 10:11:33.897
6712,25,3896,광주,12,12,0,11072,2021-08-24 09:00:00.000,2021-09-16 10:11:33.897
6713,34,5349,대전,63,63,0,11071,2021-08-24 09:00:00.000,2021-09-16 10:11:33.897
6714,41,3959,울산,26,26,0,11070,2021-08-24 09:00:00.000,2021-09-16 10:11:33.897
6715,1,928,세종,7,7,0,11069,2021-08-24 09:00:00.000,2021-09-16 10:11:33.897
6716,726,67569,경기,474,469,5,11068,2021-08-24 09:00:00.000,2021-09-16 10:11:33.897
6717,59,5196,강원,17,16,1,11067,2021-08-24 09:00:00.000,2021-09-16 10:11:33.897
6718,72,4894,충북,30,30,0,11066,2021-08-24 09:00:00.000,2021-09-16 10:11:33.897
6719,51,6471,충남,60,60,0,11065,2021-08-24 09:00:00.000,2021-09-16 10:11:33.897
6720,60,3356,전북,34,33,1,11064,2021-08-24 09:00:00.000,2021-09-16 10:11:33.897
6721,19,2471,전남,9,7,2,11063,2021-08-24 09:00:00.000,2021-09-16 10:11:33.897
6722,88,6731,경북,31,28,3,11062,2021-08-24 09:00:00.000,2021-09-16 10:11:33.897
6723,30,9511,경남,69,68,1,11061,2021-08-24 09:00:00.000,2021-09-16 10:11:33.897
6724,2,2467,제주,30,30,0,11060,2021-08-24 09:00:00.000,2021-09-16 10:11:33.897
6725,13,5726,검역,12,0,12,11059,2021-08-24 09:00:00.000,2021-09-16 10:11:33.897
6726,2222,237770,합계,1417,1370,47,11058,2021-08-23 09:00:00.000,2021-09-16 10:11:33.897
6727,573,75129,서울,388,383,5,11057,2021-08-23 09:00:00.000,2021-09-16 10:11:33.897
6728,136,10852,부산,63,63,0,11056,2021-08-23 09:00:00.000,2021-09-16 10:11:33.897
6729,224,13018,대구,57,52,5,11055,2021-08-23 09:00:00.000,2021-09-16 10:11:33.897
6730,73,11121,인천,78,72,6,11054,2021-08-23 09:00:00.000,2021-09-16 10:11:33.897
6731,25,3884,광주,33,33,0,11053,2021-08-23 09:00:00.000,2021-09-16 10:11:33.897
6732,34,5286,대전,30,30,0,11052,2021-08-23 09:00:00.000,2021-09-16 10:11:33.897
6733,41,3933,울산,37,37,0,11051,2021-08-23 09:00:00.000,2021-09-16 10:11:33.897
6734,1,921,세종,11,11,0,11050,2021-08-23 09:00:00.000,2021-09-16 10:11:33.897
6735,724,67095,경기,396,392,4,11049,2021-08-23 09:00:00.000,2021-09-16 10:11:33.897
6736,58,5179,강원,26,26,0,11048,2021-08-23 09:00:00.000,2021-09-16 10:11:33.897
6737,72,4864,충북,43,42,1,11047,2021-08-23 09:00:00.000,2021-09-16 10:11:33.897
6738,50,6411,충남,68,65,3,11046,2021-08-23 09:00:00.000,2021-09-16 10:11:33.897
6739,60,3322,전북,36,36,0,11045,2021-08-23 09:00:00.000,2021-09-16 10:11:33.897
6740,19,2462,전남,10,10,0,11044,2021-08-23 09:00:00.000,2021-09-16 10:11:33.897
6741,88,6700,경북,35,34,1,11043,2021-08-23 09:00:00.000,2021-09-16 10:11:33.897
6742,30,9442,경남,54,52,2,11042,2021-08-23 09:00:00.000,2021-09-16 10:11:33.897
6743,1,2437,제주,32,32,0,11041,2021-08-23 09:00:00.000,2021-09-16 10:11:33.897
6744,13,5714,검역,20,0,20,11040,2021-08-23 09:00:00.000,2021-09-16 10:11:33.897
6745,2215,236353,합계,1626,1588,38,11039,2021-08-22 09:00:00.000,2021-09-16 10:11:33.897
6746,571,74741,서울,497,492,5,11038,2021-08-22 09:00:00.000,2021-09-16 10:11:33.897
6747,136,10789,부산,113,110,3,11037,2021-08-22 09:00:00.000,2021-09-16 10:11:33.897
6748,224,12961,대구,51,50,1,11036,2021-08-22 09:00:00.000,2021-09-16 10:11:33.897
6749,73,11043,인천,66,64,2,11035,2021-08-22 09:00:00.000,2021-09-16 10:11:33.897
6750,25,3851,광주,22,22,0,11034,2021-08-22 09:00:00.000,2021-09-16 10:11:33.897
6751,34,5256,대전,23,23,0,11033,2021-08-22 09:00:00.000,2021-09-16 10:11:33.897
6752,41,3896,울산,36,36,0,11032,2021-08-22 09:00:00.000,2021-09-16 10:11:33.897
6753,1,910,세종,1,1,0,11031,2021-08-22 09:00:00.000,2021-09-16 10:11:33.897
6754,721,66699,경기,524,513,11,11030,2021-08-22 09:00:00.000,2021-09-16 10:11:33.897
6755,58,5153,강원,15,14,1,11029,2021-08-22 09:00:00.000,2021-09-16 10:11:33.897
6756,72,4821,충북,46,45,1,11028,2021-08-22 09:00:00.000,2021-09-16 10:11:33.897
6757,50,6343,충남,51,50,1,11027,2021-08-22 09:00:00.000,2021-09-16 10:11:33.897
6758,60,3286,전북,21,20,1,11026,2021-08-22 09:00:00.000,2021-09-16 10:11:33.897
6759,19,2452,전남,9,9,0,11025,2021-08-22 09:00:00.000,2021-09-16 10:11:33.897
6760,88,6665,경북,50,48,2,11024,2021-08-22 09:00:00.000,2021-09-16 10:11:33.897
6761,28,9388,경남,57,56,1,11023,2021-08-22 09:00:00.000,2021-09-16 10:11:33.897
6762,1,2405,제주,35,35,0,11022,2021-08-22 09:00:00.000,2021-09-16 10:11:33.897
6763,13,5694,검역,9,0,9,11021,2021-08-22 09:00:00.000,2021-09-16 10:11:33.897
6764,2202,234727,합계,1877,1812,65,11020,2021-08-21 09:00:00.000,2021-09-16 10:11:33.897
6765,567,74244,서울,525,518,7,11019,2021-08-21 09:00:00.000,2021-09-16 10:11:33.897
6766,135,10676,부산,86,86,0,11018,2021-08-21 09:00:00.000,2021-09-16 10:11:33.897
6767,223,12910,대구,34,31,3,11017,2021-08-21 09:00:00.000,2021-09-16 10:11:33.897
6768,73,10977,인천,92,90,2,11016,2021-08-21 09:00:00.000,2021-09-16 10:11:33.897
6769,25,3829,광주,27,27,0,11015,2021-08-21 09:00:00.000,2021-09-16 10:11:33.897
6770,34,5233,대전,28,28,0,11014,2021-08-21 09:00:00.000,2021-09-16 10:11:33.897
6771,41,3860,울산,27,27,0,11013,2021-08-21 09:00:00.000,2021-09-16 10:11:33.897
6772,1,909,세종,2,2,0,11012,2021-08-21 09:00:00.000,2021-09-16 10:11:33.897
6773,716,66175,경기,599,584,15,11011,2021-08-21 09:00:00.000,2021-09-16 10:11:33.897
6774,58,5138,강원,40,40,0,11010,2021-08-21 09:00:00.000,2021-09-16 10:11:33.897
6775,72,4775,충북,41,37,4,11009,2021-08-21 09:00:00.000,2021-09-16 10:11:33.897
6776,49,6292,충남,75,65,10,11008,2021-08-21 09:00:00.000,2021-09-16 10:11:33.897
6777,60,3265,전북,24,24,0,11007,2021-08-21 09:00:00.000,2021-09-16 10:11:33.897
6778,19,2443,전남,15,15,0,11006,2021-08-21 09:00:00.000,2021-09-16 10:11:33.897
6779,88,6615,경북,111,109,2,11005,2021-08-21 09:00:00.000,2021-09-16 10:11:33.897
6780,27,9331,경남,79,78,1,11004,2021-08-21 09:00:00.000,2021-09-16 10:11:33.897
6781,1,2370,제주,52,51,1,11003,2021-08-21 09:00:00.000,2021-09-16 10:11:33.897
6782,13,5685,검역,20,0,20,11002,2021-08-21 09:00:00.000,2021-09-16 10:11:33.897
6783,2197,232850,합계,2050,2000,50,11001,2021-08-20 09:00:00.000,2021-09-16 10:11:33.897
6784,566,73719,서울,554,548,6,11000,2021-08-20 09:00:00.000,2021-09-16 10:11:33.897
6785,134,10590,부산,132,131,1,10999,2021-08-20 09:00:00.000,2021-09-16 10:11:33.897
6786,223,12876,대구,39,39,0,10998,2021-08-20 09:00:00.000,2021-09-16 10:11:33.897
6787,73,10885,인천,120,117,3,10997,2021-08-20 09:00:00.000,2021-09-16 10:11:33.897
6788,25,3802,광주,22,22,0,10996,2021-08-20 09:00:00.000,2021-09-16 10:11:33.897
6789,33,5205,대전,58,58,0,10995,2021-08-20 09:00:00.000,2021-09-16 10:11:33.897
6790,41,3833,울산,30,28,2,10994,2021-08-20 09:00:00.000,2021-09-16 10:11:33.897
6791,1,907,세종,13,13,0,10993,2021-08-20 09:00:00.000,2021-09-16 10:11:33.897
6792,715,65576,경기,645,633,12,10992,2021-08-20 09:00:00.000,2021-09-16 10:11:33.897
6793,58,5098,강원,28,26,2,10991,2021-08-20 09:00:00.000,2021-09-16 10:11:33.897
6794,72,4734,충북,44,44,0,10990,2021-08-20 09:00:00.000,2021-09-16 10:11:33.897
6795,49,6217,충남,76,71,5,10989,2021-08-20 09:00:00.000,2021-09-16 10:11:33.897
6796,60,3241,전북,40,39,1,10988,2021-08-20 09:00:00.000,2021-09-16 10:11:33.897
6797,19,2428,전남,23,23,0,10987,2021-08-20 09:00:00.000,2021-09-16 10:11:33.897
6798,88,6504,경북,67,64,3,10986,2021-08-20 09:00:00.000,2021-09-16 10:11:33.897
6799,26,9252,경남,90,88,2,10985,2021-08-20 09:00:00.000,2021-09-16 10:11:33.897
6800,1,2318,제주,56,56,0,10984,2021-08-20 09:00:00.000,2021-09-16 10:11:33.897
6801,13,5665,검역,13,0,13,10983,2021-08-20 09:00:00.000,2021-09-16 10:11:33.897
6802,2191,230800,합계,2152,2114,38,10982,2021-08-19 09:00:00.000,2021-09-16 10:11:33.897
6803,564,73165,서울,575,570,5,10981,2021-08-19 09:00:00.000,2021-09-16 10:11:33.897
6804,134,10458,부산,138,136,2,10980,2021-08-19 09:00:00.000,2021-09-16 10:11:33.897
6805,223,12837,대구,52,52,0,10979,2021-08-19 09:00:00.000,2021-09-16 10:11:33.897
6806,73,10765,인천,153,153,0,10978,2021-08-19 09:00:00.000,2021-09-16 10:11:33.897
6807,24,3780,광주,22,22,0,10977,2021-08-19 09:00:00.000,2021-09-16 10:11:33.897
6808,33,5147,대전,49,49,0,10976,2021-08-19 09:00:00.000,2021-09-16 10:11:33.897
6809,41,3803,울산,68,68,0,10975,2021-08-19 09:00:00.000,2021-09-16 10:11:33.897
6810,1,894,세종,13,13,0,10974,2021-08-19 09:00:00.000,2021-09-16 10:11:33.897
6811,715,64931,경기,649,641,8,10973,2021-08-19 09:00:00.000,2021-09-16 10:11:33.897
6812,58,5070,강원,29,28,1,10972,2021-08-19 09:00:00.000,2021-09-16 10:11:33.897
6813,71,4690,충북,59,57,2,10971,2021-08-19 09:00:00.000,2021-09-16 10:11:33.897
6814,47,6141,충남,83,81,2,10970,2021-08-19 09:00:00.000,2021-09-16 10:11:33.897
6815,60,3201,전북,39,38,1,10969,2021-08-19 09:00:00.000,2021-09-16 10:11:33.897
6816,19,2405,전남,17,17,0,10968,2021-08-19 09:00:00.000,2021-09-16 10:11:33.897
6817,88,6437,경북,47,47,0,10967,2021-08-19 09:00:00.000,2021-09-16 10:11:33.897
6818,26,9162,경남,109,107,2,10966,2021-08-19 09:00:00.000,2021-09-16 10:11:33.897
6819,1,2262,제주,37,35,2,10965,2021-08-19 09:00:00.000,2021-09-16 10:11:33.897
6820,13,5652,검역,13,0,13,10964,2021-08-19 09:00:00.000,2021-09-16 10:11:33.897
6821,2178,228648,합계,1803,1766,37,10963,2021-08-18 09:00:00.000,2021-09-16 10:11:33.897
6822,561,72590,서울,509,506,3,10962,2021-08-18 09:00:00.000,2021-09-16 10:11:33.897
6823,131,10320,부산,124,123,1,10961,2021-08-18 09:00:00.000,2021-09-16 10:11:33.897
6824,223,12785,대구,61,61,0,10960,2021-08-18 09:00:00.000,2021-09-16 10:11:33.897
6825,72,10612,인천,92,91,1,10959,2021-08-18 09:00:00.000,2021-09-16 10:11:33.897
6826,24,3758,광주,31,30,1,10958,2021-08-18 09:00:00.000,2021-09-16 10:11:33.897
6827,33,5098,대전,34,32,2,10957,2021-08-18 09:00:00.000,2021-09-16 10:11:33.897
6828,41,3735,울산,32,31,1,10956,2021-08-18 09:00:00.000,2021-09-16 10:11:33.897
6829,1,881,세종,6,6,0,10955,2021-08-18 09:00:00.000,2021-09-16 10:11:33.897
6830,710,64282,경기,515,509,6,10954,2021-08-18 09:00:00.000,2021-09-16 10:11:33.897
6831,58,5041,강원,40,40,0,10953,2021-08-18 09:00:00.000,2021-09-16 10:11:33.897
6832,71,4631,충북,33,32,1,10952,2021-08-18 09:00:00.000,2021-09-16 10:11:33.897
6833,46,6058,충남,70,70,0,10951,2021-08-18 09:00:00.000,2021-09-16 10:11:33.897
6834,60,3162,전북,20,19,1,10950,2021-08-18 09:00:00.000,2021-09-16 10:11:33.897
6835,19,2388,전남,34,32,2,10949,2021-08-18 09:00:00.000,2021-09-16 10:11:33.897
6836,88,6390,경북,37,35,2,10948,2021-08-18 09:00:00.000,2021-09-16 10:11:33.897
6837,26,9053,경남,105,104,1,10947,2021-08-18 09:00:00.000,2021-09-16 10:11:33.897
6838,1,2225,제주,46,45,1,10946,2021-08-18 09:00:00.000,2021-09-16 10:11:33.897
6839,13,5639,검역,14,0,14,10945,2021-08-18 09:00:00.000,2021-09-16 10:11:33.897
6840,2173,226845,합계,1372,1322,50,10944,2021-08-17 09:00:00.000,2021-09-16 10:11:33.897
6841,560,72081,서울,365,360,5,10943,2021-08-17 09:00:00.000,2021-09-16 10:11:33.897
6842,129,10196,부산,66,65,1,10942,2021-08-17 09:00:00.000,2021-09-16 10:11:33.897
6843,223,12724,대구,46,45,1,10941,2021-08-17 09:00:00.000,2021-09-16 10:11:33.897
6844,72,10520,인천,78,77,1,10940,2021-08-17 09:00:00.000,2021-09-16 10:11:33.897
6845,24,3727,광주,18,17,1,10939,2021-08-17 09:00:00.000,2021-09-16 10:11:33.897
6846,33,5064,대전,33,33,0,10938,2021-08-17 09:00:00.000,2021-09-16 10:11:33.897
6847,41,3703,울산,22,21,1,10937,2021-08-17 09:00:00.000,2021-09-16 10:11:33.897
6848,1,875,세종,3,3,0,10936,2021-08-17 09:00:00.000,2021-09-16 10:11:33.897
6849,710,63767,경기,385,372,13,10935,2021-08-17 09:00:00.000,2021-09-16 10:11:33.897
6850,57,5001,강원,26,23,3,10934,2021-08-17 09:00:00.000,2021-09-16 10:11:33.897
6851,71,4598,충북,43,43,0,10933,2021-08-17 09:00:00.000,2021-09-16 10:11:33.897
6852,46,5988,충남,42,42,0,10932,2021-08-17 09:00:00.000,2021-09-16 10:11:33.897
6853,60,3142,전북,25,22,3,10931,2021-08-17 09:00:00.000,2021-09-16 10:11:33.897
6854,19,2354,전남,25,22,3,10930,2021-08-17 09:00:00.000,2021-09-16 10:11:33.897
6855,88,6353,경북,38,37,1,10929,2021-08-17 09:00:00.000,2021-09-16 10:11:33.897
6856,25,8948,경남,106,103,3,10928,2021-08-17 09:00:00.000,2021-09-16 10:11:33.897
6857,1,2179,제주,37,37,0,10927,2021-08-17 09:00:00.000,2021-09-16 10:11:33.897
6858,13,5625,검역,14,0,14,10926,2021-08-17 09:00:00.000,2021-09-16 10:11:33.897
6859,2167,225473,합계,1555,1492,63,10925,2021-08-16 09:00:00.000,2021-09-16 10:11:33.897
6860,557,71716,서울,364,355,9,10924,2021-08-16 09:00:00.000,2021-09-16 10:11:33.897
6861,128,10130,부산,127,125,2,10923,2021-08-16 09:00:00.000,2021-09-16 10:11:33.897
6862,223,12678,대구,45,44,1,10922,2021-08-16 09:00:00.000,2021-09-16 10:11:33.897
6863,71,10442,인천,110,110,0,10921,2021-08-16 09:00:00.000,2021-09-16 10:11:33.897
6864,24,3709,광주,29,27,2,10920,2021-08-16 09:00:00.000,2021-09-16 10:11:33.897
6865,33,5031,대전,31,31,0,10919,2021-08-16 09:00:00.000,2021-09-16 10:11:33.897
6866,41,3681,울산,31,29,2,10918,2021-08-16 09:00:00.000,2021-09-16 10:11:33.897
6867,1,872,세종,3,3,0,10917,2021-08-16 09:00:00.000,2021-09-16 10:11:33.897
6868,709,63382,경기,396,392,4,10916,2021-08-16 09:00:00.000,2021-09-16 10:11:33.897
6869,57,4975,강원,41,40,1,10915,2021-08-16 09:00:00.000,2021-09-16 10:11:33.897
6870,71,4555,충북,37,37,0,10914,2021-08-16 09:00:00.000,2021-09-16 10:11:33.897
6871,46,5946,충남,43,40,3,10913,2021-08-16 09:00:00.000,2021-09-16 10:11:33.897
6872,60,3117,전북,14,11,3,10912,2021-08-16 09:00:00.000,2021-09-16 10:11:33.897
6873,19,2329,전남,27,25,2,10911,2021-08-16 09:00:00.000,2021-09-16 10:11:33.897
6874,88,6315,경북,75,75,0,10910,2021-08-16 09:00:00.000,2021-09-16 10:11:33.897
6875,25,8842,경남,86,84,2,10909,2021-08-16 09:00:00.000,2021-09-16 10:11:33.897
6876,1,2142,제주,65,64,1,10908,2021-08-16 09:00:00.000,2021-09-16 10:11:33.897
6877,13,5611,검역,31,0,31,10907,2021-08-16 09:00:00.000,2021-09-16 10:11:33.897
6878,2156,223918,합계,1816,1748,68,10906,2021-08-15 09:00:00.000,2021-09-16 10:11:33.897
6879,554,71352,서울,488,478,10,10905,2021-08-15 09:00:00.000,2021-09-16 10:11:33.897
6880,128,10003,부산,156,153,3,10904,2021-08-15 09:00:00.000,2021-09-16 10:11:33.897
6881,223,12633,대구,57,55,2,10903,2021-08-15 09:00:00.000,2021-09-16 10:11:33.897
6882,70,10332,인천,100,95,5,10902,2021-08-15 09:00:00.000,2021-09-16 10:11:33.897
6883,24,3680,광주,29,27,2,10901,2021-08-15 09:00:00.000,2021-09-16 10:11:33.897
6884,33,5000,대전,44,44,0,10900,2021-08-15 09:00:00.000,2021-09-16 10:11:33.897
6885,41,3650,울산,29,27,2,10899,2021-08-15 09:00:00.000,2021-09-16 10:11:33.897
6886,1,869,세종,5,5,0,10898,2021-08-15 09:00:00.000,2021-09-16 10:11:33.897
6887,705,62986,경기,510,505,5,10897,2021-08-15 09:00:00.000,2021-09-16 10:11:33.897
6888,57,4934,강원,31,31,0,10896,2021-08-15 09:00:00.000,2021-09-16 10:11:33.897
6889,71,4518,충북,44,42,2,10895,2021-08-15 09:00:00.000,2021-09-16 10:11:33.897
6890,46,5903,충남,62,57,5,10894,2021-08-15 09:00:00.000,2021-09-16 10:11:33.897
6891,60,3103,전북,12,10,2,10893,2021-08-15 09:00:00.000,2021-09-16 10:11:33.897
6892,18,2302,전남,18,17,1,10892,2021-08-15 09:00:00.000,2021-09-16 10:11:33.897
6893,88,6240,경북,76,74,2,10891,2021-08-15 09:00:00.000,2021-09-16 10:11:33.897
6894,24,8756,경남,93,90,3,10890,2021-08-15 09:00:00.000,2021-09-16 10:11:33.897
6895,1,2077,제주,38,38,0,10889,2021-08-15 09:00:00.000,2021-09-16 10:11:33.897
6896,12,5580,검역,24,0,24,10888,2021-08-15 09:00:00.000,2021-09-16 10:11:33.897
6897,2148,222102,합계,1928,1858,70,10887,2021-08-14 09:00:00.000,2021-09-16 10:11:33.897
6898,550,70864,서울,513,508,5,10886,2021-08-14 09:00:00.000,2021-09-16 10:11:33.897
6899,128,9847,부산,153,150,3,10885,2021-08-14 09:00:00.000,2021-09-16 10:11:33.897
6900,223,12576,대구,82,79,3,10884,2021-08-14 09:00:00.000,2021-09-16 10:11:33.897
6901,70,10232,인천,79,76,3,10883,2021-08-14 09:00:00.000,2021-09-16 10:11:33.897
6902,24,3651,광주,17,16,1,10882,2021-08-14 09:00:00.000,2021-09-16 10:11:33.897
6903,33,4956,대전,42,40,2,10881,2021-08-14 09:00:00.000,2021-09-16 10:11:33.897
6904,41,3621,울산,26,26,0,10880,2021-08-14 09:00:00.000,2021-09-16 10:11:33.897
6905,1,864,세종,10,10,0,10879,2021-08-14 09:00:00.000,2021-09-16 10:11:33.897
6906,701,62476,경기,573,560,13,10878,2021-08-14 09:00:00.000,2021-09-16 10:11:33.897
6907,57,4903,강원,39,39,0,10877,2021-08-14 09:00:00.000,2021-09-16 10:11:33.897
6908,71,4474,충북,45,42,3,10876,2021-08-14 09:00:00.000,2021-09-16 10:11:33.897
6909,46,5841,충남,64,57,7,10875,2021-08-14 09:00:00.000,2021-09-16 10:11:33.897
6910,60,3091,전북,21,20,1,10874,2021-08-14 09:00:00.000,2021-09-16 10:11:33.897
6911,18,2284,전남,28,27,1,10873,2021-08-14 09:00:00.000,2021-09-16 10:11:33.897
6912,88,6164,경북,54,52,2,10872,2021-08-14 09:00:00.000,2021-09-16 10:11:33.897
6913,24,8663,경남,103,101,2,10871,2021-08-14 09:00:00.000,2021-09-16 10:11:33.897
6914,1,2039,제주,55,55,0,10870,2021-08-14 09:00:00.000,2021-09-16 10:11:33.897
6915,12,5556,검역,24,0,24,10869,2021-08-14 09:00:00.000,2021-09-16 10:11:33.897
6916,2144,220174,합계,1989,1913,76,10868,2021-08-13 09:00:00.000,2021-09-16 10:11:33.897
6917,549,70351,서울,524,504,20,10867,2021-08-13 09:00:00.000,2021-09-16 10:11:33.897
6918,128,9694,부산,180,178,2,10866,2021-08-13 09:00:00.000,2021-09-16 10:11:33.897
6919,223,12494,대구,57,55,2,10865,2021-08-13 09:00:00.000,2021-09-16 10:11:33.897
6920,70,10153,인천,97,94,3,10864,2021-08-13 09:00:00.000,2021-09-16 10:11:33.897
6921,24,3634,광주,15,14,1,10863,2021-08-13 09:00:00.000,2021-09-16 10:11:33.897
6922,32,4914,대전,58,58,0,10862,2021-08-13 09:00:00.000,2021-09-16 10:11:33.897
6923,41,3595,울산,39,39,0,10861,2021-08-13 09:00:00.000,2021-09-16 10:11:33.897
6924,1,854,세종,7,7,0,10860,2021-08-13 09:00:00.000,2021-09-16 10:11:33.897
6925,700,61903,경기,540,527,13,10859,2021-08-13 09:00:00.000,2021-09-16 10:11:33.897
6926,57,4864,강원,33,33,0,10858,2021-08-13 09:00:00.000,2021-09-16 10:11:33.897
6927,71,4429,충북,52,50,2,10857,2021-08-13 09:00:00.000,2021-09-16 10:11:33.897
6928,46,5777,충남,72,68,4,10856,2021-08-13 09:00:00.000,2021-09-16 10:11:33.897
6929,60,3070,전북,27,25,2,10855,2021-08-13 09:00:00.000,2021-09-16 10:11:33.897
6930,18,2256,전남,18,18,0,10854,2021-08-13 09:00:00.000,2021-09-16 10:11:33.897
6931,88,6110,경북,82,77,5,10853,2021-08-13 09:00:00.000,2021-09-16 10:11:33.897
6932,23,8560,경남,125,122,3,10852,2021-08-13 09:00:00.000,2021-09-16 10:11:33.897
6933,1,1984,제주,44,44,0,10851,2021-08-13 09:00:00.000,2021-09-16 10:11:33.897
6934,12,5532,검역,19,0,19,10850,2021-08-13 09:00:00.000,2021-09-16 10:11:33.897
6935,2138,218185,합계,1987,1947,40,10849,2021-08-12 09:00:00.000,2021-09-16 10:11:33.897
6936,546,69827,서울,526,522,4,10848,2021-08-12 09:00:00.000,2021-09-16 10:11:33.897
6937,128,9514,부산,132,128,4,10847,2021-08-12 09:00:00.000,2021-09-16 10:11:33.897
6938,223,12437,대구,39,38,1,10846,2021-08-12 09:00:00.000,2021-09-16 10:11:33.897
6939,70,10056,인천,114,109,5,10845,2021-08-12 09:00:00.000,2021-09-16 10:11:33.897
6940,24,3619,광주,20,20,0,10844,2021-08-12 09:00:00.000,2021-09-16 10:11:33.897
6941,31,4856,대전,51,51,0,10843,2021-08-12 09:00:00.000,2021-09-16 10:11:33.897
6942,41,3556,울산,54,53,1,10842,2021-08-12 09:00:00.000,2021-09-16 10:11:33.897
6943,1,847,세종,11,11,0,10841,2021-08-12 09:00:00.000,2021-09-16 10:11:33.897
6944,698,61363,경기,575,570,5,10840,2021-08-12 09:00:00.000,2021-09-16 10:11:33.897
6945,57,4831,강원,42,41,1,10839,2021-08-12 09:00:00.000,2021-09-16 10:11:33.897
6946,71,4377,충북,75,75,0,10838,2021-08-12 09:00:00.000,2021-09-16 10:11:33.897
6947,46,5705,충남,85,84,1,10837,2021-08-12 09:00:00.000,2021-09-16 10:11:33.897
6948,60,3043,전북,24,24,0,10836,2021-08-12 09:00:00.000,2021-09-16 10:11:33.897
6949,18,2238,전남,27,27,0,10835,2021-08-12 09:00:00.000,2021-09-16 10:11:33.897
6950,88,6028,경북,63,63,0,10834,2021-08-12 09:00:00.000,2021-09-16 10:11:33.897
6951,23,8435,경남,110,108,2,10833,2021-08-12 09:00:00.000,2021-09-16 10:11:33.897
6952,1,1940,제주,23,23,0,10832,2021-08-12 09:00:00.000,2021-09-16 10:11:33.897
6953,12,5513,검역,16,0,16,10831,2021-08-12 09:00:00.000,2021-09-16 10:11:33.897
6954,2135,216198,합계,2221,2144,77,10830,2021-08-11 09:00:00.000,2021-09-16 10:11:33.897
6955,546,69301,서울,660,649,11,10829,2021-08-11 09:00:00.000,2021-09-16 10:11:33.897
6956,128,9382,부산,126,125,1,10828,2021-08-11 09:00:00.000,2021-09-16 10:11:33.897
6957,223,12398,대구,66,66,0,10827,2021-08-11 09:00:00.000,2021-09-16 10:11:33.897
6958,69,9942,인천,111,107,4,10826,2021-08-11 09:00:00.000,2021-09-16 10:11:33.897
6959,24,3599,광주,20,17,3,10825,2021-08-11 09:00:00.000,2021-09-16 10:11:33.897
6960,31,4805,대전,43,42,1,10824,2021-08-11 09:00:00.000,2021-09-16 10:11:33.897
6961,41,3502,울산,48,48,0,10823,2021-08-11 09:00:00.000,2021-09-16 10:11:33.897
6962,1,836,세종,8,8,0,10822,2021-08-11 09:00:00.000,2021-09-16 10:11:33.897
6963,696,60788,경기,666,648,18,10821,2021-08-11 09:00:00.000,2021-09-16 10:11:33.897
6964,57,4789,강원,19,19,0,10820,2021-08-11 09:00:00.000,2021-09-16 10:11:33.897
6965,71,4302,충북,56,54,2,10819,2021-08-11 09:00:00.000,2021-09-16 10:11:33.897
6966,46,5620,충남,86,84,2,10818,2021-08-11 09:00:00.000,2021-09-16 10:11:33.897
6967,60,3019,전북,31,28,3,10817,2021-08-11 09:00:00.000,2021-09-16 10:11:33.897
6968,18,2211,전남,18,16,2,10816,2021-08-11 09:00:00.000,2021-09-16 10:11:33.897
6969,88,5965,경북,67,66,1,10815,2021-08-11 09:00:00.000,2021-09-16 10:11:33.897
6970,23,8325,경남,141,139,2,10814,2021-08-11 09:00:00.000,2021-09-16 10:11:33.897
6971,1,1917,제주,28,28,0,10813,2021-08-11 09:00:00.000,2021-09-16 10:11:33.897
6972,12,5497,검역,27,0,27,10812,2021-08-11 09:00:00.000,2021-09-16 10:11:33.897
6973,2134,213977,합계,1537,1474,63,10811,2021-08-10 09:00:00.000,2021-09-16 10:11:33.897
6974,545,68641,서울,359,355,4,10810,2021-08-10 09:00:00.000,2021-09-16 10:11:33.897
6975,128,9256,부산,105,105,0,10809,2021-08-10 09:00:00.000,2021-09-16 10:11:33.897
6976,223,12332,대구,80,78,2,10808,2021-08-10 09:00:00.000,2021-09-16 10:11:33.897
6977,69,9831,인천,66,64,2,10807,2021-08-10 09:00:00.000,2021-09-16 10:11:33.897
6978,24,3579,광주,15,13,2,10806,2021-08-10 09:00:00.000,2021-09-16 10:11:33.897
6979,31,4762,대전,51,49,2,10805,2021-08-10 09:00:00.000,2021-09-16 10:11:33.897
6980,41,3454,울산,51,50,1,10804,2021-08-10 09:00:00.000,2021-09-16 10:11:33.897
6981,1,828,세종,4,4,0,10803,2021-08-10 09:00:00.000,2021-09-16 10:11:33.897
6982,696,60122,경기,420,398,22,10802,2021-08-10 09:00:00.000,2021-09-16 10:11:33.897
6983,57,4770,강원,22,22,0,10801,2021-08-10 09:00:00.000,2021-09-16 10:11:33.897
6984,71,4246,충북,47,41,6,10800,2021-08-10 09:00:00.000,2021-09-16 10:11:33.897
6985,46,5534,충남,66,66,0,10799,2021-08-10 09:00:00.000,2021-09-16 10:11:33.897
6986,60,2988,전북,31,28,3,10798,2021-08-10 09:00:00.000,2021-09-16 10:11:33.897
6987,18,2193,전남,26,24,2,10797,2021-08-10 09:00:00.000,2021-09-16 10:11:33.897
6988,88,5898,경북,59,57,2,10796,2021-08-10 09:00:00.000,2021-09-16 10:11:33.897
6989,23,8184,경남,110,110,0,10795,2021-08-10 09:00:00.000,2021-09-16 10:11:33.897
6990,1,1889,제주,12,10,2,10794,2021-08-10 09:00:00.000,2021-09-16 10:11:33.897
6991,12,5470,검역,13,0,13,10793,2021-08-10 09:00:00.000,2021-09-16 10:11:33.897
6992,2125,212440,합계,1491,1455,36,10792,2021-08-09 09:00:00.000,2021-09-16 10:11:33.897
6993,543,68282,서울,415,414,1,10791,2021-08-09 09:00:00.000,2021-09-16 10:11:33.897
6994,128,9151,부산,123,121,2,10790,2021-08-09 09:00:00.000,2021-09-16 10:11:33.897
6995,223,12252,대구,86,82,4,10789,2021-08-09 09:00:00.000,2021-09-16 10:11:33.897
6996,67,9765,인천,65,65,0,10788,2021-08-09 09:00:00.000,2021-09-16 10:11:33.897
6997,24,3564,광주,19,15,4,10787,2021-08-09 09:00:00.000,2021-09-16 10:11:33.897
6998,31,4711,대전,42,42,0,10786,2021-08-09 09:00:00.000,2021-09-16 10:11:33.897
6999,41,3403,울산,25,25,0,10785,2021-08-09 09:00:00.000,2021-09-16 10:11:33.897
7000,1,824,세종,1,1,0,10784,2021-08-09 09:00:00.000,2021-09-16 10:11:33.897
7001,692,59702,경기,408,402,6,10783,2021-08-09 09:00:00.000,2021-09-16 10:11:33.897
7002,57,4748,강원,24,23,1,10782,2021-08-09 09:00:00.000,2021-09-16 10:11:33.897
7003,71,4199,충북,38,38,0,10781,2021-08-09 09:00:00.000,2021-09-16 10:11:33.897
7004,46,5468,충남,68,65,3,10780,2021-08-09 09:00:00.000,2021-09-16 10:11:33.897
7005,60,2957,전북,21,20,1,10779,2021-08-09 09:00:00.000,2021-09-16 10:11:33.897
7006,18,2167,전남,14,14,0,10778,2021-08-09 09:00:00.000,2021-09-16 10:11:33.897
7007,87,5839,경북,30,30,0,10777,2021-08-09 09:00:00.000,2021-09-16 10:11:33.897
7008,23,8074,경남,88,87,1,10776,2021-08-09 09:00:00.000,2021-09-16 10:11:33.897
7009,1,1877,제주,11,11,0,10775,2021-08-09 09:00:00.000,2021-09-16 10:11:33.897
7010,12,5457,검역,13,0,13,10774,2021-08-09 09:00:00.000,2021-09-16 10:11:33.897
7011,2121,210949,합계,1728,1669,59,10773,2021-08-08 09:00:00.000,2021-09-16 10:11:33.897
7012,542,67867,서울,450,441,9,10772,2021-08-08 09:00:00.000,2021-09-16 10:11:33.897
7013,128,9028,부산,147,145,2,10771,2021-08-08 09:00:00.000,2021-09-16 10:11:33.897
7014,223,12166,대구,63,57,6,10770,2021-08-08 09:00:00.000,2021-09-16 10:11:33.897
7015,66,9700,인천,75,70,5,10769,2021-08-08 09:00:00.000,2021-09-16 10:11:33.897
7016,24,3545,광주,32,29,3,10768,2021-08-08 09:00:00.000,2021-09-16 10:11:33.897
7017,31,4669,대전,33,33,0,10767,2021-08-08 09:00:00.000,2021-09-16 10:11:33.897
7018,41,3378,울산,58,58,0,10766,2021-08-08 09:00:00.000,2021-09-16 10:11:33.897
7019,1,823,세종,7,7,0,10765,2021-08-08 09:00:00.000,2021-09-16 10:11:33.897
7020,690,59294,경기,462,455,7,10764,2021-08-08 09:00:00.000,2021-09-16 10:11:33.897
7021,57,4724,강원,25,25,0,10763,2021-08-08 09:00:00.000,2021-09-16 10:11:33.897
7022,71,4161,충북,55,54,1,10762,2021-08-08 09:00:00.000,2021-09-16 10:11:33.897
7023,46,5400,충남,86,82,4,10761,2021-08-08 09:00:00.000,2021-09-16 10:11:33.897
7024,60,2936,전북,20,20,0,10760,2021-08-08 09:00:00.000,2021-09-16 10:11:33.897
7025,18,2153,전남,20,18,2,10759,2021-08-08 09:00:00.000,2021-09-16 10:11:33.897
7026,87,5809,경북,56,53,3,10758,2021-08-08 09:00:00.000,2021-09-16 10:11:33.897
7027,23,7986,경남,118,117,1,10757,2021-08-08 09:00:00.000,2021-09-16 10:11:33.897
7028,1,1866,제주,5,5,0,10756,2021-08-08 09:00:00.000,2021-09-16 10:11:33.897
7029,12,5444,검역,16,0,16,10755,2021-08-08 09:00:00.000,2021-09-16 10:11:33.897
7030,2116,209221,합계,1823,1762,61,10754,2021-08-07 09:00:00.000,2021-09-16 10:11:33.897
7031,540,67417,서울,503,498,5,10753,2021-08-07 09:00:00.000,2021-09-16 10:11:33.897
7032,128,8881,부산,146,144,2,10752,2021-08-07 09:00:00.000,2021-09-16 10:11:33.897
7033,222,12103,대구,68,66,2,10751,2021-08-07 09:00:00.000,2021-09-16 10:11:33.897
7034,66,9625,인천,90,90,0,10750,2021-08-07 09:00:00.000,2021-09-16 10:11:33.897
7035,24,3513,광주,18,16,2,10749,2021-08-07 09:00:00.000,2021-09-16 10:11:33.897
7036,31,4636,대전,57,57,0,10748,2021-08-07 09:00:00.000,2021-09-16 10:11:33.897
7037,41,3320,울산,21,21,0,10747,2021-08-07 09:00:00.000,2021-09-16 10:11:33.897
7038,1,816,세종,18,17,1,10746,2021-08-07 09:00:00.000,2021-09-16 10:11:33.897
7039,688,58832,경기,514,501,13,10745,2021-08-07 09:00:00.000,2021-09-16 10:11:33.897
7040,57,4699,강원,33,33,0,10744,2021-08-07 09:00:00.000,2021-09-16 10:11:33.897
7041,71,4106,충북,43,42,1,10743,2021-08-07 09:00:00.000,2021-09-16 10:11:33.897
7042,46,5314,충남,54,52,2,10742,2021-08-07 09:00:00.000,2021-09-16 10:11:33.897
7043,60,2916,전북,20,18,2,10741,2021-08-07 09:00:00.000,2021-09-16 10:11:33.897
7044,18,2133,전남,20,16,4,10740,2021-08-07 09:00:00.000,2021-09-16 10:11:33.897
7045,87,5753,경북,49,48,1,10739,2021-08-07 09:00:00.000,2021-09-16 10:11:33.897
7046,23,7868,경남,131,130,1,10738,2021-08-07 09:00:00.000,2021-09-16 10:11:33.897
7047,1,1861,제주,13,13,0,10737,2021-08-07 09:00:00.000,2021-09-16 10:11:33.897
7048,12,5428,검역,25,0,25,10736,2021-08-07 09:00:00.000,2021-09-16 10:11:33.897
7049,2113,207398,합계,1704,1640,64,10735,2021-08-06 09:00:00.000,2021-09-16 10:11:33.897
7050,540,66914,서울,464,460,4,10734,2021-08-06 09:00:00.000,2021-09-16 10:11:33.897
7051,128,8735,부산,107,105,2,10733,2021-08-06 09:00:00.000,2021-09-16 10:11:33.897
7052,222,12035,대구,84,83,1,10732,2021-08-06 09:00:00.000,2021-09-16 10:11:33.897
7053,66,9535,인천,103,101,2,10731,2021-08-06 09:00:00.000,2021-09-16 10:11:33.897
7054,24,3495,광주,14,13,1,10730,2021-08-06 09:00:00.000,2021-09-16 10:11:33.897
7055,30,4579,대전,50,50,0,10729,2021-08-06 09:00:00.000,2021-09-16 10:11:33.897
7056,41,3299,울산,24,23,1,10728,2021-08-06 09:00:00.000,2021-09-16 10:11:33.897
7057,1,798,세종,20,15,5,10727,2021-08-06 09:00:00.000,2021-09-16 10:11:33.897
7058,687,58318,경기,462,451,11,10726,2021-08-06 09:00:00.000,2021-09-16 10:11:33.897
7059,57,4666,강원,26,26,0,10725,2021-08-06 09:00:00.000,2021-09-16 10:11:33.897
7060,71,4063,충북,41,38,3,10724,2021-08-06 09:00:00.000,2021-09-16 10:11:33.897
7061,46,5260,충남,53,52,1,10723,2021-08-06 09:00:00.000,2021-09-16 10:11:33.897
7062,60,2896,전북,34,33,1,10722,2021-08-06 09:00:00.000,2021-09-16 10:11:33.897
7063,17,2113,전남,24,24,0,10721,2021-08-06 09:00:00.000,2021-09-16 10:11:33.897
7064,87,5704,경북,56,52,4,10720,2021-08-06 09:00:00.000,2021-09-16 10:11:33.897
7065,23,7737,경남,98,98,0,10719,2021-08-06 09:00:00.000,2021-09-16 10:11:33.897
7066,1,1848,제주,16,16,0,10718,2021-08-06 09:00:00.000,2021-09-16 10:11:33.897
7067,12,5403,검역,28,0,28,10717,2021-08-06 09:00:00.000,2021-09-16 10:11:33.897
7068,2109,205694,합계,1775,1716,59,10716,2021-08-05 09:00:00.000,2021-09-16 10:11:33.897
7069,539,66450,서울,466,461,5,10715,2021-08-05 09:00:00.000,2021-09-16 10:11:33.897
7070,128,8628,부산,112,111,1,10714,2021-08-05 09:00:00.000,2021-09-16 10:11:33.897
7071,222,11951,대구,121,120,1,10713,2021-08-05 09:00:00.000,2021-09-16 10:11:33.897
7072,66,9432,인천,90,89,1,10712,2021-08-05 09:00:00.000,2021-09-16 10:11:33.897
7073,24,3481,광주,17,17,0,10711,2021-08-05 09:00:00.000,2021-09-16 10:11:33.897
7074,30,4529,대전,70,70,0,10710,2021-08-05 09:00:00.000,2021-09-16 10:11:33.897
7075,41,3275,울산,13,13,0,10709,2021-08-05 09:00:00.000,2021-09-16 10:11:33.897
7076,1,778,세종,15,14,1,10708,2021-08-05 09:00:00.000,2021-09-16 10:11:33.897
7077,686,57856,경기,486,474,12,10707,2021-08-05 09:00:00.000,2021-09-16 10:11:33.897
7078,56,4640,강원,31,30,1,10706,2021-08-05 09:00:00.000,2021-09-16 10:11:33.897
7079,71,4022,충북,45,45,0,10705,2021-08-05 09:00:00.000,2021-09-16 10:11:33.897
7080,45,5207,충남,71,70,1,10704,2021-08-05 09:00:00.000,2021-09-16 10:11:33.897
7081,60,2862,전북,19,19,0,10703,2021-08-05 09:00:00.000,2021-09-16 10:11:33.897
7082,17,2089,전남,20,20,0,10702,2021-08-05 09:00:00.000,2021-09-16 10:11:33.897
7083,87,5648,경북,60,59,1,10701,2021-08-05 09:00:00.000,2021-09-16 10:11:33.897
7084,23,7639,경남,82,81,1,10700,2021-08-05 09:00:00.000,2021-09-16 10:11:33.897
7085,1,1832,제주,24,23,1,10699,2021-08-05 09:00:00.000,2021-09-16 10:11:33.897
7086,12,5375,검역,33,0,33,10698,2021-08-05 09:00:00.000,2021-09-16 10:11:33.897
7087,2106,203919,합계,1725,1664,61,10697,2021-08-04 09:00:00.000,2021-09-16 10:11:33.897
7088,537,65984,서울,486,479,7,10696,2021-08-04 09:00:00.000,2021-09-16 10:11:33.897
7089,128,8516,부산,111,108,3,10695,2021-08-04 09:00:00.000,2021-09-16 10:11:33.897
7090,222,11830,대구,75,75,0,10694,2021-08-04 09:00:00.000,2021-09-16 10:11:33.897
7091,66,9342,인천,83,83,0,10693,2021-08-04 09:00:00.000,2021-09-16 10:11:33.897
7092,24,3464,광주,16,15,1,10692,2021-08-04 09:00:00.000,2021-09-16 10:11:33.897
7093,30,4459,대전,59,59,0,10691,2021-08-04 09:00:00.000,2021-09-16 10:11:33.897
7094,41,3262,울산,15,14,1,10690,2021-08-04 09:00:00.000,2021-09-16 10:11:33.897
7095,1,763,세종,8,8,0,10689,2021-08-04 09:00:00.000,2021-09-16 10:11:33.897
7096,685,57370,경기,487,474,13,10688,2021-08-04 09:00:00.000,2021-09-16 10:11:33.897
7097,56,4609,강원,22,22,0,10687,2021-08-04 09:00:00.000,2021-09-16 10:11:33.897
7098,71,3977,충북,45,45,0,10686,2021-08-04 09:00:00.000,2021-09-16 10:11:33.897
7099,45,5136,충남,55,52,3,10685,2021-08-04 09:00:00.000,2021-09-16 10:11:33.897
7100,60,2843,전북,33,33,0,10684,2021-08-04 09:00:00.000,2021-09-16 10:11:33.897
7101,17,2069,전남,15,15,0,10683,2021-08-04 09:00:00.000,2021-09-16 10:11:33.897
7102,87,5588,경북,48,46,2,10682,2021-08-04 09:00:00.000,2021-09-16 10:11:33.897
7103,23,7557,경남,114,113,1,10681,2021-08-04 09:00:00.000,2021-09-16 10:11:33.897
7104,1,1808,제주,23,23,0,10680,2021-08-04 09:00:00.000,2021-09-16 10:11:33.897
7105,12,5342,검역,30,0,30,10679,2021-08-04 09:00:00.000,2021-09-16 10:11:33.897
7106,2104,202194,합계,1200,1150,50,10678,2021-08-03 09:00:00.000,2021-09-16 10:11:33.897
7107,537,65498,서울,311,307,4,10677,2021-08-03 09:00:00.000,2021-09-16 10:11:33.897
7108,128,8405,부산,69,67,2,10676,2021-08-03 09:00:00.000,2021-09-16 10:11:33.897
7109,222,11755,대구,37,37,0,10675,2021-08-03 09:00:00.000,2021-09-16 10:11:33.897
7110,65,9259,인천,48,46,2,10674,2021-08-03 09:00:00.000,2021-09-16 10:11:33.897
7111,24,3448,광주,18,17,1,10673,2021-08-03 09:00:00.000,2021-09-16 10:11:33.897
7112,30,4400,대전,78,78,0,10672,2021-08-03 09:00:00.000,2021-09-16 10:11:33.897
7113,41,3247,울산,8,8,0,10671,2021-08-03 09:00:00.000,2021-09-16 10:11:33.897
7114,1,755,세종,7,6,1,10670,2021-08-03 09:00:00.000,2021-09-16 10:11:33.897
7115,684,56883,경기,360,344,16,10669,2021-08-03 09:00:00.000,2021-09-16 10:11:33.897
7116,56,4587,강원,25,21,4,10668,2021-08-03 09:00:00.000,2021-09-16 10:11:33.897
7117,71,3932,충북,39,38,1,10667,2021-08-03 09:00:00.000,2021-09-16 10:11:33.897
7118,45,5081,충남,51,49,2,10666,2021-08-03 09:00:00.000,2021-09-16 10:11:33.897
7119,60,2810,전북,16,16,0,10665,2021-08-03 09:00:00.000,2021-09-16 10:11:33.897
7120,17,2054,전남,4,4,0,10664,2021-08-03 09:00:00.000,2021-09-16 10:11:33.897
7121,87,5540,경북,25,22,3,10663,2021-08-03 09:00:00.000,2021-09-16 10:11:33.897
7122,23,7443,경남,72,70,2,10662,2021-08-03 09:00:00.000,2021-09-16 10:11:33.897
7123,1,1785,제주,21,20,1,10661,2021-08-03 09:00:00.000,2021-09-16 10:11:33.897
7124,12,5312,검역,11,0,11,10660,2021-08-03 09:00:00.000,2021-09-16 10:11:33.897
7125,2099,200994,합계,1218,1150,68,10659,2021-08-02 09:00:00.000,2021-09-16 10:11:33.897
7126,535,65187,서울,364,362,2,10658,2021-08-02 09:00:00.000,2021-09-16 10:11:33.897
7127,128,8336,부산,72,68,4,10657,2021-08-02 09:00:00.000,2021-09-16 10:11:33.897
7128,222,11718,대구,26,26,0,10656,2021-08-02 09:00:00.000,2021-09-16 10:11:33.897
7129,64,9211,인천,62,59,3,10655,2021-08-02 09:00:00.000,2021-09-16 10:11:33.897
7130,24,3430,광주,17,16,1,10654,2021-08-02 09:00:00.000,2021-09-16 10:11:33.897
7131,30,4322,대전,64,62,2,10653,2021-08-02 09:00:00.000,2021-09-16 10:11:33.897
7132,41,3239,울산,13,12,1,10652,2021-08-02 09:00:00.000,2021-09-16 10:11:33.897
7133,1,748,세종,3,2,1,10651,2021-08-02 09:00:00.000,2021-09-16 10:11:33.897
7134,684,56523,경기,337,328,9,10650,2021-08-02 09:00:00.000,2021-09-16 10:11:33.897
7135,56,4562,강원,25,24,1,10649,2021-08-02 09:00:00.000,2021-09-16 10:11:33.897
7136,71,3893,충북,26,26,0,10648,2021-08-02 09:00:00.000,2021-09-16 10:11:33.897
7137,45,5030,충남,38,35,3,10647,2021-08-02 09:00:00.000,2021-09-16 10:11:33.897
7138,60,2794,전북,13,11,2,10646,2021-08-02 09:00:00.000,2021-09-16 10:11:33.897
7139,17,2050,전남,6,3,3,10645,2021-08-02 09:00:00.000,2021-09-16 10:11:33.897
7140,87,5515,경북,31,27,4,10644,2021-08-02 09:00:00.000,2021-09-16 10:11:33.897
7141,22,7371,경남,84,77,7,10643,2021-08-02 09:00:00.000,2021-09-16 10:11:33.897
7142,1,1764,제주,12,12,0,10642,2021-08-02 09:00:00.000,2021-09-16 10:11:33.897
7143,11,5301,검역,25,0,25,10641,2021-08-02 09:00:00.000,2021-09-16 10:11:33.897
7144,2098,199776,합계,1442,1386,56,10640,2021-08-01 09:00:00.000,2021-09-16 10:11:33.897
7145,535,64823,서울,473,469,4,10639,2021-08-01 09:00:00.000,2021-09-16 10:11:33.897
7146,128,8264,부산,58,57,1,10638,2021-08-01 09:00:00.000,2021-09-16 10:11:33.897
7147,222,11692,대구,23,23,0,10637,2021-08-01 09:00:00.000,2021-09-16 10:11:33.897
7148,64,9149,인천,89,87,2,10636,2021-08-01 09:00:00.000,2021-09-16 10:11:33.897
7149,24,3413,광주,14,12,2,10635,2021-08-01 09:00:00.000,2021-09-16 10:11:33.897
7150,30,4258,대전,69,67,2,10634,2021-08-01 09:00:00.000,2021-09-16 10:11:33.897
7151,41,3226,울산,20,19,1,10633,2021-08-01 09:00:00.000,2021-09-16 10:11:33.897
7152,1,745,세종,9,9,0,10632,2021-08-01 09:00:00.000,2021-09-16 10:11:33.897
7153,684,56186,경기,406,393,13,10631,2021-08-01 09:00:00.000,2021-09-16 10:11:33.897
7154,55,4537,강원,44,44,0,10630,2021-08-01 09:00:00.000,2021-09-16 10:11:33.897
7155,71,3867,충북,17,15,2,10629,2021-08-01 09:00:00.000,2021-09-16 10:11:33.897
7156,45,4992,충남,46,42,4,10628,2021-08-01 09:00:00.000,2021-09-16 10:11:33.897
7157,60,2781,전북,14,13,1,10627,2021-08-01 09:00:00.000,2021-09-16 10:11:33.897
7158,17,2044,전남,9,9,0,10626,2021-08-01 09:00:00.000,2021-09-16 10:11:33.897
7159,87,5484,경북,28,26,2,10625,2021-08-01 09:00:00.000,2021-09-16 10:11:33.897
7160,22,7287,경남,84,81,3,10624,2021-08-01 09:00:00.000,2021-09-16 10:11:33.897
7161,1,1752,제주,20,20,0,10623,2021-08-01 09:00:00.000,2021-09-16 10:11:33.897
7162,11,5276,검역,19,0,19,10622,2021-08-01 09:00:00.000,2021-09-16 10:11:33.897
7163,2095,198334,합계,1538,1465,73,10621,2021-07-31 09:00:00.000,2021-09-16 10:11:33.897
7164,534,64350,서울,475,467,8,10620,2021-07-31 09:00:00.000,2021-09-16 10:11:33.897
7165,128,8206,부산,72,69,3,10619,2021-07-31 09:00:00.000,2021-09-16 10:11:33.897
7166,222,11669,대구,46,43,3,10618,2021-07-31 09:00:00.000,2021-09-16 10:11:33.897
7167,64,9060,인천,96,87,9,10617,2021-07-31 09:00:00.000,2021-09-16 10:11:33.897
7168,24,3399,광주,22,20,2,10616,2021-07-31 09:00:00.000,2021-09-16 10:11:33.897
7169,30,4189,대전,86,86,0,10615,2021-07-31 09:00:00.000,2021-09-16 10:11:33.897
7170,41,3206,울산,17,16,1,10614,2021-07-31 09:00:00.000,2021-09-16 10:11:33.897
7171,1,736,세종,12,12,0,10613,2021-07-31 09:00:00.000,2021-09-16 10:11:33.897
7172,683,55780,경기,395,383,12,10612,2021-07-31 09:00:00.000,2021-09-16 10:11:33.897
7173,55,4493,강원,39,37,2,10611,2021-07-31 09:00:00.000,2021-09-16 10:11:33.897
7174,71,3850,충북,19,18,1,10610,2021-07-31 09:00:00.000,2021-09-16 10:11:33.897
7175,45,4946,충남,63,62,1,10609,2021-07-31 09:00:00.000,2021-09-16 10:11:33.897
7176,60,2767,전북,14,11,3,10608,2021-07-31 09:00:00.000,2021-09-16 10:11:33.897
7177,17,2035,전남,13,12,1,10607,2021-07-31 09:00:00.000,2021-09-16 10:11:33.897
7178,87,5456,경북,19,19,0,10606,2021-07-31 09:00:00.000,2021-09-16 10:11:33.897
7179,22,7203,경남,99,97,2,10605,2021-07-31 09:00:00.000,2021-09-16 10:11:33.897
7180,1,1732,제주,26,26,0,10604,2021-07-31 09:00:00.000,2021-09-16 10:11:33.897
7181,10,5257,검역,25,0,25,10603,2021-07-31 09:00:00.000,2021-09-16 10:11:33.897
7182,2089,196796,합계,1710,1662,48,10602,2021-07-30 09:00:00.000,2021-09-16 10:11:33.897
7183,532,63875,서울,488,487,1,10601,2021-07-30 09:00:00.000,2021-09-16 10:11:33.897
7184,128,8134,부산,78,77,1,10600,2021-07-30 09:00:00.000,2021-09-16 10:11:33.897
7185,222,11623,대구,62,61,1,10599,2021-07-30 09:00:00.000,2021-09-16 10:11:33.897
7186,62,8964,인천,119,112,7,10598,2021-07-30 09:00:00.000,2021-09-16 10:11:33.897
7187,24,3377,광주,25,24,1,10597,2021-07-30 09:00:00.000,2021-09-16 10:11:33.897
7188,29,4103,대전,85,84,1,10596,2021-07-30 09:00:00.000,2021-09-16 10:11:33.897
7189,41,3189,울산,18,17,1,10595,2021-07-30 09:00:00.000,2021-09-16 10:11:33.897
7190,1,724,세종,4,4,0,10594,2021-07-30 09:00:00.000,2021-09-16 10:11:33.897
7191,682,55385,경기,524,515,9,10593,2021-07-30 09:00:00.000,2021-09-16 10:11:33.897
7192,55,4454,강원,20,20,0,10592,2021-07-30 09:00:00.000,2021-09-16 10:11:33.897
7193,71,3831,충북,37,34,3,10591,2021-07-30 09:00:00.000,2021-09-16 10:11:33.897
7194,45,4883,충남,37,36,1,10590,2021-07-30 09:00:00.000,2021-09-16 10:11:33.897
7195,60,2753,전북,23,21,2,10589,2021-07-30 09:00:00.000,2021-09-16 10:11:33.897
7196,17,2022,전남,19,17,2,10588,2021-07-30 09:00:00.000,2021-09-16 10:11:33.897
7197,87,5437,경북,37,37,0,10587,2021-07-30 09:00:00.000,2021-09-16 10:11:33.897
7198,22,7104,경남,99,98,1,10586,2021-07-30 09:00:00.000,2021-09-16 10:11:33.897
7199,1,1706,제주,18,18,0,10585,2021-07-30 09:00:00.000,2021-09-16 10:11:33.897
7200,10,5232,검역,17,0,17,10584,2021-07-30 09:00:00.000,2021-09-16 10:11:33.897
7201,2085,195086,합계,1673,1631,42,10583,2021-07-29 09:00:00.000,2021-09-16 10:11:33.897
7202,532,63387,서울,514,507,7,10582,2021-07-29 09:00:00.000,2021-09-16 10:11:33.897
7203,127,8056,부산,82,81,1,10581,2021-07-29 09:00:00.000,2021-09-16 10:11:33.897
7204,222,11561,대구,56,56,0,10580,2021-07-29 09:00:00.000,2021-09-16 10:11:33.897
7205,61,8845,인천,96,94,2,10579,2021-07-29 09:00:00.000,2021-09-16 10:11:33.897
7206,24,3352,광주,39,39,0,10578,2021-07-29 09:00:00.000,2021-09-16 10:11:33.897
7207,29,4018,대전,69,69,0,10577,2021-07-29 09:00:00.000,2021-09-16 10:11:33.897
7208,41,3171,울산,14,14,0,10576,2021-07-29 09:00:00.000,2021-09-16 10:11:33.897
7209,1,720,세종,5,5,0,10575,2021-07-29 09:00:00.000,2021-09-16 10:11:33.897
7210,681,54861,경기,469,460,9,10574,2021-07-29 09:00:00.000,2021-09-16 10:11:33.897
7211,55,4434,강원,47,46,1,10573,2021-07-29 09:00:00.000,2021-09-16 10:11:33.897
7212,71,3794,충북,30,30,0,10572,2021-07-29 09:00:00.000,2021-09-16 10:11:33.897
7213,45,4846,충남,47,46,1,10571,2021-07-29 09:00:00.000,2021-09-16 10:11:33.897
7214,60,2730,전북,31,30,1,10570,2021-07-29 09:00:00.000,2021-09-16 10:11:33.897
7215,17,2003,전남,20,18,2,10569,2021-07-29 09:00:00.000,2021-09-16 10:11:33.897
7216,87,5400,경북,22,22,0,10568,2021-07-29 09:00:00.000,2021-09-16 10:11:33.897
7217,22,7005,경남,90,90,0,10567,2021-07-29 09:00:00.000,2021-09-16 10:11:33.897
7218,1,1688,제주,24,24,0,10566,2021-07-29 09:00:00.000,2021-09-16 10:11:33.897
7219,9,5215,검역,18,0,18,10565,2021-07-29 09:00:00.000,2021-09-16 10:11:33.897
7220,2083,193413,합계,1895,1822,73,10564,2021-07-28 09:00:00.000,2021-09-16 10:11:33.897
7221,531,62873,서울,573,568,5,10563,2021-07-28 09:00:00.000,2021-09-16 10:11:33.897
7222,127,7974,부산,102,99,3,10562,2021-07-28 09:00:00.000,2021-09-16 10:11:33.897
7223,222,11505,대구,55,54,1,10561,2021-07-28 09:00:00.000,2021-09-16 10:11:33.897
7224,61,8749,인천,102,101,1,10560,2021-07-28 09:00:00.000,2021-09-16 10:11:33.897
7225,24,3313,광주,27,25,2,10559,2021-07-28 09:00:00.000,2021-09-16 10:11:33.897
7226,29,3949,대전,75,74,1,10558,2021-07-28 09:00:00.000,2021-09-16 10:11:33.897
7227,41,3157,울산,18,17,1,10557,2021-07-28 09:00:00.000,2021-09-16 10:11:33.897
7228,1,715,세종,11,11,0,10556,2021-07-28 09:00:00.000,2021-09-16 10:11:33.897
7229,680,54392,경기,556,542,14,10555,2021-07-28 09:00:00.000,2021-09-16 10:11:33.897
7230,55,4387,강원,74,74,0,10554,2021-07-28 09:00:00.000,2021-09-16 10:11:33.897
7231,71,3764,충북,40,40,0,10553,2021-07-28 09:00:00.000,2021-09-16 10:11:33.897
7232,45,4799,충남,31,30,1,10552,2021-07-28 09:00:00.000,2021-09-16 10:11:33.897
7233,60,2699,전북,23,22,1,10551,2021-07-28 09:00:00.000,2021-09-16 10:11:33.897
7234,17,1983,전남,20,17,3,10550,2021-07-28 09:00:00.000,2021-09-16 10:11:33.897
7235,87,5378,경북,33,32,1,10549,2021-07-28 09:00:00.000,2021-09-16 10:11:33.897
7236,22,6915,경남,98,93,5,10548,2021-07-28 09:00:00.000,2021-09-16 10:11:33.897
7237,1,1664,제주,23,23,0,10547,2021-07-28 09:00:00.000,2021-09-16 10:11:33.897
7238,9,5197,검역,34,0,34,10546,2021-07-28 09:00:00.000,2021-09-16 10:11:33.897
7239,2079,191518,합계,1363,1274,89,10545,2021-07-27 09:00:00.000,2021-09-16 10:11:33.897
7240,529,62300,서울,351,349,2,10544,2021-07-27 09:00:00.000,2021-09-16 10:11:33.897
7241,127,7872,부산,66,64,2,10543,2021-07-27 09:00:00.000,2021-09-16 10:11:33.897
7242,222,11450,대구,69,66,3,10542,2021-07-27 09:00:00.000,2021-09-16 10:11:33.897
7243,61,8647,인천,65,58,7,10541,2021-07-27 09:00:00.000,2021-09-16 10:11:33.897
7244,24,3286,광주,23,22,1,10540,2021-07-27 09:00:00.000,2021-09-16 10:11:33.897
7245,28,3874,대전,71,71,0,10539,2021-07-27 09:00:00.000,2021-09-16 10:11:33.897
7246,41,3139,울산,5,5,0,10538,2021-07-27 09:00:00.000,2021-09-16 10:11:33.897
7247,1,704,세종,6,3,3,10537,2021-07-27 09:00:00.000,2021-09-16 10:11:33.897
7248,679,53836,경기,373,362,11,10536,2021-07-27 09:00:00.000,2021-09-16 10:11:33.897
7249,55,4313,강원,61,60,1,10535,2021-07-27 09:00:00.000,2021-09-16 10:11:33.897
7250,71,3724,충북,13,12,1,10534,2021-07-27 09:00:00.000,2021-09-16 10:11:33.897
7251,45,4768,충남,38,37,1,10533,2021-07-27 09:00:00.000,2021-09-16 10:11:33.897
7252,60,2676,전북,32,30,2,10532,2021-07-27 09:00:00.000,2021-09-16 10:11:33.897
7253,17,1963,전남,15,15,0,10531,2021-07-27 09:00:00.000,2021-09-16 10:11:33.897
7254,87,5345,경북,25,20,5,10530,2021-07-27 09:00:00.000,2021-09-16 10:11:33.897
7255,22,6817,경남,88,85,3,10529,2021-07-27 09:00:00.000,2021-09-16 10:11:33.897
7256,1,1641,제주,17,15,2,10528,2021-07-27 09:00:00.000,2021-09-16 10:11:33.897
7257,9,5163,검역,45,0,45,10527,2021-07-27 09:00:00.000,2021-09-16 10:11:33.897
7258,2077,190155,합계,1318,1264,54,10526,2021-07-26 09:00:00.000,2021-09-16 10:11:33.897
7259,529,61949,서울,341,339,2,10525,2021-07-26 09:00:00.000,2021-09-16 10:11:33.897
7260,127,7806,부산,89,83,6,10524,2021-07-26 09:00:00.000,2021-09-16 10:11:33.897
7261,222,11381,대구,60,60,0,10523,2021-07-26 09:00:00.000,2021-09-16 10:11:33.897
7262,61,8582,인천,71,67,4,10522,2021-07-26 09:00:00.000,2021-09-16 10:11:33.897
7263,24,3263,광주,18,17,1,10521,2021-07-26 09:00:00.000,2021-09-16 10:11:33.897
7264,28,3803,대전,71,71,0,10520,2021-07-26 09:00:00.000,2021-09-16 10:11:33.897
7265,41,3134,울산,3,3,0,10519,2021-07-26 09:00:00.000,2021-09-16 10:11:33.897
7266,1,698,세종,5,5,0,10518,2021-07-26 09:00:00.000,2021-09-16 10:11:33.897
7267,678,53463,경기,350,343,7,10517,2021-07-26 09:00:00.000,2021-09-16 10:11:33.897
7268,55,4252,강원,29,28,1,10516,2021-07-26 09:00:00.000,2021-09-16 10:11:33.897
7269,71,3711,충북,31,31,0,10515,2021-07-26 09:00:00.000,2021-09-16 10:11:33.897
7270,45,4730,충남,65,61,4,10514,2021-07-26 09:00:00.000,2021-09-16 10:11:33.897
7271,60,2644,전북,24,23,1,10513,2021-07-26 09:00:00.000,2021-09-16 10:11:33.897
7272,17,1948,전남,28,26,2,10512,2021-07-26 09:00:00.000,2021-09-16 10:11:33.897
7273,87,5320,경북,22,21,1,10511,2021-07-26 09:00:00.000,2021-09-16 10:11:33.897
7274,22,6729,경남,78,75,3,10510,2021-07-26 09:00:00.000,2021-09-16 10:11:33.897
7275,1,1624,제주,12,11,1,10509,2021-07-26 09:00:00.000,2021-09-16 10:11:33.897
7276,8,5118,검역,21,0,21,10508,2021-07-26 09:00:00.000,2021-09-16 10:11:33.897
7277,2073,188837,합계,1487,1422,65,10507,2021-07-25 09:00:00.000,2021-09-16 10:11:33.897
7278,529,61608,서울,489,478,11,10506,2021-07-25 09:00:00.000,2021-09-16 10:11:33.897
7279,127,7717,부산,108,106,2,10505,2021-07-25 09:00:00.000,2021-09-16 10:11:33.897
7280,222,11321,대구,69,69,0,10504,2021-07-25 09:00:00.000,2021-09-16 10:11:33.897
7281,61,8511,인천,88,83,5,10503,2021-07-25 09:00:00.000,2021-09-16 10:11:33.897
7282,24,3245,광주,13,11,2,10502,2021-07-25 09:00:00.000,2021-09-16 10:11:33.897
7283,28,3732,대전,54,54,0,10501,2021-07-25 09:00:00.000,2021-09-16 10:11:33.897
7284,41,3131,울산,9,9,0,10500,2021-07-25 09:00:00.000,2021-09-16 10:11:33.897
7285,1,693,세종,9,9,0,10499,2021-07-25 09:00:00.000,2021-09-16 10:11:33.897
7286,674,53113,경기,320,315,5,10498,2021-07-25 09:00:00.000,2021-09-16 10:11:33.897
7287,55,4223,강원,25,25,0,10497,2021-07-25 09:00:00.000,2021-09-16 10:11:33.897
7288,71,3680,충북,41,37,4,10496,2021-07-25 09:00:00.000,2021-09-16 10:11:33.897
7289,44,4665,충남,47,45,2,10495,2021-07-25 09:00:00.000,2021-09-16 10:11:33.897
7290,60,2620,전북,7,7,0,10494,2021-07-25 09:00:00.000,2021-09-16 10:11:33.897
7291,17,1920,전남,16,16,0,10493,2021-07-25 09:00:00.000,2021-09-16 10:11:33.897
7292,87,5298,경북,28,28,0,10492,2021-07-25 09:00:00.000,2021-09-16 10:11:33.897
7293,22,6651,경남,119,116,3,10491,2021-07-25 09:00:00.000,2021-09-16 10:11:33.897
7294,1,1612,제주,14,14,0,10490,2021-07-25 09:00:00.000,2021-09-16 10:11:33.897
7295,8,5097,검역,31,0,31,10489,2021-07-25 09:00:00.000,2021-09-16 10:11:33.897
7296,2068,187350,합계,1627,1572,55,10488,2021-07-24 09:00:00.000,2021-09-16 10:11:33.897
7297,528,61119,서울,465,462,3,10487,2021-07-24 09:00:00.000,2021-09-16 10:11:33.897
7298,127,7609,부산,116,114,2,10486,2021-07-24 09:00:00.000,2021-09-16 10:11:33.897
7299,222,11252,대구,52,52,0,10485,2021-07-24 09:00:00.000,2021-09-16 10:11:33.897
7300,61,8423,인천,84,81,3,10484,2021-07-24 09:00:00.000,2021-09-16 10:11:33.897
7301,24,3232,광주,9,9,0,10483,2021-07-24 09:00:00.000,2021-09-16 10:11:33.897
7302,28,3678,대전,68,68,0,10482,2021-07-24 09:00:00.000,2021-09-16 10:11:33.897
7303,40,3122,울산,19,18,1,10481,2021-07-24 09:00:00.000,2021-09-16 10:11:33.897
7304,1,684,세종,6,6,0,10480,2021-07-24 09:00:00.000,2021-09-16 10:11:33.897
7305,673,52793,경기,464,448,16,10479,2021-07-24 09:00:00.000,2021-09-16 10:11:33.897
7306,55,4198,강원,46,46,0,10478,2021-07-24 09:00:00.000,2021-09-16 10:11:33.897
7307,71,3639,충북,31,29,2,10477,2021-07-24 09:00:00.000,2021-09-16 10:11:33.897
7308,44,4618,충남,39,34,5,10476,2021-07-24 09:00:00.000,2021-09-16 10:11:33.897
7309,60,2613,전북,42,41,1,10475,2021-07-24 09:00:00.000,2021-09-16 10:11:33.897
7310,17,1904,전남,20,20,0,10474,2021-07-24 09:00:00.000,2021-09-16 10:11:33.897
7311,87,5270,경북,21,20,1,10473,2021-07-24 09:00:00.000,2021-09-16 10:11:33.897
7312,22,6532,경남,111,110,1,10472,2021-07-24 09:00:00.000,2021-09-16 10:11:33.897
7313,1,1598,제주,15,14,1,10471,2021-07-24 09:00:00.000,2021-09-16 10:11:33.897
7314,7,5066,검역,19,0,19,10470,2021-07-24 09:00:00.000,2021-09-16 10:11:33.897
7315,2066,185723,합계,1629,1573,56,10469,2021-07-23 09:00:00.000,2021-09-16 10:11:33.897
7316,528,60654,서울,519,515,4,10468,2021-07-23 09:00:00.000,2021-09-16 10:11:33.897
7317,127,7493,부산,116,115,1,10467,2021-07-23 09:00:00.000,2021-09-16 10:11:33.897
7318,222,11200,대구,60,57,3,10466,2021-07-23 09:00:00.000,2021-09-16 10:11:33.897
7319,61,8339,인천,97,90,7,10465,2021-07-23 09:00:00.000,2021-09-16 10:11:33.897
7320,24,3223,광주,9,9,0,10464,2021-07-23 09:00:00.000,2021-09-16 10:11:33.897
7321,28,3610,대전,67,67,0,10463,2021-07-23 09:00:00.000,2021-09-16 10:11:33.897
7322,40,3103,울산,22,22,0,10462,2021-07-23 09:00:00.000,2021-09-16 10:11:33.897
7323,1,678,세종,8,8,0,10461,2021-07-23 09:00:00.000,2021-09-16 10:11:33.897
7324,672,52329,경기,415,403,12,10460,2021-07-23 09:00:00.000,2021-09-16 10:11:33.897
7325,54,4152,강원,62,61,1,10459,2021-07-23 09:00:00.000,2021-09-16 10:11:33.897
7326,71,3608,충북,35,34,1,10458,2021-07-23 09:00:00.000,2021-09-16 10:11:33.897
7327,44,4579,충남,28,24,4,10457,2021-07-23 09:00:00.000,2021-09-16 10:11:33.897
7328,60,2571,전북,10,10,0,10456,2021-07-23 09:00:00.000,2021-09-16 10:11:33.897
7329,17,1884,전남,23,22,1,10455,2021-07-23 09:00:00.000,2021-09-16 10:11:33.897
7330,87,5249,경북,16,15,1,10454,2021-07-23 09:00:00.000,2021-09-16 10:11:33.897
7331,22,6421,경남,93,93,0,10453,2021-07-23 09:00:00.000,2021-09-16 10:11:33.897
7332,1,1583,제주,29,28,1,10452,2021-07-23 09:00:00.000,2021-09-16 10:11:33.897
7333,7,5047,검역,20,0,20,10451,2021-07-23 09:00:00.000,2021-09-16 10:11:33.897
7334,2063,184094,합계,1841,1532,309,10450,2021-07-22 09:00:00.000,2021-09-16 10:11:33.897
7335,528,60135,서울,499,494,5,10449,2021-07-22 09:00:00.000,2021-09-16 10:11:33.897
7336,127,7377,부산,104,101,3,10448,2021-07-22 09:00:00.000,2021-09-16 10:11:33.897
7337,222,11140,대구,38,38,0,10447,2021-07-22 09:00:00.000,2021-09-16 10:11:33.897
7338,61,8242,인천,130,130,0,10446,2021-07-22 09:00:00.000,2021-09-16 10:11:33.897
7339,24,3214,광주,11,11,0,10445,2021-07-22 09:00:00.000,2021-09-16 10:11:33.897
7340,28,3543,대전,81,81,0,10444,2021-07-22 09:00:00.000,2021-09-16 10:11:33.897
7341,40,3081,울산,25,25,0,10443,2021-07-22 09:00:00.000,2021-09-16 10:11:33.897
7342,1,670,세종,10,10,0,10442,2021-07-22 09:00:00.000,2021-09-16 10:11:33.897
7343,669,51914,경기,373,363,10,10441,2021-07-22 09:00:00.000,2021-09-16 10:11:33.897
7344,54,4090,강원,47,47,0,10440,2021-07-22 09:00:00.000,2021-09-16 10:11:33.897
7345,71,3573,충북,28,28,0,10439,2021-07-22 09:00:00.000,2021-09-16 10:11:33.897
7346,44,4551,충남,39,39,0,10438,2021-07-22 09:00:00.000,2021-09-16 10:11:33.897
7347,60,2561,전북,4,4,0,10437,2021-07-22 09:00:00.000,2021-09-16 10:11:33.897
7348,17,1861,전남,18,18,0,10436,2021-07-22 09:00:00.000,2021-09-16 10:11:33.897
7349,87,5233,경북,29,29,0,10435,2021-07-22 09:00:00.000,2021-09-16 10:11:33.897
7350,22,6328,경남,91,90,1,10434,2021-07-22 09:00:00.000,2021-09-16 10:11:33.897
7351,1,1554,제주,24,24,0,10433,2021-07-22 09:00:00.000,2021-09-16 10:11:33.897
7352,7,5027,검역,290,0,290,10432,2021-07-22 09:00:00.000,2021-09-16 10:11:33.897
7353,2060,182253,합계,1781,1725,56,10431,2021-07-21 09:00:00.000,2021-09-16 10:11:33.897
7354,528,59636,서울,604,599,5,10430,2021-07-21 09:00:00.000,2021-09-16 10:11:33.897
7355,127,7273,부산,102,100,2,10429,2021-07-21 09:00:00.000,2021-09-16 10:11:33.897
7356,222,11102,대구,35,33,2,10428,2021-07-21 09:00:00.000,2021-09-16 10:11:33.897
7357,61,8112,인천,128,126,2,10427,2021-07-21 09:00:00.000,2021-09-16 10:11:33.897
7358,24,3203,광주,23,22,1,10426,2021-07-21 09:00:00.000,2021-09-16 10:11:33.897
7359,28,3462,대전,73,72,1,10425,2021-07-21 09:00:00.000,2021-09-16 10:11:33.897
7360,40,3056,울산,18,18,0,10424,2021-07-21 09:00:00.000,2021-09-16 10:11:33.897
7361,1,660,세종,6,6,0,10423,2021-07-21 09:00:00.000,2021-09-16 10:11:33.897
7362,666,51541,경기,465,450,15,10422,2021-07-21 09:00:00.000,2021-09-16 10:11:33.897
7363,54,4043,강원,54,54,0,10421,2021-07-21 09:00:00.000,2021-09-16 10:11:33.897
7364,71,3545,충북,15,15,0,10420,2021-07-21 09:00:00.000,2021-09-16 10:11:33.897
7365,44,4512,충남,49,48,1,10419,2021-07-21 09:00:00.000,2021-09-16 10:11:33.897
7366,60,2557,전북,19,18,1,10418,2021-07-21 09:00:00.000,2021-09-16 10:11:33.897
7367,17,1843,전남,21,21,0,10417,2021-07-21 09:00:00.000,2021-09-16 10:11:33.897
7368,87,5204,경북,25,23,2,10416,2021-07-21 09:00:00.000,2021-09-16 10:11:33.897
7369,22,6237,경남,89,86,3,10415,2021-07-21 09:00:00.000,2021-09-16 10:11:33.897
7370,1,1530,제주,34,34,0,10414,2021-07-21 09:00:00.000,2021-09-16 10:11:33.897
7371,7,4737,검역,21,0,21,10413,2021-07-21 09:00:00.000,2021-09-16 10:11:33.897
7372,2059,180472,합계,1278,1242,36,10412,2021-07-20 09:00:00.000,2021-09-16 10:11:33.897
7373,527,59032,서울,394,388,6,10411,2021-07-20 09:00:00.000,2021-09-16 10:11:33.897
7374,127,7171,부산,49,49,0,10410,2021-07-20 09:00:00.000,2021-09-16 10:11:33.897
7375,222,11067,대구,30,29,1,10409,2021-07-20 09:00:00.000,2021-09-16 10:11:33.897
7376,61,7984,인천,71,70,1,10408,2021-07-20 09:00:00.000,2021-09-16 10:11:33.897
7377,24,3180,광주,25,25,0,10407,2021-07-20 09:00:00.000,2021-09-16 10:11:33.897
7378,28,3389,대전,73,73,0,10406,2021-07-20 09:00:00.000,2021-09-16 10:11:33.897
7379,40,3038,울산,9,9,0,10405,2021-07-20 09:00:00.000,2021-09-16 10:11:33.897
7380,1,654,세종,13,13,0,10404,2021-07-20 09:00:00.000,2021-09-16 10:11:33.897
7381,666,51076,경기,383,375,8,10403,2021-07-20 09:00:00.000,2021-09-16 10:11:33.897
7382,54,3989,강원,42,41,1,10402,2021-07-20 09:00:00.000,2021-09-16 10:11:33.897
7383,71,3530,충북,44,44,0,10401,2021-07-20 09:00:00.000,2021-09-16 10:11:33.897
7384,44,4463,충남,30,28,2,10400,2021-07-20 09:00:00.000,2021-09-16 10:11:33.897
7385,60,2538,전북,15,14,1,10399,2021-07-20 09:00:00.000,2021-09-16 10:11:33.897
7386,17,1822,전남,9,8,1,10398,2021-07-20 09:00:00.000,2021-09-16 10:11:33.897
7387,87,5179,경북,19,13,6,10397,2021-07-20 09:00:00.000,2021-09-16 10:11:33.897
7388,22,6148,경남,57,55,2,10396,2021-07-20 09:00:00.000,2021-09-16 10:11:33.897
7389,1,1496,제주,8,8,0,10395,2021-07-20 09:00:00.000,2021-09-16 10:11:33.897
7390,7,4716,검역,7,0,7,10394,2021-07-20 09:00:00.000,2021-09-16 10:11:33.897
7391,2058,179194,합계,1251,1207,44,10393,2021-07-19 09:00:00.000,2021-09-16 10:11:33.897
7392,527,58638,서울,419,413,6,10392,2021-07-19 09:00:00.000,2021-09-16 10:11:33.897
7393,127,7122,부산,65,63,2,10391,2021-07-19 09:00:00.000,2021-09-16 10:11:33.897
7394,222,11037,대구,33,31,2,10390,2021-07-19 09:00:00.000,2021-09-16 10:11:33.897
7395,61,7913,인천,67,62,5,10389,2021-07-19 09:00:00.000,2021-09-16 10:11:33.897
7396,24,3155,광주,14,12,2,10388,2021-07-19 09:00:00.000,2021-09-16 10:11:33.897
7397,28,3316,대전,83,83,0,10387,2021-07-19 09:00:00.000,2021-09-16 10:11:33.897
7398,40,3029,울산,14,13,1,10386,2021-07-19 09:00:00.000,2021-09-16 10:11:33.897
7399,1,641,세종,8,8,0,10385,2021-07-19 09:00:00.000,2021-09-16 10:11:33.897
7400,666,50693,경기,340,335,5,10384,2021-07-19 09:00:00.000,2021-09-16 10:11:33.897
7401,54,3947,강원,27,27,0,10383,2021-07-19 09:00:00.000,2021-09-16 10:11:33.897
7402,71,3486,충북,4,4,0,10382,2021-07-19 09:00:00.000,2021-09-16 10:11:33.897
7403,44,4433,충남,33,33,0,10381,2021-07-19 09:00:00.000,2021-09-16 10:11:33.897
7404,60,2523,전북,10,10,0,10380,2021-07-19 09:00:00.000,2021-09-16 10:11:33.897
7405,17,1813,전남,16,16,0,10379,2021-07-19 09:00:00.000,2021-09-16 10:11:33.897
7406,87,5160,경북,19,17,2,10378,2021-07-19 09:00:00.000,2021-09-16 10:11:33.897
7407,22,6091,경남,74,69,5,10377,2021-07-19 09:00:00.000,2021-09-16 10:11:33.897
7408,1,1488,제주,11,11,0,10376,2021-07-19 09:00:00.000,2021-09-16 10:11:33.897
7409,6,4709,검역,14,0,14,10375,2021-07-19 09:00:00.000,2021-09-16 10:11:33.897
7410,2057,177943,합계,1453,1402,51,10374,2021-07-18 09:00:00.000,2021-09-16 10:11:33.897
7411,527,58219,서울,522,515,7,10373,2021-07-18 09:00:00.000,2021-09-16 10:11:33.897
7412,127,7057,부산,70,68,2,10372,2021-07-18 09:00:00.000,2021-09-16 10:11:33.897
7413,222,11004,대구,42,41,1,10371,2021-07-18 09:00:00.000,2021-09-16 10:11:33.897
7414,61,7846,인천,83,81,2,10370,2021-07-18 09:00:00.000,2021-09-16 10:11:33.897
7415,24,3141,광주,23,23,0,10369,2021-07-18 09:00:00.000,2021-09-16 10:11:33.897
7416,28,3233,대전,45,45,0,10368,2021-07-18 09:00:00.000,2021-09-16 10:11:33.897
7417,40,3015,울산,12,11,1,10367,2021-07-18 09:00:00.000,2021-09-16 10:11:33.897
7418,1,633,세종,5,5,0,10366,2021-07-18 09:00:00.000,2021-09-16 10:11:33.897
7419,666,50353,경기,373,363,10,10365,2021-07-18 09:00:00.000,2021-09-16 10:11:33.897
7420,53,3920,강원,52,50,2,10364,2021-07-18 09:00:00.000,2021-09-16 10:11:33.897
7421,71,3482,충북,29,29,0,10363,2021-07-18 09:00:00.000,2021-09-16 10:11:33.897
7422,44,4400,충남,40,35,5,10362,2021-07-18 09:00:00.000,2021-09-16 10:11:33.897
7423,60,2513,전북,5,4,1,10361,2021-07-18 09:00:00.000,2021-09-16 10:11:33.897
7424,17,1797,전남,11,11,0,10360,2021-07-18 09:00:00.000,2021-09-16 10:11:33.897
7425,87,5141,경북,15,14,1,10359,2021-07-18 09:00:00.000,2021-09-16 10:11:33.897
7426,22,6017,경남,99,96,3,10358,2021-07-18 09:00:00.000,2021-09-16 10:11:33.897
7427,1,1477,제주,11,11,0,10357,2021-07-18 09:00:00.000,2021-09-16 10:11:33.897
7428,6,4695,검역,16,0,16,10356,2021-07-18 09:00:00.000,2021-09-16 10:11:33.897
7429,2055,176490,합계,1449,1400,49,10355,2021-07-17 09:00:00.000,2021-09-16 10:11:33.897
7430,527,57697,서울,559,555,4,10354,2021-07-17 09:00:00.000,2021-09-16 10:11:33.897
7431,127,6987,부산,62,61,1,10353,2021-07-17 09:00:00.000,2021-09-16 10:11:33.897
7432,222,10962,대구,29,28,1,10352,2021-07-17 09:00:00.000,2021-09-16 10:11:33.897
7433,61,7763,인천,81,77,4,10351,2021-07-17 09:00:00.000,2021-09-16 10:11:33.897
7434,24,3118,광주,12,12,0,10350,2021-07-17 09:00:00.000,2021-09-16 10:11:33.897
7435,28,3188,대전,33,33,0,10349,2021-07-17 09:00:00.000,2021-09-16 10:11:33.897
7436,40,3003,울산,11,10,1,10348,2021-07-17 09:00:00.000,2021-09-16 10:11:33.897
7437,1,628,세종,2,2,0,10347,2021-07-17 09:00:00.000,2021-09-16 10:11:33.897
7438,664,49980,경기,393,383,10,10346,2021-07-17 09:00:00.000,2021-09-16 10:11:33.897
7439,53,3868,강원,45,45,0,10345,2021-07-17 09:00:00.000,2021-09-16 10:11:33.897
7440,71,3453,충북,11,11,0,10344,2021-07-17 09:00:00.000,2021-09-16 10:11:33.897
7441,44,4360,충남,52,52,0,10343,2021-07-17 09:00:00.000,2021-09-16 10:11:33.897
7442,60,2508,전북,8,8,0,10342,2021-07-17 09:00:00.000,2021-09-16 10:11:33.897
7443,17,1786,전남,8,7,1,10341,2021-07-17 09:00:00.000,2021-09-16 10:11:33.897
7444,87,5126,경북,16,14,2,10340,2021-07-17 09:00:00.000,2021-09-16 10:11:33.897
7445,22,5918,경남,89,88,1,10339,2021-07-17 09:00:00.000,2021-09-16 10:11:33.897
7446,1,1466,제주,14,14,0,10338,2021-07-17 09:00:00.000,2021-09-16 10:11:33.897
7447,6,4679,검역,24,0,24,10337,2021-07-17 09:00:00.000,2021-09-16 10:11:33.897
7448,2051,175041,합계,1535,1475,60,10336,2021-07-16 09:00:00.000,2021-09-16 10:11:33.897
7449,525,57138,서울,569,563,6,10335,2021-07-16 09:00:00.000,2021-09-16 10:11:33.897
7450,127,6925,부산,50,49,1,10334,2021-07-16 09:00:00.000,2021-09-16 10:11:33.897
7451,222,10933,대구,32,32,0,10333,2021-07-16 09:00:00.000,2021-09-16 10:11:33.897
7452,61,7682,인천,97,95,2,10332,2021-07-16 09:00:00.000,2021-09-16 10:11:33.897
7453,24,3106,광주,23,23,0,10331,2021-07-16 09:00:00.000,2021-09-16 10:11:33.897
7454,28,3155,대전,49,49,0,10330,2021-07-16 09:00:00.000,2021-09-16 10:11:33.897
7455,40,2992,울산,14,14,0,10329,2021-07-16 09:00:00.000,2021-09-16 10:11:33.897
7456,1,626,세종,7,7,0,10328,2021-07-16 09:00:00.000,2021-09-16 10:11:33.897
7457,663,49587,경기,456,448,8,10327,2021-07-16 09:00:00.000,2021-09-16 10:11:33.897
7458,53,3823,강원,28,27,1,10326,2021-07-16 09:00:00.000,2021-09-16 10:11:33.897
7459,71,3442,충북,14,13,1,10325,2021-07-16 09:00:00.000,2021-09-16 10:11:33.897
7460,44,4308,충남,39,38,1,10324,2021-07-16 09:00:00.000,2021-09-16 10:11:33.897
7461,60,2500,전북,13,12,1,10323,2021-07-16 09:00:00.000,2021-09-16 10:11:33.897
7462,17,1778,전남,8,7,1,10322,2021-07-16 09:00:00.000,2021-09-16 10:11:33.897
7463,87,5110,경북,12,10,2,10321,2021-07-16 09:00:00.000,2021-09-16 10:11:33.897
7464,22,5829,경남,80,79,1,10320,2021-07-16 09:00:00.000,2021-09-16 10:11:33.897
7465,1,1452,제주,10,9,1,10319,2021-07-16 09:00:00.000,2021-09-16 10:11:33.897
7466,5,4655,검역,34,0,34,10318,2021-07-16 09:00:00.000,2021-09-16 10:11:33.897
7467,2050,173506,합계,1599,1554,45,10317,2021-07-15 09:00:00.000,2021-09-16 10:11:33.897
7468,525,56569,서울,519,517,2,10316,2021-07-15 09:00:00.000,2021-09-16 10:11:33.897
7469,126,6875,부산,65,63,2,10315,2021-07-15 09:00:00.000,2021-09-16 10:11:33.897
7470,222,10901,대구,51,50,1,10314,2021-07-15 09:00:00.000,2021-09-16 10:11:33.897
7471,61,7585,인천,90,89,1,10313,2021-07-15 09:00:00.000,2021-09-16 10:11:33.897
7472,24,3083,광주,21,21,0,10312,2021-07-15 09:00:00.000,2021-09-16 10:11:33.897
7473,28,3106,대전,60,59,1,10311,2021-07-15 09:00:00.000,2021-09-16 10:11:33.897
7474,40,2978,울산,19,18,1,10310,2021-07-15 09:00:00.000,2021-09-16 10:11:33.897
7475,1,619,세종,2,2,0,10309,2021-07-15 09:00:00.000,2021-09-16 10:11:33.897
7476,663,49131,경기,496,491,5,10308,2021-07-15 09:00:00.000,2021-09-16 10:11:33.897
7477,53,3795,강원,25,24,1,10307,2021-07-15 09:00:00.000,2021-09-16 10:11:33.897
7478,71,3428,충북,12,12,0,10306,2021-07-15 09:00:00.000,2021-09-16 10:11:33.897
7479,44,4269,충남,51,51,0,10305,2021-07-15 09:00:00.000,2021-09-16 10:11:33.897
7480,60,2487,전북,24,23,1,10304,2021-07-15 09:00:00.000,2021-09-16 10:11:33.897
7481,17,1770,전남,26,26,0,10303,2021-07-15 09:00:00.000,2021-09-16 10:11:33.897
7482,87,5098,경북,13,13,0,10302,2021-07-15 09:00:00.000,2021-09-16 10:11:33.897
7483,22,5749,경남,88,86,2,10301,2021-07-15 09:00:00.000,2021-09-16 10:11:33.897
7484,1,1442,제주,9,9,0,10300,2021-07-15 09:00:00.000,2021-09-16 10:11:33.897
7485,5,4621,검역,28,0,28,10299,2021-07-15 09:00:00.000,2021-09-16 10:11:33.897
7486,2048,171907,합계,1613,1566,47,10298,2021-07-14 09:00:00.000,2021-09-16 10:11:33.897
7487,524,56050,서울,637,632,5,10297,2021-07-14 09:00:00.000,2021-09-16 10:11:33.897
7488,126,6810,부산,63,62,1,10296,2021-07-14 09:00:00.000,2021-09-16 10:11:33.897
7489,222,10850,대구,52,52,0,10295,2021-07-14 09:00:00.000,2021-09-16 10:11:33.897
7490,61,7495,인천,96,93,3,10294,2021-07-14 09:00:00.000,2021-09-16 10:11:33.897
7491,24,3062,광주,15,15,0,10293,2021-07-14 09:00:00.000,2021-09-16 10:11:33.897
7492,28,3046,대전,41,41,0,10292,2021-07-14 09:00:00.000,2021-09-16 10:11:33.897
7493,40,2959,울산,11,11,0,10291,2021-07-14 09:00:00.000,2021-09-16 10:11:33.897
7494,1,617,세종,6,6,0,10290,2021-07-14 09:00:00.000,2021-09-16 10:11:33.897
7495,662,48635,경기,464,452,12,10289,2021-07-14 09:00:00.000,2021-09-16 10:11:33.897
7496,53,3770,강원,16,15,1,10288,2021-07-14 09:00:00.000,2021-09-16 10:11:33.897
7497,71,3416,충북,10,9,1,10287,2021-07-14 09:00:00.000,2021-09-16 10:11:33.897
7498,44,4218,충남,36,36,0,10286,2021-07-14 09:00:00.000,2021-09-16 10:11:33.897
7499,60,2463,전북,9,9,0,10285,2021-07-14 09:00:00.000,2021-09-16 10:11:33.897
7500,17,1744,전남,6,6,0,10284,2021-07-14 09:00:00.000,2021-09-16 10:11:33.897
7501,87,5085,경북,22,19,3,10283,2021-07-14 09:00:00.000,2021-09-16 10:11:33.897
7502,22,5661,경남,89,87,2,10282,2021-07-14 09:00:00.000,2021-09-16 10:11:33.897
7503,1,1433,제주,21,21,0,10281,2021-07-14 09:00:00.000,2021-09-16 10:11:33.897
7504,5,4593,검역,19,0,19,10280,2021-07-14 09:00:00.000,2021-09-16 10:11:33.897
7505,2046,170294,합계,1150,1097,53,10279,2021-07-13 09:00:00.000,2021-09-16 10:11:33.897
7506,523,55413,서울,417,414,3,10278,2021-07-13 09:00:00.000,2021-09-16 10:11:33.897
7507,126,6747,부산,50,47,3,10277,2021-07-13 09:00:00.000,2021-09-16 10:11:33.897
7508,222,10798,대구,38,36,2,10276,2021-07-13 09:00:00.000,2021-09-16 10:11:33.897
7509,61,7399,인천,71,67,4,10275,2021-07-13 09:00:00.000,2021-09-16 10:11:33.897
7510,24,3047,광주,9,9,0,10274,2021-07-13 09:00:00.000,2021-09-16 10:11:33.897
7511,28,3005,대전,31,31,0,10273,2021-07-13 09:00:00.000,2021-09-16 10:11:33.897
7512,40,2948,울산,7,7,0,10272,2021-07-13 09:00:00.000,2021-09-16 10:11:33.897
7513,1,611,세종,8,8,0,10271,2021-07-13 09:00:00.000,2021-09-16 10:11:33.897
7514,662,48171,경기,318,313,5,10270,2021-07-13 09:00:00.000,2021-09-16 10:11:33.897
7515,53,3754,강원,19,19,0,10269,2021-07-13 09:00:00.000,2021-09-16 10:11:33.897
7516,71,3406,충북,8,7,1,10268,2021-07-13 09:00:00.000,2021-09-16 10:11:33.897
7517,44,4182,충남,36,32,4,10267,2021-07-13 09:00:00.000,2021-09-16 10:11:33.897
7518,60,2454,전북,18,18,0,10266,2021-07-13 09:00:00.000,2021-09-16 10:11:33.897
7519,17,1738,전남,13,13,0,10265,2021-07-13 09:00:00.000,2021-09-16 10:11:33.897
7520,86,5063,경북,8,8,0,10264,2021-07-13 09:00:00.000,2021-09-16 10:11:33.897
7521,22,5572,경남,51,49,2,10263,2021-07-13 09:00:00.000,2021-09-16 10:11:33.897
7522,1,1412,제주,19,19,0,10262,2021-07-13 09:00:00.000,2021-09-16 10:11:33.897
7523,5,4574,검역,29,0,29,10261,2021-07-13 09:00:00.000,2021-09-16 10:11:33.897
7524,2044,169144,합계,1100,1063,37,10260,2021-07-12 09:00:00.000,2021-09-16 10:11:33.897
7525,523,54996,서울,403,402,1,10259,2021-07-12 09:00:00.000,2021-09-16 10:11:33.897
7526,126,6697,부산,44,43,1,10258,2021-07-12 09:00:00.000,2021-09-16 10:11:33.897
7527,222,10760,대구,37,37,0,10257,2021-07-12 09:00:00.000,2021-09-16 10:11:33.897
7528,61,7328,인천,56,51,5,10256,2021-07-12 09:00:00.000,2021-09-16 10:11:33.897
7529,24,3038,광주,14,13,1,10255,2021-07-12 09:00:00.000,2021-09-16 10:11:33.897
7530,28,2974,대전,25,25,0,10254,2021-07-12 09:00:00.000,2021-09-16 10:11:33.897
7531,40,2941,울산,8,8,0,10253,2021-07-12 09:00:00.000,2021-09-16 10:11:33.897
7532,1,603,세종,6,6,0,10252,2021-07-12 09:00:00.000,2021-09-16 10:11:33.897
7533,661,47853,경기,327,322,5,10251,2021-07-12 09:00:00.000,2021-09-16 10:11:33.897
7534,53,3735,강원,18,18,0,10250,2021-07-12 09:00:00.000,2021-09-16 10:11:33.897
7535,71,3398,충북,14,13,1,10249,2021-07-12 09:00:00.000,2021-09-16 10:11:33.897
7536,43,4146,충남,45,43,2,10248,2021-07-12 09:00:00.000,2021-09-16 10:11:33.897
7537,60,2436,전북,4,4,0,10247,2021-07-12 09:00:00.000,2021-09-16 10:11:33.897
7538,17,1725,전남,19,19,0,10246,2021-07-12 09:00:00.000,2021-09-16 10:11:33.897
7539,86,5055,경북,13,12,1,10245,2021-07-12 09:00:00.000,2021-09-16 10:11:33.897
7540,22,5521,경남,40,40,0,10244,2021-07-12 09:00:00.000,2021-09-16 10:11:33.897
7541,1,1393,제주,7,7,0,10243,2021-07-12 09:00:00.000,2021-09-16 10:11:33.897
7542,5,4545,검역,20,0,20,10242,2021-07-12 09:00:00.000,2021-09-16 10:11:33.897
7543,2043,168044,합계,1324,1280,44,10241,2021-07-11 09:00:00.000,2021-09-16 10:11:33.897
7544,523,54593,서울,509,501,8,10240,2021-07-11 09:00:00.000,2021-09-16 10:11:33.897
7545,126,6653,부산,56,53,3,10239,2021-07-11 09:00:00.000,2021-09-16 10:11:33.897
7546,222,10723,대구,23,23,0,10238,2021-07-11 09:00:00.000,2021-09-16 10:11:33.897
7547,61,7272,인천,66,64,2,10237,2021-07-11 09:00:00.000,2021-09-16 10:11:33.897
7548,24,3024,광주,23,22,1,10236,2021-07-11 09:00:00.000,2021-09-16 10:11:33.897
7549,28,2949,대전,32,31,1,10235,2021-07-11 09:00:00.000,2021-09-16 10:11:33.897
7550,40,2933,울산,22,22,0,10234,2021-07-11 09:00:00.000,2021-09-16 10:11:33.897
7551,1,597,세종,3,3,0,10233,2021-07-11 09:00:00.000,2021-09-16 10:11:33.897
7552,660,47526,경기,407,399,8,10232,2021-07-11 09:00:00.000,2021-09-16 10:11:33.897
7553,53,3717,강원,20,20,0,10231,2021-07-11 09:00:00.000,2021-09-16 10:11:33.897
7554,71,3384,충북,8,7,1,10230,2021-07-11 09:00:00.000,2021-09-16 10:11:33.897
7555,43,4101,충남,32,31,1,10229,2021-07-11 09:00:00.000,2021-09-16 10:11:33.897
7556,60,2432,전북,2,2,0,10228,2021-07-11 09:00:00.000,2021-09-16 10:11:33.897
7557,17,1706,전남,6,5,1,10227,2021-07-11 09:00:00.000,2021-09-16 10:11:33.897
7558,86,5042,경북,12,10,2,10226,2021-07-11 09:00:00.000,2021-09-16 10:11:33.897
7559,22,5481,경남,67,63,4,10225,2021-07-11 09:00:00.000,2021-09-16 10:11:33.897
7560,1,1386,제주,24,24,0,10224,2021-07-11 09:00:00.000,2021-09-16 10:11:33.897
7561,5,4525,검역,12,0,12,10223,2021-07-11 09:00:00.000,2021-09-16 10:11:33.897
7562,2038,166720,합계,1378,1320,58,10222,2021-07-10 09:00:00.000,2021-09-16 10:11:33.897
7563,521,54084,서울,509,501,8,10221,2021-07-10 09:00:00.000,2021-09-16 10:11:33.897
7564,126,6597,부산,61,59,2,10220,2021-07-10 09:00:00.000,2021-09-16 10:11:33.897
7565,222,10700,대구,14,12,2,10219,2021-07-10 09:00:00.000,2021-09-16 10:11:33.897
7566,61,7206,인천,84,79,5,10218,2021-07-10 09:00:00.000,2021-09-16 10:11:33.897
7567,24,3001,광주,21,20,1,10217,2021-07-10 09:00:00.000,2021-09-16 10:11:33.897
7568,27,2917,대전,48,47,1,10216,2021-07-10 09:00:00.000,2021-09-16 10:11:33.897
7569,40,2911,울산,30,29,1,10215,2021-07-10 09:00:00.000,2021-09-16 10:11:33.897
7570,1,594,세종,0,0,0,10214,2021-07-10 09:00:00.000,2021-09-16 10:11:33.897
7571,659,47119,경기,451,441,10,10213,2021-07-10 09:00:00.000,2021-09-16 10:11:33.897
7572,53,3697,강원,16,15,1,10212,2021-07-10 09:00:00.000,2021-09-16 10:11:33.897
7573,71,3376,충북,19,18,1,10211,2021-07-10 09:00:00.000,2021-09-16 10:11:33.897
7574,43,4069,충남,29,28,1,10210,2021-07-10 09:00:00.000,2021-09-16 10:11:33.897
7575,60,2430,전북,14,14,0,10209,2021-07-10 09:00:00.000,2021-09-16 10:11:33.897
7576,17,1700,전남,2,2,0,10208,2021-07-10 09:00:00.000,2021-09-16 10:11:33.897
7577,86,5030,경북,13,9,4,10207,2021-07-10 09:00:00.000,2021-09-16 10:11:33.897
7578,21,5414,경남,36,36,0,10206,2021-07-10 09:00:00.000,2021-09-16 10:11:33.897
7579,1,1362,제주,10,10,0,10205,2021-07-10 09:00:00.000,2021-09-16 10:11:33.897
7580,5,4513,검역,21,0,21,10204,2021-07-10 09:00:00.000,2021-09-16 10:11:33.897
7581,2036,165342,합계,1316,1236,80,10203,2021-07-09 09:00:00.000,2021-09-16 10:11:33.897
7582,519,53575,서울,503,495,8,10202,2021-07-09 09:00:00.000,2021-09-16 10:11:33.897
7583,126,6536,부산,58,53,5,10201,2021-07-09 09:00:00.000,2021-09-16 10:11:33.897
7584,222,10686,대구,19,16,3,10200,2021-07-09 09:00:00.000,2021-09-16 10:11:33.897
7585,61,7122,인천,82,72,10,10199,2021-07-09 09:00:00.000,2021-09-16 10:11:33.897
7586,24,2980,광주,4,3,1,10198,2021-07-09 09:00:00.000,2021-09-16 10:11:33.897
7587,27,2869,대전,29,28,1,10197,2021-07-09 09:00:00.000,2021-09-16 10:11:33.897
7588,40,2881,울산,16,16,0,10196,2021-07-09 09:00:00.000,2021-09-16 10:11:33.897
7589,1,594,세종,1,1,0,10195,2021-07-09 09:00:00.000,2021-09-16 10:11:33.897
7590,659,46668,경기,405,396,9,10194,2021-07-09 09:00:00.000,2021-09-16 10:11:33.897
7591,53,3681,강원,24,23,1,10193,2021-07-09 09:00:00.000,2021-09-16 10:11:33.897
7592,71,3357,충북,14,13,1,10192,2021-07-09 09:00:00.000,2021-09-16 10:11:33.897
7593,43,4040,충남,52,51,1,10191,2021-07-09 09:00:00.000,2021-09-16 10:11:33.897
7594,60,2416,전북,8,8,0,10190,2021-07-09 09:00:00.000,2021-09-16 10:11:33.897
7595,17,1698,전남,5,5,0,10189,2021-07-09 09:00:00.000,2021-09-16 10:11:33.897
7596,86,5017,경북,9,9,0,10188,2021-07-09 09:00:00.000,2021-09-16 10:11:33.897
7597,21,5378,경남,17,17,0,10187,2021-07-09 09:00:00.000,2021-09-16 10:11:33.897
7598,1,1352,제주,31,30,1,10186,2021-07-09 09:00:00.000,2021-09-16 10:11:33.897
7599,5,4492,검역,39,0,39,10185,2021-07-09 09:00:00.000,2021-09-16 10:11:33.897
7600,2034,164026,합계,1275,1227,48,10184,2021-07-08 09:00:00.000,2021-09-16 10:11:33.897
7601,518,53072,서울,550,545,5,10183,2021-07-08 09:00:00.000,2021-09-16 10:11:33.897
7602,126,6478,부산,55,55,0,10182,2021-07-08 09:00:00.000,2021-09-16 10:11:33.897
7603,222,10667,대구,15,14,1,10181,2021-07-08 09:00:00.000,2021-09-16 10:11:33.897
7604,61,7040,인천,64,61,3,10180,2021-07-08 09:00:00.000,2021-09-16 10:11:33.897
7605,24,2976,광주,2,2,0,10179,2021-07-08 09:00:00.000,2021-09-16 10:11:33.897
7606,27,2840,대전,13,12,1,10178,2021-07-08 09:00:00.000,2021-09-16 10:11:33.897
7607,40,2865,울산,9,8,1,10177,2021-07-08 09:00:00.000,2021-09-16 10:11:33.897
7608,1,593,세종,5,4,1,10176,2021-07-08 09:00:00.000,2021-09-16 10:11:33.897
7609,659,46263,경기,392,388,4,10175,2021-07-08 09:00:00.000,2021-09-16 10:11:33.897
7610,53,3657,강원,16,15,1,10174,2021-07-08 09:00:00.000,2021-09-16 10:11:33.897
7611,71,3343,충북,8,8,0,10173,2021-07-08 09:00:00.000,2021-09-16 10:11:33.897
7612,43,3988,충남,78,77,1,10172,2021-07-08 09:00:00.000,2021-09-16 10:11:33.897
7613,59,2408,전북,3,3,0,10171,2021-07-08 09:00:00.000,2021-09-16 10:11:33.897
7614,17,1693,전남,9,7,2,10170,2021-07-08 09:00:00.000,2021-09-16 10:11:33.897
7615,86,5008,경북,4,4,0,10169,2021-07-08 09:00:00.000,2021-09-16 10:11:33.897
7616,21,5361,경남,10,7,3,10168,2021-07-08 09:00:00.000,2021-09-16 10:11:33.897
7617,1,1321,제주,17,17,0,10167,2021-07-08 09:00:00.000,2021-09-16 10:11:33.897
7618,5,4453,검역,25,0,25,10166,2021-07-08 09:00:00.000,2021-09-16 10:11:33.897
7619,2033,162751,합계,1211,1166,45,10165,2021-07-07 09:00:00.000,2021-09-16 10:11:33.897
7620,518,52522,서울,582,576,6,10164,2021-07-07 09:00:00.000,2021-09-16 10:11:33.897
7621,126,6423,부산,34,33,1,10163,2021-07-07 09:00:00.000,2021-09-16 10:11:33.897
7622,222,10652,대구,13,12,1,10162,2021-07-07 09:00:00.000,2021-09-16 10:11:33.897
7623,61,6976,인천,57,56,1,10161,2021-07-07 09:00:00.000,2021-09-16 10:11:33.897
7624,24,2974,광주,11,10,1,10160,2021-07-07 09:00:00.000,2021-09-16 10:11:33.897
7625,27,2827,대전,30,29,1,10159,2021-07-07 09:00:00.000,2021-09-16 10:11:33.897
7626,40,2856,울산,1,1,0,10158,2021-07-07 09:00:00.000,2021-09-16 10:11:33.897
7627,1,588,세종,5,5,0,10157,2021-07-07 09:00:00.000,2021-09-16 10:11:33.897
7628,658,45871,경기,367,357,10,10156,2021-07-07 09:00:00.000,2021-09-16 10:11:33.897
7629,53,3641,강원,12,12,0,10155,2021-07-07 09:00:00.000,2021-09-16 10:11:33.897
7630,71,3335,충북,5,5,0,10154,2021-07-07 09:00:00.000,2021-09-16 10:11:33.897
7631,43,3910,충남,16,16,0,10153,2021-07-07 09:00:00.000,2021-09-16 10:11:33.897
7632,59,2405,전북,8,8,0,10152,2021-07-07 09:00:00.000,2021-09-16 10:11:33.897
7633,17,1684,전남,10,10,0,10151,2021-07-07 09:00:00.000,2021-09-16 10:11:33.897
7634,86,5004,경북,6,4,2,10150,2021-07-07 09:00:00.000,2021-09-16 10:11:33.897
7635,21,5351,경남,15,15,0,10149,2021-07-07 09:00:00.000,2021-09-16 10:11:33.897
7636,1,1304,제주,19,17,2,10148,2021-07-07 09:00:00.000,2021-09-16 10:11:33.897
7637,5,4428,검역,20,0,20,10147,2021-07-07 09:00:00.000,2021-09-16 10:11:33.897
7638,2032,161540,합계,746,690,56,10146,2021-07-06 09:00:00.000,2021-09-16 10:11:33.897
7639,518,51940,서울,320,313,7,10145,2021-07-06 09:00:00.000,2021-09-16 10:11:33.897
7640,126,6389,부산,29,27,2,10144,2021-07-06 09:00:00.000,2021-09-16 10:11:33.897
7641,222,10639,대구,8,7,1,10143,2021-07-06 09:00:00.000,2021-09-16 10:11:33.897
7642,61,6919,인천,23,20,3,10142,2021-07-06 09:00:00.000,2021-09-16 10:11:33.897
7643,24,2963,광주,4,4,0,10141,2021-07-06 09:00:00.000,2021-09-16 10:11:33.897
7644,27,2797,대전,26,26,0,10140,2021-07-06 09:00:00.000,2021-09-16 10:11:33.897
7645,40,2855,울산,3,3,0,10139,2021-07-06 09:00:00.000,2021-09-16 10:11:33.897
7646,1,583,세종,5,5,0,10138,2021-07-06 09:00:00.000,2021-09-16 10:11:33.897
7647,658,45504,경기,229,224,5,10137,2021-07-06 09:00:00.000,2021-09-16 10:11:33.897
7648,53,3629,강원,9,6,3,10136,2021-07-06 09:00:00.000,2021-09-16 10:11:33.897
7649,71,3330,충북,2,2,0,10135,2021-07-06 09:00:00.000,2021-09-16 10:11:33.897
7650,43,3894,충남,13,11,2,10134,2021-07-06 09:00:00.000,2021-09-16 10:11:33.897
7651,59,2397,전북,6,6,0,10133,2021-07-06 09:00:00.000,2021-09-16 10:11:33.897
7652,16,1674,전남,4,4,0,10132,2021-07-06 09:00:00.000,2021-09-16 10:11:33.897
7653,86,4998,경북,11,11,0,10131,2021-07-06 09:00:00.000,2021-09-16 10:11:33.897
7654,21,5336,경남,19,17,2,10130,2021-07-06 09:00:00.000,2021-09-16 10:11:33.897
7655,1,1285,제주,5,4,1,10129,2021-07-06 09:00:00.000,2021-09-16 10:11:33.897
7656,5,4408,검역,30,0,30,10128,2021-07-06 09:00:00.000,2021-09-16 10:11:33.897
7657,2028,160794,합계,711,644,67,10127,2021-07-05 09:00:00.000,2021-09-16 10:11:33.897
7658,517,51620,서울,307,301,6,10126,2021-07-05 09:00:00.000,2021-09-16 10:11:33.897
7659,125,6360,부산,25,20,5,10125,2021-07-05 09:00:00.000,2021-09-16 10:11:33.897
7660,222,10631,대구,6,4,2,10124,2021-07-05 09:00:00.000,2021-09-16 10:11:33.897
7661,61,6896,인천,22,16,6,10123,2021-07-05 09:00:00.000,2021-09-16 10:11:33.897
7662,24,2959,광주,7,6,1,10122,2021-07-05 09:00:00.000,2021-09-16 10:11:33.897
7663,27,2771,대전,19,18,1,10121,2021-07-05 09:00:00.000,2021-09-16 10:11:33.897
7664,40,2852,울산,1,1,0,10120,2021-07-05 09:00:00.000,2021-09-16 10:11:33.897
7665,1,578,세종,4,4,0,10119,2021-07-05 09:00:00.000,2021-09-16 10:11:33.897
7666,656,45275,경기,220,210,10,10118,2021-07-05 09:00:00.000,2021-09-16 10:11:33.897
7667,53,3620,강원,7,7,0,10117,2021-07-05 09:00:00.000,2021-09-16 10:11:33.897
7668,71,3328,충북,3,3,0,10116,2021-07-05 09:00:00.000,2021-09-16 10:11:33.897
7669,43,3881,충남,12,10,2,10115,2021-07-05 09:00:00.000,2021-09-16 10:11:33.897
7670,59,2391,전북,6,6,0,10114,2021-07-05 09:00:00.000,2021-09-16 10:11:33.897
7671,16,1670,전남,6,3,3,10113,2021-07-05 09:00:00.000,2021-09-16 10:11:33.897
7672,86,4987,경북,13,10,3,10112,2021-07-05 09:00:00.000,2021-09-16 10:11:33.897
7673,21,5317,경남,22,20,2,10111,2021-07-05 09:00:00.000,2021-09-16 10:11:33.897
7674,1,1280,제주,6,5,1,10110,2021-07-05 09:00:00.000,2021-09-16 10:11:33.897
7675,5,4378,검역,25,0,25,10109,2021-07-05 09:00:00.000,2021-09-16 10:11:33.897
7676,2026,160083,합계,743,662,81,10108,2021-07-04 09:00:00.000,2021-09-16 10:11:33.897
7677,516,51313,서울,289,286,3,10107,2021-07-04 09:00:00.000,2021-09-16 10:11:33.897
7678,125,6335,부산,28,26,2,10106,2021-07-04 09:00:00.000,2021-09-16 10:11:33.897
7679,222,10625,대구,3,2,1,10105,2021-07-04 09:00:00.000,2021-09-16 10:11:33.897
7680,61,6874,인천,33,28,5,10104,2021-07-04 09:00:00.000,2021-09-16 10:11:33.897
7681,24,2952,광주,3,1,2,10103,2021-07-04 09:00:00.000,2021-09-16 10:11:33.897
7682,27,2752,대전,32,32,0,10102,2021-07-04 09:00:00.000,2021-09-16 10:11:33.897
7683,40,2851,울산,13,10,3,10101,2021-07-04 09:00:00.000,2021-09-16 10:11:33.897
7684,1,574,세종,4,4,0,10100,2021-07-04 09:00:00.000,2021-09-16 10:11:33.897
7685,655,45055,경기,231,227,4,10099,2021-07-04 09:00:00.000,2021-09-16 10:11:33.897
7686,53,3613,강원,19,11,8,10098,2021-07-04 09:00:00.000,2021-09-16 10:11:33.897
7687,71,3325,충북,2,2,0,10097,2021-07-04 09:00:00.000,2021-09-16 10:11:33.897
7688,43,3869,충남,7,7,0,10096,2021-07-04 09:00:00.000,2021-09-16 10:11:33.897
7689,59,2385,전북,3,2,1,10095,2021-07-04 09:00:00.000,2021-09-16 10:11:33.897
7690,16,1664,전남,0,0,0,10094,2021-07-04 09:00:00.000,2021-09-16 10:11:33.897
7691,86,4974,경북,9,8,1,10093,2021-07-04 09:00:00.000,2021-09-16 10:11:33.897
7692,21,5295,경남,15,14,1,10092,2021-07-04 09:00:00.000,2021-09-16 10:11:33.897
7693,1,1274,제주,2,2,0,10091,2021-07-04 09:00:00.000,2021-09-16 10:11:33.897
7694,5,4353,검역,50,0,50,10090,2021-07-04 09:00:00.000,2021-09-16 10:11:33.897
7695,2025,159340,합계,794,748,46,10089,2021-07-03 09:00:00.000,2021-09-16 10:11:33.897
7696,516,51024,서울,359,353,6,10088,2021-07-03 09:00:00.000,2021-09-16 10:11:33.897
7697,125,6307,부산,39,35,4,10087,2021-07-03 09:00:00.000,2021-09-16 10:11:33.897
7698,222,10622,대구,8,8,0,10086,2021-07-03 09:00:00.000,2021-09-16 10:11:33.897
7699,61,6841,인천,16,14,2,10085,2021-07-03 09:00:00.000,2021-09-16 10:11:33.897
7700,24,2949,광주,3,3,0,10084,2021-07-03 09:00:00.000,2021-09-16 10:11:33.897
7701,27,2720,대전,28,28,0,10083,2021-07-03 09:00:00.000,2021-09-16 10:11:33.897
7702,40,2838,울산,1,0,1,10082,2021-07-03 09:00:00.000,2021-09-16 10:11:33.897
7703,1,570,세종,3,3,0,10081,2021-07-03 09:00:00.000,2021-09-16 10:11:33.897
7704,654,44824,경기,252,247,5,10080,2021-07-03 09:00:00.000,2021-09-16 10:11:33.897
7705,53,3594,강원,11,11,0,10079,2021-07-03 09:00:00.000,2021-09-16 10:11:33.897
7706,71,3323,충북,6,5,1,10078,2021-07-03 09:00:00.000,2021-09-16 10:11:33.897
7707,43,3862,충남,16,16,0,10077,2021-07-03 09:00:00.000,2021-09-16 10:11:33.897
7708,59,2382,전북,4,4,0,10076,2021-07-03 09:00:00.000,2021-09-16 10:11:33.897
7709,16,1664,전남,7,6,1,10075,2021-07-03 09:00:00.000,2021-09-16 10:11:33.897
7710,86,4965,경북,4,3,1,10074,2021-07-03 09:00:00.000,2021-09-16 10:11:33.897
7711,21,5280,경남,10,8,2,10073,2021-07-03 09:00:00.000,2021-09-16 10:11:33.897
7712,1,1272,제주,4,4,0,10072,2021-07-03 09:00:00.000,2021-09-16 10:11:33.897
7713,5,4303,검역,23,0,23,10071,2021-07-03 09:00:00.000,2021-09-16 10:11:33.897
7714,2024,158546,합계,825,765,60,10070,2021-07-02 09:00:00.000,2021-09-16 10:11:33.897
7715,515,50665,서울,346,337,9,10069,2021-07-02 09:00:00.000,2021-09-16 10:11:33.897
7716,125,6268,부산,29,25,4,10068,2021-07-02 09:00:00.000,2021-09-16 10:11:33.897
7717,222,10614,대구,9,8,1,10067,2021-07-02 09:00:00.000,2021-09-16 10:11:33.897
7718,61,6825,인천,22,22,0,10066,2021-07-02 09:00:00.000,2021-09-16 10:11:33.897
7719,24,2946,광주,2,2,0,10065,2021-07-02 09:00:00.000,2021-09-16 10:11:33.897
7720,27,2692,대전,25,25,0,10064,2021-07-02 09:00:00.000,2021-09-16 10:11:33.897
7721,40,2837,울산,11,10,1,10063,2021-07-02 09:00:00.000,2021-09-16 10:11:33.897
7722,1,567,세종,2,2,0,10062,2021-07-02 09:00:00.000,2021-09-16 10:11:33.897
7723,654,44572,경기,264,260,4,10061,2021-07-02 09:00:00.000,2021-09-16 10:11:33.897
7724,53,3583,강원,14,7,7,10060,2021-07-02 09:00:00.000,2021-09-16 10:11:33.897
7725,71,3317,충북,7,7,0,10059,2021-07-02 09:00:00.000,2021-09-16 10:11:33.897
7726,43,3846,충남,27,27,0,10058,2021-07-02 09:00:00.000,2021-09-16 10:11:33.897
7727,59,2378,전북,7,7,0,10057,2021-07-02 09:00:00.000,2021-09-16 10:11:33.897
7728,16,1657,전남,4,4,0,10056,2021-07-02 09:00:00.000,2021-09-16 10:11:33.897
7729,86,4961,경북,7,7,0,10055,2021-07-02 09:00:00.000,2021-09-16 10:11:33.897
7730,21,5270,경남,13,12,1,10054,2021-07-02 09:00:00.000,2021-09-16 10:11:33.897
7731,1,1268,제주,3,3,0,10053,2021-07-02 09:00:00.000,2021-09-16 10:11:33.897
7732,5,4280,검역,33,0,33,10052,2021-07-02 09:00:00.000,2021-09-16 10:11:33.897
7733,2021,157721,합계,761,711,50,10051,2021-07-01 09:00:00.000,2021-09-16 10:11:33.897
7734,514,50319,서울,333,331,2,10050,2021-07-01 09:00:00.000,2021-09-16 10:11:33.897
7735,125,6239,부산,18,17,1,10049,2021-07-01 09:00:00.000,2021-09-16 10:11:33.897
7736,222,10605,대구,7,7,0,10048,2021-07-01 09:00:00.000,2021-09-16 10:11:33.897
7737,61,6803,인천,36,30,6,10047,2021-07-01 09:00:00.000,2021-09-16 10:11:33.897
7738,24,2944,광주,7,7,0,10046,2021-07-01 09:00:00.000,2021-09-16 10:11:33.897
7739,27,2667,대전,16,16,0,10045,2021-07-01 09:00:00.000,2021-09-16 10:11:33.897
7740,40,2826,울산,2,1,1,10044,2021-07-01 09:00:00.000,2021-09-16 10:11:33.897
7741,1,565,세종,5,5,0,10043,2021-07-01 09:00:00.000,2021-09-16 10:11:33.897
7742,654,44308,경기,249,245,4,10042,2021-07-01 09:00:00.000,2021-09-16 10:11:33.897
7743,53,3569,강원,10,8,2,10041,2021-07-01 09:00:00.000,2021-09-16 10:11:33.897
7744,70,3310,충북,4,4,0,10040,2021-07-01 09:00:00.000,2021-09-16 10:11:33.897
7745,43,3819,충남,15,13,2,10039,2021-07-01 09:00:00.000,2021-09-16 10:11:33.897
7746,59,2371,전북,7,7,0,10038,2021-07-01 09:00:00.000,2021-09-16 10:11:33.897
7747,16,1653,전남,5,5,0,10037,2021-07-01 09:00:00.000,2021-09-16 10:11:33.897
7748,86,4954,경북,5,4,1,10036,2021-07-01 09:00:00.000,2021-09-16 10:11:33.897
7749,20,5257,경남,10,10,0,10035,2021-07-01 09:00:00.000,2021-09-16 10:11:33.897
7750,1,1265,제주,1,1,0,10034,2021-07-01 09:00:00.000,2021-09-16 10:11:33.897
7751,5,4247,검역,31,0,31,10033,2021-07-01 09:00:00.000,2021-09-16 10:11:33.897
7752,2018,156960,합계,794,759,35,10032,2021-06-30 09:00:00.000,2021-09-16 10:11:33.897
7753,513,49986,서울,375,368,7,10031,2021-06-30 09:00:00.000,2021-09-16 10:11:33.897
7754,124,6221,부산,14,13,1,10030,2021-06-30 09:00:00.000,2021-09-16 10:11:33.897
7755,222,10598,대구,11,11,0,10029,2021-06-30 09:00:00.000,2021-09-16 10:11:33.897
7756,61,6767,인천,30,29,1,10028,2021-06-30 09:00:00.000,2021-09-16 10:11:33.897
7757,24,2937,광주,6,6,0,10027,2021-06-30 09:00:00.000,2021-09-16 10:11:33.897
7758,27,2651,대전,26,26,0,10026,2021-06-30 09:00:00.000,2021-09-16 10:11:33.897
7759,40,2824,울산,4,4,0,10025,2021-06-30 09:00:00.000,2021-09-16 10:11:33.897
7760,1,560,세종,3,3,0,10024,2021-06-30 09:00:00.000,2021-09-16 10:11:33.897
7761,654,44059,경기,240,234,6,10023,2021-06-30 09:00:00.000,2021-09-16 10:11:33.897
7762,53,3559,강원,15,14,1,10022,2021-06-30 09:00:00.000,2021-09-16 10:11:33.897
7763,70,3306,충북,5,5,0,10021,2021-06-30 09:00:00.000,2021-09-16 10:11:33.897
7764,43,3804,충남,8,8,0,10020,2021-06-30 09:00:00.000,2021-09-16 10:11:33.897
7765,59,2364,전북,10,10,0,10019,2021-06-30 09:00:00.000,2021-09-16 10:11:33.897
7766,15,1648,전남,7,7,0,10018,2021-06-30 09:00:00.000,2021-09-16 10:11:33.897
7767,86,4949,경북,4,3,1,10017,2021-06-30 09:00:00.000,2021-09-16 10:11:33.897
7768,20,5247,경남,17,16,1,10016,2021-06-30 09:00:00.000,2021-09-16 10:11:33.897
7769,1,1264,제주,2,2,0,10015,2021-06-30 09:00:00.000,2021-09-16 10:11:33.897
7770,5,4216,검역,17,0,17,10014,2021-06-30 09:00:00.000,2021-09-16 10:11:33.897
7771,2017,156166,합계,595,560,35,10013,2021-06-29 09:00:00.000,2021-09-16 10:11:33.897
7772,513,49611,서울,205,201,4,10012,2021-06-29 09:00:00.000,2021-09-16 10:11:33.897
7773,124,6207,부산,9,6,3,10011,2021-06-29 09:00:00.000,2021-09-16 10:11:33.897
7774,222,10587,대구,8,6,2,10010,2021-06-29 09:00:00.000,2021-09-16 10:11:33.897
7775,61,6737,인천,17,17,0,10009,2021-06-29 09:00:00.000,2021-09-16 10:11:33.897
7776,24,2931,광주,2,2,0,10008,2021-06-29 09:00:00.000,2021-09-16 10:11:33.897
7777,27,2625,대전,25,25,0,10007,2021-06-29 09:00:00.000,2021-09-16 10:11:33.897
7778,40,2820,울산,13,13,0,10006,2021-06-29 09:00:00.000,2021-09-16 10:11:33.897
7779,1,557,세종,3,3,0,10005,2021-06-29 09:00:00.000,2021-09-16 10:11:33.897
7780,654,43819,경기,230,228,2,10004,2021-06-29 09:00:00.000,2021-09-16 10:11:33.897
7781,53,3544,강원,8,8,0,10003,2021-06-29 09:00:00.000,2021-09-16 10:11:33.897
7782,70,3301,충북,10,7,3,10002,2021-06-29 09:00:00.000,2021-09-16 10:11:33.897
7783,42,3796,충남,11,11,0,10001,2021-06-29 09:00:00.000,2021-09-16 10:11:33.897
7784,59,2354,전북,7,7,0,10000,2021-06-29 09:00:00.000,2021-09-16 10:11:33.897
7785,15,1641,전남,4,2,2,9999,2021-06-29 09:00:00.000,2021-09-16 10:11:33.897
7786,86,4945,경북,6,5,1,9998,2021-06-29 09:00:00.000,2021-09-16 10:11:33.897
7787,20,5230,경남,15,13,2,9997,2021-06-29 09:00:00.000,2021-09-16 10:11:33.897
7788,1,1262,제주,6,6,0,9996,2021-06-29 09:00:00.000,2021-09-16 10:11:33.897
7789,5,4199,검역,16,0,16,9995,2021-06-29 09:00:00.000,2021-09-16 10:11:33.897
7790,2015,155571,합계,501,472,29,9994,2021-06-28 09:00:00.000,2021-09-16 10:11:33.897
7791,513,49406,서울,185,179,6,9993,2021-06-28 09:00:00.000,2021-09-16 10:11:33.897
7792,124,6198,부산,38,37,1,9992,2021-06-28 09:00:00.000,2021-09-16 10:11:33.897
7793,222,10579,대구,5,5,0,9991,2021-06-28 09:00:00.000,2021-09-16 10:11:33.897
7794,61,6720,인천,31,30,1,9990,2021-06-28 09:00:00.000,2021-09-16 10:11:33.897
7795,24,2929,광주,7,6,1,9989,2021-06-28 09:00:00.000,2021-09-16 10:11:33.897
7796,27,2600,대전,7,7,0,9988,2021-06-28 09:00:00.000,2021-09-16 10:11:33.897
7797,40,2807,울산,8,7,1,9987,2021-06-28 09:00:00.000,2021-09-16 10:11:33.897
7798,1,554,세종,0,0,0,9986,2021-06-28 09:00:00.000,2021-09-16 10:11:33.897
7799,652,43589,경기,162,157,5,9985,2021-06-28 09:00:00.000,2021-09-16 10:11:33.897
7800,53,3536,강원,17,16,1,9984,2021-06-28 09:00:00.000,2021-09-16 10:11:33.897
7801,70,3291,충북,5,5,0,9983,2021-06-28 09:00:00.000,2021-09-16 10:11:33.897
7802,42,3785,충남,8,6,2,9982,2021-06-28 09:00:00.000,2021-09-16 10:11:33.897
7803,59,2347,전북,2,2,0,9981,2021-06-28 09:00:00.000,2021-09-16 10:11:33.897
7804,15,1637,전남,2,2,0,9980,2021-06-28 09:00:00.000,2021-09-16 10:11:33.897
7805,86,4939,경북,1,1,0,9979,2021-06-28 09:00:00.000,2021-09-16 10:11:33.897
7806,20,5215,경남,10,10,0,9978,2021-06-28 09:00:00.000,2021-09-16 10:11:33.897
7807,1,1256,제주,2,2,0,9977,2021-06-28 09:00:00.000,2021-09-16 10:11:33.897
7808,5,4183,검역,11,0,11,9976,2021-06-28 09:00:00.000,2021-09-16 10:11:33.897
7809,2013,155070,합계,614,570,44,9975,2021-06-27 09:00:00.000,2021-09-16 10:11:33.897
7810,512,49221,서울,242,242,0,9974,2021-06-27 09:00:00.000,2021-09-16 10:11:33.897
7811,124,6160,부산,12,12,0,9973,2021-06-27 09:00:00.000,2021-09-16 10:11:33.897
7812,222,10574,대구,8,8,0,9972,2021-06-27 09:00:00.000,2021-09-16 10:11:33.897
7813,61,6689,인천,25,24,1,9971,2021-06-27 09:00:00.000,2021-09-16 10:11:33.897
7814,24,2922,광주,12,12,0,9970,2021-06-27 09:00:00.000,2021-09-16 10:11:33.897
7815,27,2593,대전,15,15,0,9969,2021-06-27 09:00:00.000,2021-09-16 10:11:33.897
7816,40,2799,울산,6,3,3,9968,2021-06-27 09:00:00.000,2021-09-16 10:11:33.897
7817,1,554,세종,8,8,0,9967,2021-06-27 09:00:00.000,2021-09-16 10:11:33.897
7818,652,43427,경기,173,171,2,9966,2021-06-27 09:00:00.000,2021-09-16 10:11:33.897
7819,52,3519,강원,19,19,0,9965,2021-06-27 09:00:00.000,2021-09-16 10:11:33.897
7820,70,3286,충북,4,3,1,9964,2021-06-27 09:00:00.000,2021-09-16 10:11:33.897
7821,42,3777,충남,24,23,1,9963,2021-06-27 09:00:00.000,2021-09-16 10:11:33.897
7822,59,2345,전북,6,6,0,9962,2021-06-27 09:00:00.000,2021-09-16 10:11:33.897
7823,15,1635,전남,6,5,1,9961,2021-06-27 09:00:00.000,2021-09-16 10:11:33.897
7824,86,4938,경북,4,4,0,9960,2021-06-27 09:00:00.000,2021-09-16 10:11:33.897
7825,20,5205,경남,14,13,1,9959,2021-06-27 09:00:00.000,2021-09-16 10:11:33.897
7826,1,1254,제주,2,2,0,9958,2021-06-27 09:00:00.000,2021-09-16 10:11:33.897
7827,5,4172,검역,34,0,34,9957,2021-06-27 09:00:00.000,2021-09-16 10:11:33.897
7828,2012,154456,합계,668,611,57,9956,2021-06-26 09:00:00.000,2021-09-16 10:11:33.897
7829,512,48979,서울,263,260,3,9955,2021-06-26 09:00:00.000,2021-09-16 10:11:33.897
7830,124,6148,부산,31,28,3,9954,2021-06-26 09:00:00.000,2021-09-16 10:11:33.897
7831,222,10566,대구,13,13,0,9953,2021-06-26 09:00:00.000,2021-09-16 10:11:33.897
7832,61,6664,인천,12,12,0,9952,2021-06-26 09:00:00.000,2021-09-16 10:11:33.897
7833,24,2910,광주,8,7,1,9951,2021-06-26 09:00:00.000,2021-09-16 10:11:33.897
7834,27,2578,대전,13,12,1,9950,2021-06-26 09:00:00.000,2021-09-16 10:11:33.897
7835,40,2793,울산,22,22,0,9949,2021-06-26 09:00:00.000,2021-09-16 10:11:33.897
7836,1,546,세종,2,2,0,9948,2021-06-26 09:00:00.000,2021-09-16 10:11:33.897
7837,652,43254,경기,188,185,3,9947,2021-06-26 09:00:00.000,2021-09-16 10:11:33.897
7838,52,3500,강원,35,23,12,9946,2021-06-26 09:00:00.000,2021-09-16 10:11:33.897
7839,70,3282,충북,5,5,0,9945,2021-06-26 09:00:00.000,2021-09-16 10:11:33.897
7840,42,3753,충남,7,6,1,9944,2021-06-26 09:00:00.000,2021-09-16 10:11:33.897
7841,58,2339,전북,5,3,2,9943,2021-06-26 09:00:00.000,2021-09-16 10:11:33.897
7842,15,1629,전남,3,3,0,9942,2021-06-26 09:00:00.000,2021-09-16 10:11:33.897
7843,86,4934,경북,9,9,0,9941,2021-06-26 09:00:00.000,2021-09-16 10:11:33.897
7844,20,5191,경남,12,12,0,9940,2021-06-26 09:00:00.000,2021-09-16 10:11:33.897
7845,1,1252,제주,9,9,0,9939,2021-06-26 09:00:00.000,2021-09-16 10:11:33.897
7846,5,4138,검역,31,0,31,9938,2021-06-26 09:00:00.000,2021-09-16 10:11:33.897
7847,2009,153788,합계,634,602,32,9937,2021-06-25 09:00:00.000,2021-09-16 10:11:33.897
7848,511,48716,서울,269,264,5,9936,2021-06-25 09:00:00.000,2021-09-16 10:11:33.897
7849,124,6117,부산,27,27,0,9935,2021-06-25 09:00:00.000,2021-09-16 10:11:33.897
7850,222,10553,대구,5,5,0,9934,2021-06-25 09:00:00.000,2021-09-16 10:11:33.897
7851,61,6652,인천,29,24,5,9933,2021-06-25 09:00:00.000,2021-09-16 10:11:33.897
7852,24,2902,광주,5,5,0,9932,2021-06-25 09:00:00.000,2021-09-16 10:11:33.897
7853,27,2565,대전,9,8,1,9931,2021-06-25 09:00:00.000,2021-09-16 10:11:33.897
7854,40,2771,울산,16,16,0,9930,2021-06-25 09:00:00.000,2021-09-16 10:11:33.897
7855,1,544,세종,2,2,0,9929,2021-06-25 09:00:00.000,2021-09-16 10:11:33.897
7856,651,43066,경기,183,179,4,9928,2021-06-25 09:00:00.000,2021-09-16 10:11:33.897
7857,52,3465,강원,13,13,0,9927,2021-06-25 09:00:00.000,2021-09-16 10:11:33.897
7858,70,3277,충북,10,10,0,9926,2021-06-25 09:00:00.000,2021-09-16 10:11:33.897
7859,41,3746,충남,4,4,0,9925,2021-06-25 09:00:00.000,2021-09-16 10:11:33.897
7860,58,2334,전북,2,1,1,9924,2021-06-25 09:00:00.000,2021-09-16 10:11:33.897
7861,15,1626,전남,18,17,1,9923,2021-06-25 09:00:00.000,2021-09-16 10:11:33.897
7862,86,4925,경북,7,6,1,9922,2021-06-25 09:00:00.000,2021-09-16 10:11:33.897
7863,20,5179,경남,17,17,0,9921,2021-06-25 09:00:00.000,2021-09-16 10:11:33.897
7864,1,1243,제주,5,4,1,9920,2021-06-25 09:00:00.000,2021-09-16 10:11:33.897
7865,5,4107,검역,13,0,13,9919,2021-06-25 09:00:00.000,2021-09-16 10:11:33.897
7866,2008,153154,합계,610,576,34,9918,2021-06-24 09:00:00.000,2021-09-16 10:11:33.897
7867,510,48447,서울,252,251,1,9917,2021-06-24 09:00:00.000,2021-09-16 10:11:33.897
7868,124,6090,부산,20,16,4,9916,2021-06-24 09:00:00.000,2021-09-16 10:11:33.897
7869,222,10548,대구,3,3,0,9915,2021-06-24 09:00:00.000,2021-09-16 10:11:33.897
7870,61,6623,인천,15,15,0,9914,2021-06-24 09:00:00.000,2021-09-16 10:11:33.897
7871,24,2897,광주,1,1,0,9913,2021-06-24 09:00:00.000,2021-09-16 10:11:33.897
7872,27,2556,대전,15,15,0,9912,2021-06-24 09:00:00.000,2021-09-16 10:11:33.897
7873,40,2755,울산,13,11,2,9911,2021-06-24 09:00:00.000,2021-09-16 10:11:33.897
7874,1,542,세종,1,1,0,9910,2021-06-24 09:00:00.000,2021-09-16 10:11:33.897
7875,651,42883,경기,185,184,1,9909,2021-06-24 09:00:00.000,2021-09-16 10:11:33.897
7876,52,3452,강원,5,5,0,9908,2021-06-24 09:00:00.000,2021-09-16 10:11:33.897
7877,70,3267,충북,6,5,1,9907,2021-06-24 09:00:00.000,2021-09-16 10:11:33.897
7878,41,3742,충남,7,7,0,9906,2021-06-24 09:00:00.000,2021-09-16 10:11:33.897
7879,58,2332,전북,6,6,0,9905,2021-06-24 09:00:00.000,2021-09-16 10:11:33.897
7880,15,1608,전남,6,3,3,9904,2021-06-24 09:00:00.000,2021-09-16 10:11:33.897
7881,86,4918,경북,29,28,1,9903,2021-06-24 09:00:00.000,2021-09-16 10:11:33.897
7882,20,5162,경남,23,22,1,9902,2021-06-24 09:00:00.000,2021-09-16 10:11:33.897
7883,1,1238,제주,4,3,1,9901,2021-06-24 09:00:00.000,2021-09-16 10:11:33.897
7884,5,4094,검역,19,0,19,9900,2021-06-24 09:00:00.000,2021-09-16 10:11:33.897
7885,2007,152544,합계,645,605,40,9899,2021-06-23 09:00:00.000,2021-09-16 10:11:33.897
7886,510,48195,서울,236,228,8,9898,2021-06-23 09:00:00.000,2021-09-16 10:11:33.897
7887,124,6070,부산,16,13,3,9897,2021-06-23 09:00:00.000,2021-09-16 10:11:33.897
7888,222,10545,대구,7,6,1,9896,2021-06-23 09:00:00.000,2021-09-16 10:11:33.897
7889,61,6608,인천,28,26,2,9895,2021-06-23 09:00:00.000,2021-09-16 10:11:33.897
7890,24,2896,광주,4,4,0,9894,2021-06-23 09:00:00.000,2021-09-16 10:11:33.897
7891,27,2541,대전,58,57,1,9893,2021-06-23 09:00:00.000,2021-09-16 10:11:33.897
7892,40,2742,울산,5,5,0,9892,2021-06-23 09:00:00.000,2021-09-16 10:11:33.897
7893,1,541,세종,8,7,1,9891,2021-06-23 09:00:00.000,2021-09-16 10:11:33.897
7894,650,42698,경기,191,180,11,9890,2021-06-23 09:00:00.000,2021-09-16 10:11:33.897
7895,52,3447,강원,17,17,0,9889,2021-06-23 09:00:00.000,2021-09-16 10:11:33.897
7896,70,3261,충북,10,10,0,9888,2021-06-23 09:00:00.000,2021-09-16 10:11:33.897
7897,41,3735,충남,9,9,0,9887,2021-06-23 09:00:00.000,2021-09-16 10:11:33.897
7898,58,2326,전북,2,2,0,9886,2021-06-23 09:00:00.000,2021-09-16 10:11:33.897
7899,15,1602,전남,2,2,0,9885,2021-06-23 09:00:00.000,2021-09-16 10:11:33.897
7900,86,4889,경북,21,21,0,9884,2021-06-23 09:00:00.000,2021-09-16 10:11:33.897
7901,20,5139,경남,18,18,0,9883,2021-06-23 09:00:00.000,2021-09-16 10:11:33.897
7902,1,1234,제주,0,0,0,9882,2021-06-23 09:00:00.000,2021-09-16 10:11:33.897
7903,5,4075,검역,13,0,13,9881,2021-06-23 09:00:00.000,2021-09-16 10:11:33.897
7904,2006,151899,합계,394,350,44,9880,2021-06-22 09:00:00.000,2021-09-16 10:11:33.897
7905,509,47959,서울,131,125,6,9879,2021-06-22 09:00:00.000,2021-09-16 10:11:33.897
7906,124,6054,부산,6,6,0,9878,2021-06-22 09:00:00.000,2021-09-16 10:11:33.897
7907,222,10538,대구,3,3,0,9877,2021-06-22 09:00:00.000,2021-09-16 10:11:33.897
7908,61,6580,인천,18,15,3,9876,2021-06-22 09:00:00.000,2021-09-16 10:11:33.897
7909,24,2892,광주,2,2,0,9875,2021-06-22 09:00:00.000,2021-09-16 10:11:33.897
7910,27,2483,대전,31,30,1,9874,2021-06-22 09:00:00.000,2021-09-16 10:11:33.897
7911,40,2737,울산,5,4,1,9873,2021-06-22 09:00:00.000,2021-09-16 10:11:33.897
7912,1,533,세종,6,6,0,9872,2021-06-22 09:00:00.000,2021-09-16 10:11:33.897
7913,650,42507,경기,92,92,0,9871,2021-06-22 09:00:00.000,2021-09-16 10:11:33.897
7914,52,3430,강원,10,10,0,9870,2021-06-22 09:00:00.000,2021-09-16 10:11:33.897
7915,70,3251,충북,16,16,0,9869,2021-06-22 09:00:00.000,2021-09-16 10:11:33.897
7916,41,3726,충남,12,11,1,9868,2021-06-22 09:00:00.000,2021-09-16 10:11:33.897
7917,58,2324,전북,2,2,0,9867,2021-06-22 09:00:00.000,2021-09-16 10:11:33.897
7918,15,1600,전남,8,6,2,9866,2021-06-22 09:00:00.000,2021-09-16 10:11:33.897
7919,86,4868,경북,11,10,1,9865,2021-06-22 09:00:00.000,2021-09-16 10:11:33.897
7920,20,5121,경남,11,11,0,9864,2021-06-22 09:00:00.000,2021-09-16 10:11:33.897
7921,1,1234,제주,1,1,0,9863,2021-06-22 09:00:00.000,2021-09-16 10:11:33.897
7922,5,4062,검역,29,0,29,9862,2021-06-22 09:00:00.000,2021-09-16 10:11:33.897
7923,2004,151505,합계,357,317,40,9861,2021-06-21 09:00:00.000,2021-09-16 10:11:33.897
7924,508,47828,서울,134,127,7,9860,2021-06-21 09:00:00.000,2021-09-16 10:11:33.897
7925,124,6048,부산,14,11,3,9859,2021-06-21 09:00:00.000,2021-09-16 10:11:33.897
7926,222,10535,대구,18,16,2,9858,2021-06-21 09:00:00.000,2021-09-16 10:11:33.897
7927,61,6562,인천,9,7,2,9857,2021-06-21 09:00:00.000,2021-09-16 10:11:33.897
7928,24,2890,광주,2,1,1,9856,2021-06-21 09:00:00.000,2021-09-16 10:11:33.897
7929,27,2452,대전,15,14,1,9855,2021-06-21 09:00:00.000,2021-09-16 10:11:33.897
7930,40,2732,울산,0,0,0,9854,2021-06-21 09:00:00.000,2021-09-16 10:11:33.897
7931,1,527,세종,2,2,0,9853,2021-06-21 09:00:00.000,2021-09-16 10:11:33.897
7932,650,42415,경기,91,88,3,9852,2021-06-21 09:00:00.000,2021-09-16 10:11:33.897
7933,52,3420,강원,9,7,2,9851,2021-06-21 09:00:00.000,2021-09-16 10:11:33.897
7934,69,3235,충북,3,2,1,9850,2021-06-21 09:00:00.000,2021-09-16 10:11:33.897
7935,41,3714,충남,11,11,0,9849,2021-06-21 09:00:00.000,2021-09-16 10:11:33.897
7936,58,2322,전북,3,3,0,9848,2021-06-21 09:00:00.000,2021-09-16 10:11:33.897
7937,15,1592,전남,10,10,0,9847,2021-06-21 09:00:00.000,2021-09-16 10:11:33.897
7938,86,4857,경북,8,6,2,9846,2021-06-21 09:00:00.000,2021-09-16 10:11:33.897
7939,20,5110,경남,13,10,3,9845,2021-06-21 09:00:00.000,2021-09-16 10:11:33.897
7940,1,1233,제주,3,2,1,9844,2021-06-21 09:00:00.000,2021-09-16 10:11:33.897
7941,5,4033,검역,12,0,12,9843,2021-06-21 09:00:00.000,2021-09-16 10:11:33.897
7942,2002,151148,합계,429,380,49,9842,2021-06-20 09:00:00.000,2021-09-16 10:11:33.897
7943,507,47694,서울,165,152,13,9841,2021-06-20 09:00:00.000,2021-09-16 10:11:33.897
7944,124,6034,부산,21,14,7,9840,2021-06-20 09:00:00.000,2021-09-16 10:11:33.897
7945,222,10517,대구,16,15,1,9839,2021-06-20 09:00:00.000,2021-09-16 10:11:33.897
7946,61,6553,인천,22,19,3,9838,2021-06-20 09:00:00.000,2021-09-16 10:11:33.897
7947,23,2888,광주,3,2,1,9837,2021-06-20 09:00:00.000,2021-09-16 10:11:33.897
7948,27,2437,대전,8,8,0,9836,2021-06-20 09:00:00.000,2021-09-16 10:11:33.897
7949,40,2732,울산,5,5,0,9835,2021-06-20 09:00:00.000,2021-09-16 10:11:33.897
7950,1,525,세종,3,2,1,9834,2021-06-20 09:00:00.000,2021-09-16 10:11:33.897
7951,650,42324,경기,113,111,2,9833,2021-06-20 09:00:00.000,2021-09-16 10:11:33.897
7952,52,3411,강원,13,13,0,9832,2021-06-20 09:00:00.000,2021-09-16 10:11:33.897
7953,69,3232,충북,6,6,0,9831,2021-06-20 09:00:00.000,2021-09-16 10:11:33.897
7954,41,3703,충남,10,10,0,9830,2021-06-20 09:00:00.000,2021-09-16 10:11:33.897
7955,58,2319,전북,3,3,0,9829,2021-06-20 09:00:00.000,2021-09-16 10:11:33.897
7956,15,1582,전남,3,3,0,9828,2021-06-20 09:00:00.000,2021-09-16 10:11:33.897
7957,86,4849,경북,6,5,1,9827,2021-06-20 09:00:00.000,2021-09-16 10:11:33.897
7958,20,5097,경남,11,10,1,9826,2021-06-20 09:00:00.000,2021-09-16 10:11:33.897
7959,1,1230,제주,2,2,0,9825,2021-06-20 09:00:00.000,2021-09-16 10:11:33.897
7960,5,4021,검역,19,0,19,9824,2021-06-20 09:00:00.000,2021-09-16 10:11:33.897
7961,1997,150719,합계,482,456,26,9823,2021-06-19 09:00:00.000,2021-09-16 10:11:33.897
7962,506,47529,서울,197,193,4,9822,2021-06-19 09:00:00.000,2021-09-16 10:11:33.897
7963,124,6013,부산,18,15,3,9821,2021-06-19 09:00:00.000,2021-09-16 10:11:33.897
7964,222,10501,대구,13,13,0,9820,2021-06-19 09:00:00.000,2021-09-16 10:11:33.897
7965,61,6531,인천,22,20,2,9819,2021-06-19 09:00:00.000,2021-09-16 10:11:33.897
7966,23,2885,광주,4,4,0,9818,2021-06-19 09:00:00.000,2021-09-16 10:11:33.897
7967,25,2429,대전,5,5,0,9817,2021-06-19 09:00:00.000,2021-09-16 10:11:33.897
7968,40,2727,울산,5,5,0,9816,2021-06-19 09:00:00.000,2021-09-16 10:11:33.897
7969,1,522,세종,2,2,0,9815,2021-06-19 09:00:00.000,2021-09-16 10:11:33.897
7970,649,42211,경기,145,141,4,9814,2021-06-19 09:00:00.000,2021-09-16 10:11:33.897
7971,51,3398,강원,5,5,0,9813,2021-06-19 09:00:00.000,2021-09-16 10:11:33.897
7972,69,3226,충북,10,10,0,9812,2021-06-19 09:00:00.000,2021-09-16 10:11:33.897
7973,41,3693,충남,12,12,0,9811,2021-06-19 09:00:00.000,2021-09-16 10:11:33.897
7974,58,2316,전북,5,5,0,9810,2021-06-19 09:00:00.000,2021-09-16 10:11:33.897
7975,15,1579,전남,5,5,0,9809,2021-06-19 09:00:00.000,2021-09-16 10:11:33.897
7976,86,4843,경북,4,4,0,9808,2021-06-19 09:00:00.000,2021-09-16 10:11:33.897
7977,20,5086,경남,11,10,1,9807,2021-06-19 09:00:00.000,2021-09-16 10:11:33.897
7978,1,1228,제주,7,7,0,9806,2021-06-19 09:00:00.000,2021-09-16 10:11:33.897
7979,5,4002,검역,12,0,12,9805,2021-06-19 09:00:00.000,2021-09-16 10:11:33.897
7980,1996,150237,합계,507,485,22,9804,2021-06-18 09:00:00.000,2021-09-16 10:11:33.897
7981,505,47332,서울,200,197,3,9803,2021-06-18 09:00:00.000,2021-09-16 10:11:33.897
7982,124,5995,부산,10,9,1,9802,2021-06-18 09:00:00.000,2021-09-16 10:11:33.897
7983,222,10488,대구,11,11,0,9801,2021-06-18 09:00:00.000,2021-09-16 10:11:33.897
7984,61,6509,인천,22,21,1,9800,2021-06-18 09:00:00.000,2021-09-16 10:11:33.897
7985,23,2881,광주,2,1,1,9799,2021-06-18 09:00:00.000,2021-09-16 10:11:33.897
7986,25,2424,대전,13,12,1,9798,2021-06-18 09:00:00.000,2021-09-16 10:11:33.897
7987,40,2722,울산,11,11,0,9797,2021-06-18 09:00:00.000,2021-09-16 10:11:33.897
7988,1,520,세종,1,1,0,9796,2021-06-18 09:00:00.000,2021-09-16 10:11:33.897
7989,649,42066,경기,153,152,1,9795,2021-06-18 09:00:00.000,2021-09-16 10:11:33.897
7990,51,3393,강원,9,9,0,9794,2021-06-18 09:00:00.000,2021-09-16 10:11:33.897
7991,69,3216,충북,19,19,0,9793,2021-06-18 09:00:00.000,2021-09-16 10:11:33.897
7992,41,3681,충남,7,7,0,9792,2021-06-18 09:00:00.000,2021-09-16 10:11:33.897
7993,58,2311,전북,4,3,1,9791,2021-06-18 09:00:00.000,2021-09-16 10:11:33.897
7994,15,1574,전남,4,4,0,9790,2021-06-18 09:00:00.000,2021-09-16 10:11:33.897
7995,86,4839,경북,11,10,1,9789,2021-06-18 09:00:00.000,2021-09-16 10:11:33.897
7996,20,5075,경남,14,12,2,9788,2021-06-18 09:00:00.000,2021-09-16 10:11:33.897
7997,1,1221,제주,6,6,0,9787,2021-06-18 09:00:00.000,2021-09-16 10:11:33.897
7998,5,3990,검역,10,0,10,9786,2021-06-18 09:00:00.000,2021-09-16 10:11:33.897
7999,1994,149730,합계,540,523,17,9785,2021-06-17 09:00:00.000,2021-09-16 10:11:33.897
8000,504,47132,서울,201,199,2,9784,2021-06-17 09:00:00.000,2021-09-16 10:11:33.897
8001,124,5985,부산,17,15,2,9783,2021-06-17 09:00:00.000,2021-09-16 10:11:33.897
8002,222,10477,대구,7,7,0,9782,2021-06-17 09:00:00.000,2021-09-16 10:11:33.897
8003,61,6487,인천,17,17,0,9781,2021-06-17 09:00:00.000,2021-09-16 10:11:33.897
8004,23,2879,광주,6,6,0,9780,2021-06-17 09:00:00.000,2021-09-16 10:11:33.897
8005,25,2411,대전,18,18,0,9779,2021-06-17 09:00:00.000,2021-09-16 10:11:33.897
8006,40,2711,울산,22,22,0,9778,2021-06-17 09:00:00.000,2021-09-16 10:11:33.897
8007,1,519,세종,2,1,1,9777,2021-06-17 09:00:00.000,2021-09-16 10:11:33.897
8008,648,41913,경기,183,181,2,9776,2021-06-17 09:00:00.000,2021-09-16 10:11:33.897
8009,51,3384,강원,7,6,1,9775,2021-06-17 09:00:00.000,2021-09-16 10:11:33.897
8010,69,3197,충북,18,18,0,9774,2021-06-17 09:00:00.000,2021-09-16 10:11:33.897
8011,41,3674,충남,5,5,0,9773,2021-06-17 09:00:00.000,2021-09-16 10:11:33.897
8012,58,2307,전북,7,6,1,9772,2021-06-17 09:00:00.000,2021-09-16 10:11:33.897
8013,15,1570,전남,6,6,0,9771,2021-06-17 09:00:00.000,2021-09-16 10:11:33.897
8014,86,4828,경북,3,3,0,9770,2021-06-17 09:00:00.000,2021-09-16 10:11:33.897
8015,20,5061,경남,5,5,0,9769,2021-06-17 09:00:00.000,2021-09-16 10:11:33.897
8016,1,1215,제주,8,8,0,9768,2021-06-17 09:00:00.000,2021-09-16 10:11:33.897
8017,5,3980,검역,8,0,8,9767,2021-06-17 09:00:00.000,2021-09-16 10:11:33.897
8018,1993,149190,합계,545,522,23,9766,2021-06-16 09:00:00.000,2021-09-16 10:11:33.897
8019,503,46931,서울,201,199,2,9765,2021-06-16 09:00:00.000,2021-09-16 10:11:33.897
8020,124,5968,부산,16,13,3,9764,2021-06-16 09:00:00.000,2021-09-16 10:11:33.897
8021,222,10470,대구,16,16,0,9763,2021-06-16 09:00:00.000,2021-09-16 10:11:33.897
8022,61,6470,인천,12,11,1,9762,2021-06-16 09:00:00.000,2021-09-16 10:11:33.897
8023,23,2873,광주,1,1,0,9761,2021-06-16 09:00:00.000,2021-09-16 10:11:33.897
8024,25,2393,대전,29,28,1,9760,2021-06-16 09:00:00.000,2021-09-16 10:11:33.897
8025,40,2689,울산,7,6,1,9759,2021-06-16 09:00:00.000,2021-09-16 10:11:33.897
8026,1,517,세종,4,4,0,9758,2021-06-16 09:00:00.000,2021-09-16 10:11:33.897
8027,648,41730,경기,190,184,6,9757,2021-06-16 09:00:00.000,2021-09-16 10:11:33.897
8028,51,3377,강원,7,7,0,9756,2021-06-16 09:00:00.000,2021-09-16 10:11:33.897
8029,69,3179,충북,17,17,0,9755,2021-06-16 09:00:00.000,2021-09-16 10:11:33.897
8030,41,3669,충남,8,7,1,9754,2021-06-16 09:00:00.000,2021-09-16 10:11:33.897
8031,58,2300,전북,2,2,0,9753,2021-06-16 09:00:00.000,2021-09-16 10:11:33.897
8032,15,1564,전남,8,8,0,9752,2021-06-16 09:00:00.000,2021-09-16 10:11:33.897
8033,86,4825,경북,3,3,0,9751,2021-06-16 09:00:00.000,2021-09-16 10:11:33.897
8034,20,5056,경남,7,7,0,9750,2021-06-16 09:00:00.000,2021-09-16 10:11:33.897
8035,1,1207,제주,9,9,0,9749,2021-06-16 09:00:00.000,2021-09-16 10:11:33.897
8036,5,3972,검역,8,0,8,9748,2021-06-16 09:00:00.000,2021-09-16 10:11:33.897
8037,1992,148645,합계,373,347,26,9747,2021-06-15 09:00:00.000,2021-09-16 10:11:33.897
8038,502,46730,서울,131,128,3,9746,2021-06-15 09:00:00.000,2021-09-16 10:11:33.897
8039,124,5952,부산,9,6,3,9745,2021-06-15 09:00:00.000,2021-09-16 10:11:33.897
8040,222,10454,대구,16,16,0,9744,2021-06-15 09:00:00.000,2021-09-16 10:11:33.897
8041,61,6458,인천,12,11,1,9743,2021-06-15 09:00:00.000,2021-09-16 10:11:33.897
8042,23,2872,광주,4,3,1,9742,2021-06-15 09:00:00.000,2021-09-16 10:11:33.897
8043,25,2364,대전,15,14,1,9741,2021-06-15 09:00:00.000,2021-09-16 10:11:33.897
8044,40,2682,울산,4,4,0,9740,2021-06-15 09:00:00.000,2021-09-16 10:11:33.897
8045,1,513,세종,8,7,1,9739,2021-06-15 09:00:00.000,2021-09-16 10:11:33.897
8046,648,41540,경기,120,118,2,9738,2021-06-15 09:00:00.000,2021-09-16 10:11:33.897
8047,51,3370,강원,3,2,1,9737,2021-06-15 09:00:00.000,2021-09-16 10:11:33.897
8048,69,3162,충북,14,14,0,9736,2021-06-15 09:00:00.000,2021-09-16 10:11:33.897
8049,41,3661,충남,7,6,1,9735,2021-06-15 09:00:00.000,2021-09-16 10:11:33.897
8050,58,2298,전북,4,4,0,9734,2021-06-15 09:00:00.000,2021-09-16 10:11:33.897
8051,15,1556,전남,3,3,0,9733,2021-06-15 09:00:00.000,2021-09-16 10:11:33.897
8052,86,4822,경북,5,2,3,9732,2021-06-15 09:00:00.000,2021-09-16 10:11:33.897
8053,20,5049,경남,3,3,0,9731,2021-06-15 09:00:00.000,2021-09-16 10:11:33.897
8054,1,1198,제주,6,6,0,9730,2021-06-15 09:00:00.000,2021-09-16 10:11:33.897
8055,5,3964,검역,9,0,9,9729,2021-06-15 09:00:00.000,2021-09-16 10:11:33.897
8056,1988,148272,합계,399,360,39,9728,2021-06-14 09:00:00.000,2021-09-16 10:11:33.897
8057,501,46599,서울,122,120,2,9727,2021-06-14 09:00:00.000,2021-09-16 10:11:33.897
8058,124,5943,부산,17,10,7,9726,2021-06-14 09:00:00.000,2021-09-16 10:11:33.897
8059,222,10438,대구,20,19,1,9725,2021-06-14 09:00:00.000,2021-09-16 10:11:33.897
8060,61,6446,인천,14,13,1,9724,2021-06-14 09:00:00.000,2021-09-16 10:11:33.897
8061,22,2868,광주,4,3,1,9723,2021-06-14 09:00:00.000,2021-09-16 10:11:33.897
8062,25,2349,대전,10,10,0,9722,2021-06-14 09:00:00.000,2021-09-16 10:11:33.897
8063,40,2678,울산,0,0,0,9721,2021-06-14 09:00:00.000,2021-09-16 10:11:33.897
8064,1,505,세종,1,0,1,9720,2021-06-14 09:00:00.000,2021-09-16 10:11:33.897
8065,648,41420,경기,122,113,9,9719,2021-06-14 09:00:00.000,2021-09-16 10:11:33.897
8066,51,3367,강원,11,10,1,9718,2021-06-14 09:00:00.000,2021-09-16 10:11:33.897
8067,69,3148,충북,23,23,0,9717,2021-06-14 09:00:00.000,2021-09-16 10:11:33.897
8068,39,3654,충남,7,7,0,9716,2021-06-14 09:00:00.000,2021-09-16 10:11:33.897
8069,58,2294,전북,2,2,0,9715,2021-06-14 09:00:00.000,2021-09-16 10:11:33.897
8070,15,1553,전남,4,4,0,9714,2021-06-14 09:00:00.000,2021-09-16 10:11:33.897
8071,86,4817,경북,4,4,0,9713,2021-06-14 09:00:00.000,2021-09-16 10:11:33.897
8072,20,5046,경남,13,13,0,9712,2021-06-14 09:00:00.000,2021-09-16 10:11:33.897
8073,1,1192,제주,9,9,0,9711,2021-06-14 09:00:00.000,2021-09-16 10:11:33.897
8074,5,3955,검역,16,0,16,9710,2021-06-14 09:00:00.000,2021-09-16 10:11:33.897
8075,1985,147873,합계,452,419,33,9709,2021-06-13 09:00:00.000,2021-09-16 10:11:33.897
8076,501,46477,서울,176,174,2,9708,2021-06-13 09:00:00.000,2021-09-16 10:11:33.897
8077,124,5926,부산,13,13,0,9707,2021-06-13 09:00:00.000,2021-09-16 10:11:33.897
8078,222,10418,대구,15,14,1,9706,2021-06-13 09:00:00.000,2021-09-16 10:11:33.897
8079,61,6432,인천,15,13,2,9705,2021-06-13 09:00:00.000,2021-09-16 10:11:33.897
8080,22,2864,광주,3,2,1,9704,2021-06-13 09:00:00.000,2021-09-16 10:11:33.897
8081,25,2339,대전,11,11,0,9703,2021-06-13 09:00:00.000,2021-09-16 10:11:33.897
8082,40,2678,울산,2,2,0,9702,2021-06-13 09:00:00.000,2021-09-16 10:11:33.897
8083,1,504,세종,1,1,0,9701,2021-06-13 09:00:00.000,2021-09-16 10:11:33.897
8084,647,41298,경기,149,142,7,9700,2021-06-13 09:00:00.000,2021-09-16 10:11:33.897
8085,51,3356,강원,10,10,0,9699,2021-06-13 09:00:00.000,2021-09-16 10:11:33.897
8086,68,3125,충북,6,6,0,9698,2021-06-13 09:00:00.000,2021-09-16 10:11:33.897
8087,39,3647,충남,10,8,2,9697,2021-06-13 09:00:00.000,2021-09-16 10:11:33.897
8088,58,2292,전북,1,1,0,9696,2021-06-13 09:00:00.000,2021-09-16 10:11:33.897
8089,15,1549,전남,3,3,0,9695,2021-06-13 09:00:00.000,2021-09-16 10:11:33.897
8090,86,4813,경북,7,7,0,9694,2021-06-13 09:00:00.000,2021-09-16 10:11:33.897
8091,19,5033,경남,8,7,1,9693,2021-06-13 09:00:00.000,2021-09-16 10:11:33.897
8092,1,1183,제주,5,5,0,9692,2021-06-13 09:00:00.000,2021-09-16 10:11:33.897
8093,5,3939,검역,17,0,17,9691,2021-06-13 09:00:00.000,2021-09-16 10:11:33.897
8094,1982,147421,합계,565,525,40,9690,2021-06-12 09:00:00.000,2021-09-16 10:11:33.897
8095,499,46301,서울,208,205,3,9689,2021-06-12 09:00:00.000,2021-09-16 10:11:33.897
8096,124,5913,부산,26,13,13,9688,2021-06-12 09:00:00.000,2021-09-16 10:11:33.897
8097,222,10403,대구,23,21,2,9687,2021-06-12 09:00:00.000,2021-09-16 10:11:33.897
8098,61,6417,인천,20,19,1,9686,2021-06-12 09:00:00.000,2021-09-16 10:11:33.897
8099,22,2861,광주,7,4,3,9685,2021-06-12 09:00:00.000,2021-09-16 10:11:33.897
8100,25,2328,대전,22,22,0,9684,2021-06-12 09:00:00.000,2021-09-16 10:11:33.897
8101,40,2676,울산,6,6,0,9683,2021-06-12 09:00:00.000,2021-09-16 10:11:33.897
8102,1,503,세종,1,0,1,9682,2021-06-12 09:00:00.000,2021-09-16 10:11:33.897
8103,646,41149,경기,174,170,4,9681,2021-06-12 09:00:00.000,2021-09-16 10:11:33.897
8104,51,3346,강원,11,10,1,9680,2021-06-12 09:00:00.000,2021-09-16 10:11:33.897
8105,68,3119,충북,12,12,0,9679,2021-06-12 09:00:00.000,2021-09-16 10:11:33.897
8106,39,3637,충남,5,4,1,9678,2021-06-12 09:00:00.000,2021-09-16 10:11:33.897
8107,58,2291,전북,2,2,0,9677,2021-06-12 09:00:00.000,2021-09-16 10:11:33.897
8108,15,1546,전남,4,4,0,9676,2021-06-12 09:00:00.000,2021-09-16 10:11:33.897
8109,86,4806,경북,5,5,0,9675,2021-06-12 09:00:00.000,2021-09-16 10:11:33.897
8110,19,5025,경남,25,23,2,9674,2021-06-12 09:00:00.000,2021-09-16 10:11:33.897
8111,1,1178,제주,5,5,0,9673,2021-06-12 09:00:00.000,2021-09-16 10:11:33.897
8112,5,3922,검역,9,0,9,9672,2021-06-12 09:00:00.000,2021-09-16 10:11:33.897
8113,1981,146856,합계,556,541,15,9671,2021-06-11 09:00:00.000,2021-09-16 10:11:33.897
8114,499,46093,서울,204,201,3,9670,2021-06-11 09:00:00.000,2021-09-16 10:11:33.897
8115,124,5887,부산,28,25,3,9669,2021-06-11 09:00:00.000,2021-09-16 10:11:33.897
8116,222,10380,대구,24,23,1,9668,2021-06-11 09:00:00.000,2021-09-16 10:11:33.897
8117,61,6397,인천,18,17,1,9667,2021-06-11 09:00:00.000,2021-09-16 10:11:33.897
8118,22,2854,광주,1,1,0,9666,2021-06-11 09:00:00.000,2021-09-16 10:11:33.897
8119,25,2306,대전,15,15,0,9665,2021-06-11 09:00:00.000,2021-09-16 10:11:33.897
8120,40,2670,울산,15,15,0,9664,2021-06-11 09:00:00.000,2021-09-16 10:11:33.897
8121,1,502,세종,2,1,1,9663,2021-06-11 09:00:00.000,2021-09-16 10:11:33.897
8122,645,40975,경기,173,172,1,9662,2021-06-11 09:00:00.000,2021-09-16 10:11:33.897
8123,51,3335,강원,11,10,1,9661,2021-06-11 09:00:00.000,2021-09-16 10:11:33.897
8124,68,3107,충북,16,16,0,9660,2021-06-11 09:00:00.000,2021-09-16 10:11:33.897
8125,39,3632,충남,5,5,0,9659,2021-06-11 09:00:00.000,2021-09-16 10:11:33.897
8126,58,2289,전북,4,4,0,9658,2021-06-11 09:00:00.000,2021-09-16 10:11:33.897
8127,15,1542,전남,5,5,0,9657,2021-06-11 09:00:00.000,2021-09-16 10:11:33.897
8128,86,4801,경북,6,6,0,9656,2021-06-11 09:00:00.000,2021-09-16 10:11:33.897
8129,19,5000,경남,20,20,0,9655,2021-06-11 09:00:00.000,2021-09-16 10:11:33.897
8130,1,1173,제주,5,5,0,9654,2021-06-11 09:00:00.000,2021-09-16 10:11:33.897
8131,5,3913,검역,4,0,4,9653,2021-06-11 09:00:00.000,2021-09-16 10:11:33.897
8132,1979,146300,합계,610,593,17,9652,2021-06-10 09:00:00.000,2021-09-16 10:11:33.897
8133,499,45889,서울,212,212,0,9651,2021-06-10 09:00:00.000,2021-09-16 10:11:33.897
8134,124,5859,부산,15,15,0,9650,2021-06-10 09:00:00.000,2021-09-16 10:11:33.897
8135,222,10356,대구,30,29,1,9649,2021-06-10 09:00:00.000,2021-09-16 10:11:33.897
8136,61,6379,인천,22,22,0,9648,2021-06-10 09:00:00.000,2021-09-16 10:11:33.897
8137,22,2853,광주,4,3,1,9647,2021-06-10 09:00:00.000,2021-09-16 10:11:33.897
8138,25,2291,대전,22,21,1,9646,2021-06-10 09:00:00.000,2021-09-16 10:11:33.897
8139,40,2655,울산,7,7,0,9645,2021-06-10 09:00:00.000,2021-09-16 10:11:33.897
8140,1,500,세종,3,3,0,9644,2021-06-10 09:00:00.000,2021-09-16 10:11:33.897
8141,643,40802,경기,180,176,4,9643,2021-06-10 09:00:00.000,2021-09-16 10:11:33.897
8142,51,3324,강원,16,16,0,9642,2021-06-10 09:00:00.000,2021-09-16 10:11:33.897
8143,68,3091,충북,24,24,0,9641,2021-06-10 09:00:00.000,2021-09-16 10:11:33.897
8144,39,3627,충남,7,7,0,9640,2021-06-10 09:00:00.000,2021-09-16 10:11:33.897
8145,58,2285,전북,2,2,0,9639,2021-06-10 09:00:00.000,2021-09-16 10:11:33.897
8146,15,1537,전남,4,4,0,9638,2021-06-10 09:00:00.000,2021-09-16 10:11:33.897
8147,86,4795,경북,11,9,2,9637,2021-06-10 09:00:00.000,2021-09-16 10:11:33.897
8148,19,4980,경남,33,33,0,9636,2021-06-10 09:00:00.000,2021-09-16 10:11:33.897
8149,1,1168,제주,10,10,0,9635,2021-06-10 09:00:00.000,2021-09-16 10:11:33.897
8150,5,3909,검역,8,0,8,9634,2021-06-10 09:00:00.000,2021-09-16 10:11:33.897
8151,1977,145690,합계,602,581,21,9633,2021-06-09 09:00:00.000,2021-09-16 10:11:33.897
8152,499,45677,서울,183,181,2,9632,2021-06-09 09:00:00.000,2021-09-16 10:11:33.897
8153,124,5844,부산,16,14,2,9631,2021-06-09 09:00:00.000,2021-09-16 10:11:33.897
8154,222,10326,대구,44,44,0,9630,2021-06-09 09:00:00.000,2021-09-16 10:11:33.897
8155,61,6357,인천,23,21,2,9629,2021-06-09 09:00:00.000,2021-09-16 10:11:33.897
8156,22,2849,광주,7,7,0,9628,2021-06-09 09:00:00.000,2021-09-16 10:11:33.897
8157,24,2269,대전,25,25,0,9627,2021-06-09 09:00:00.000,2021-09-16 10:11:33.897
8158,40,2648,울산,6,6,0,9626,2021-06-09 09:00:00.000,2021-09-16 10:11:33.897
8159,1,497,세종,3,3,0,9625,2021-06-09 09:00:00.000,2021-09-16 10:11:33.897
8160,643,40622,경기,161,155,6,9624,2021-06-09 09:00:00.000,2021-09-16 10:11:33.897
8161,51,3308,강원,30,29,1,9623,2021-06-09 09:00:00.000,2021-09-16 10:11:33.897
8162,68,3067,충북,23,23,0,9622,2021-06-09 09:00:00.000,2021-09-16 10:11:33.897
8163,39,3620,충남,5,4,1,9621,2021-06-09 09:00:00.000,2021-09-16 10:11:33.897
8164,58,2283,전북,6,6,0,9620,2021-06-09 09:00:00.000,2021-09-16 10:11:33.897
8165,15,1533,전남,6,6,0,9619,2021-06-09 09:00:00.000,2021-09-16 10:11:33.897
8166,85,4784,경북,13,12,1,9618,2021-06-09 09:00:00.000,2021-09-16 10:11:33.897
8167,19,4947,경남,39,39,0,9617,2021-06-09 09:00:00.000,2021-09-16 10:11:33.897
8168,1,1158,제주,7,6,1,9616,2021-06-09 09:00:00.000,2021-09-16 10:11:33.897
8169,5,3901,검역,5,0,5,9615,2021-06-09 09:00:00.000,2021-09-16 10:11:33.897
8170,1975,145088,합계,454,435,19,9614,2021-06-08 09:00:00.000,2021-09-16 10:11:33.897
8171,498,45494,서울,139,139,0,9613,2021-06-08 09:00:00.000,2021-09-16 10:11:33.897
8172,124,5828,부산,15,15,0,9612,2021-06-08 09:00:00.000,2021-09-16 10:11:33.897
8173,222,10282,대구,33,33,0,9611,2021-06-08 09:00:00.000,2021-09-16 10:11:33.897
8174,61,6334,인천,13,11,2,9610,2021-06-08 09:00:00.000,2021-09-16 10:11:33.897
8175,22,2842,광주,1,1,0,9609,2021-06-08 09:00:00.000,2021-09-16 10:11:33.897
8176,24,2244,대전,22,22,0,9608,2021-06-08 09:00:00.000,2021-09-16 10:11:33.897
8177,40,2642,울산,3,3,0,9607,2021-06-08 09:00:00.000,2021-09-16 10:11:33.897
8178,1,494,세종,0,0,0,9606,2021-06-08 09:00:00.000,2021-09-16 10:11:33.897
8179,642,40461,경기,130,125,5,9605,2021-06-08 09:00:00.000,2021-09-16 10:11:33.897
8180,51,3278,강원,5,5,0,9604,2021-06-08 09:00:00.000,2021-09-16 10:11:33.897
8181,68,3044,충북,6,6,0,9603,2021-06-08 09:00:00.000,2021-09-16 10:11:33.897
8182,39,3615,충남,4,3,1,9602,2021-06-08 09:00:00.000,2021-09-16 10:11:33.897
8183,58,2277,전북,4,3,1,9601,2021-06-08 09:00:00.000,2021-09-16 10:11:33.897
8184,15,1527,전남,8,8,0,9600,2021-06-08 09:00:00.000,2021-09-16 10:11:33.897
8185,85,4771,경북,7,6,1,9599,2021-06-08 09:00:00.000,2021-09-16 10:11:33.897
8186,19,4908,경남,48,48,0,9598,2021-06-08 09:00:00.000,2021-09-16 10:11:33.897
8187,1,1151,제주,8,7,1,9597,2021-06-08 09:00:00.000,2021-09-16 10:11:33.897
8188,5,3896,검역,8,0,8,9596,2021-06-08 09:00:00.000,2021-09-16 10:11:33.897
8189,1974,144634,합계,485,454,31,9595,2021-06-07 09:00:00.000,2021-09-16 10:11:33.897
8190,497,45355,서울,159,149,10,9594,2021-06-07 09:00:00.000,2021-09-16 10:11:33.897
8191,124,5813,부산,12,9,3,9593,2021-06-07 09:00:00.000,2021-09-16 10:11:33.897
8192,222,10249,대구,26,26,0,9592,2021-06-07 09:00:00.000,2021-09-16 10:11:33.897
8193,61,6321,인천,15,15,0,9591,2021-06-07 09:00:00.000,2021-09-16 10:11:33.897
8194,22,2841,광주,4,4,0,9590,2021-06-07 09:00:00.000,2021-09-16 10:11:33.897
8195,24,2222,대전,20,20,0,9589,2021-06-07 09:00:00.000,2021-09-16 10:11:33.897
8196,40,2639,울산,10,10,0,9588,2021-06-07 09:00:00.000,2021-09-16 10:11:33.897
8197,1,494,세종,0,0,0,9587,2021-06-07 09:00:00.000,2021-09-16 10:11:33.897
8198,642,40331,경기,151,146,5,9586,2021-06-07 09:00:00.000,2021-09-16 10:11:33.897
8199,51,3273,강원,2,2,0,9585,2021-06-07 09:00:00.000,2021-09-16 10:11:33.897
8200,68,3038,충북,11,10,1,9584,2021-06-07 09:00:00.000,2021-09-16 10:11:33.897
8201,39,3611,충남,9,9,0,9583,2021-06-07 09:00:00.000,2021-09-16 10:11:33.897
8202,58,2273,전북,3,3,0,9582,2021-06-07 09:00:00.000,2021-09-16 10:11:33.897
8203,15,1519,전남,3,3,0,9581,2021-06-07 09:00:00.000,2021-09-16 10:11:33.897
8204,85,4764,경북,9,8,1,9580,2021-06-07 09:00:00.000,2021-09-16 10:11:33.897
8205,19,4860,경남,28,27,1,9579,2021-06-07 09:00:00.000,2021-09-16 10:11:33.897
8206,1,1143,제주,13,13,0,9578,2021-06-07 09:00:00.000,2021-09-16 10:11:33.897
8207,5,3888,검역,10,0,10,9577,2021-06-07 09:00:00.000,2021-09-16 10:11:33.897
8208,1973,144149,합계,556,541,15,9576,2021-06-06 09:00:00.000,2021-09-16 10:11:33.897
8209,497,45196,서울,179,177,2,9575,2021-06-06 09:00:00.000,2021-09-16 10:11:33.897
8210,124,5801,부산,21,21,0,9574,2021-06-06 09:00:00.000,2021-09-16 10:11:33.897
8211,222,10223,대구,46,45,1,9573,2021-06-06 09:00:00.000,2021-09-16 10:11:33.897
8212,61,6306,인천,23,22,1,9572,2021-06-06 09:00:00.000,2021-09-16 10:11:33.897
8213,22,2837,광주,2,2,0,9571,2021-06-06 09:00:00.000,2021-09-16 10:11:33.897
8214,24,2202,대전,18,18,0,9570,2021-06-06 09:00:00.000,2021-09-16 10:11:33.897
8215,40,2629,울산,7,7,0,9569,2021-06-06 09:00:00.000,2021-09-16 10:11:33.897
8216,1,494,세종,0,0,0,9568,2021-06-06 09:00:00.000,2021-09-16 10:11:33.897
8217,641,40180,경기,160,157,3,9567,2021-06-06 09:00:00.000,2021-09-16 10:11:33.897
8218,51,3271,강원,10,10,0,9566,2021-06-06 09:00:00.000,2021-09-16 10:11:33.897
8219,68,3027,충북,17,17,0,9565,2021-06-06 09:00:00.000,2021-09-16 10:11:33.897
8220,39,3602,충남,13,13,0,9564,2021-06-06 09:00:00.000,2021-09-16 10:11:33.897
8221,58,2270,전북,0,0,0,9563,2021-06-06 09:00:00.000,2021-09-16 10:11:33.897
8222,15,1516,전남,9,9,0,9562,2021-06-06 09:00:00.000,2021-09-16 10:11:33.897
8223,85,4755,경북,10,9,1,9561,2021-06-06 09:00:00.000,2021-09-16 10:11:33.897
8224,19,4832,경남,17,17,0,9560,2021-06-06 09:00:00.000,2021-09-16 10:11:33.897
8225,1,1130,제주,19,17,2,9559,2021-06-06 09:00:00.000,2021-09-16 10:11:33.897
8226,5,3878,검역,5,0,5,9558,2021-06-06 09:00:00.000,2021-09-16 10:11:33.897
8227,1971,143593,합계,744,725,19,9557,2021-06-05 09:00:00.000,2021-09-16 10:11:33.897
8228,496,45017,서울,277,274,3,9556,2021-06-05 09:00:00.000,2021-09-16 10:11:33.897
8229,124,5780,부산,17,13,4,9555,2021-06-05 09:00:00.000,2021-09-16 10:11:33.897
8230,222,10177,대구,41,41,0,9554,2021-06-05 09:00:00.000,2021-09-16 10:11:33.897
8231,61,6283,인천,16,16,0,9553,2021-06-05 09:00:00.000,2021-09-16 10:11:33.897
8232,22,2835,광주,9,9,0,9552,2021-06-05 09:00:00.000,2021-09-16 10:11:33.897
8233,24,2184,대전,31,31,0,9551,2021-06-05 09:00:00.000,2021-09-16 10:11:33.897
8234,40,2622,울산,5,5,0,9550,2021-06-05 09:00:00.000,2021-09-16 10:11:33.897
8235,1,494,세종,4,4,0,9549,2021-06-05 09:00:00.000,2021-09-16 10:11:33.897
8236,641,40020,경기,211,206,5,9548,2021-06-05 09:00:00.000,2021-09-16 10:11:33.897
8237,51,3261,강원,14,14,0,9547,2021-06-05 09:00:00.000,2021-09-16 10:11:33.897
8238,68,3010,충북,24,24,0,9546,2021-06-05 09:00:00.000,2021-09-16 10:11:33.897
8239,39,3589,충남,10,9,1,9545,2021-06-05 09:00:00.000,2021-09-16 10:11:33.897
8240,58,2270,전북,14,13,1,9544,2021-06-05 09:00:00.000,2021-09-16 10:11:33.897
8241,15,1507,전남,14,14,0,9543,2021-06-05 09:00:00.000,2021-09-16 10:11:33.897
8242,85,4745,경북,10,10,0,9542,2021-06-05 09:00:00.000,2021-09-16 10:11:33.897
8243,19,4815,경남,20,20,0,9541,2021-06-05 09:00:00.000,2021-09-16 10:11:33.897
8244,1,1111,제주,22,22,0,9540,2021-06-05 09:00:00.000,2021-09-16 10:11:33.897
8245,4,3873,검역,5,0,5,9539,2021-06-05 09:00:00.000,2021-09-16 10:11:33.897
8246,1969,142849,합계,695,674,21,9538,2021-06-04 09:00:00.000,2021-09-16 10:11:33.897
8247,496,44740,서울,206,205,1,9537,2021-06-04 09:00:00.000,2021-09-16 10:11:33.897
8248,124,5763,부산,14,13,1,9536,2021-06-04 09:00:00.000,2021-09-16 10:11:33.897
8249,222,10136,대구,65,65,0,9535,2021-06-04 09:00:00.000,2021-09-16 10:11:33.897
8250,61,6267,인천,10,10,0,9534,2021-06-04 09:00:00.000,2021-09-16 10:11:33.897
8251,22,2826,광주,7,7,0,9533,2021-06-04 09:00:00.000,2021-09-16 10:11:33.897
8252,24,2153,대전,18,18,0,9532,2021-06-04 09:00:00.000,2021-09-16 10:11:33.897
8253,40,2617,울산,15,14,1,9531,2021-06-04 09:00:00.000,2021-09-16 10:11:33.897
8254,1,490,세종,3,3,0,9530,2021-06-04 09:00:00.000,2021-09-16 10:11:33.897
8255,639,39809,경기,209,204,5,9529,2021-06-04 09:00:00.000,2021-09-16 10:11:33.897
8256,51,3247,강원,18,18,0,9528,2021-06-04 09:00:00.000,2021-09-16 10:11:33.897
8257,68,2986,충북,22,21,1,9527,2021-06-04 09:00:00.000,2021-09-16 10:11:33.897
8258,39,3579,충남,9,9,0,9526,2021-06-04 09:00:00.000,2021-09-16 10:11:33.897
8259,58,2256,전북,3,3,0,9525,2021-06-04 09:00:00.000,2021-09-16 10:11:33.897
8260,15,1493,전남,12,12,0,9524,2021-06-04 09:00:00.000,2021-09-16 10:11:33.897
8261,85,4735,경북,11,8,3,9523,2021-06-04 09:00:00.000,2021-09-16 10:11:33.897
8262,19,4795,경남,44,43,1,9522,2021-06-04 09:00:00.000,2021-09-16 10:11:33.897
8263,1,1089,제주,21,21,0,9521,2021-06-04 09:00:00.000,2021-09-16 10:11:33.897
8264,4,3868,검역,8,0,8,9520,2021-06-04 09:00:00.000,2021-09-16 10:11:33.897
8265,1968,142154,합계,681,672,9,9519,2021-06-03 09:00:00.000,2021-09-16 10:11:33.897
8266,495,44534,서울,215,215,0,9518,2021-06-03 09:00:00.000,2021-09-16 10:11:33.897
8267,124,5749,부산,32,32,0,9517,2021-06-03 09:00:00.000,2021-09-16 10:11:33.897
8268,222,10071,대구,74,73,1,9516,2021-06-03 09:00:00.000,2021-09-16 10:11:33.897
8269,61,6257,인천,22,22,0,9515,2021-06-03 09:00:00.000,2021-09-16 10:11:33.897
8270,22,2819,광주,4,4,0,9514,2021-06-03 09:00:00.000,2021-09-16 10:11:33.897
8271,24,2135,대전,15,15,0,9513,2021-06-03 09:00:00.000,2021-09-16 10:11:33.897
8272,40,2602,울산,8,8,0,9512,2021-06-03 09:00:00.000,2021-09-16 10:11:33.897
8273,1,487,세종,1,1,0,9511,2021-06-03 09:00:00.000,2021-09-16 10:11:33.897
8274,639,39600,경기,211,207,4,9510,2021-06-03 09:00:00.000,2021-09-16 10:11:33.897
8275,51,3229,강원,17,16,1,9509,2021-06-03 09:00:00.000,2021-09-16 10:11:33.897
8276,68,2964,충북,5,5,0,9508,2021-06-03 09:00:00.000,2021-09-16 10:11:33.897
8277,39,3570,충남,13,13,0,9507,2021-06-03 09:00:00.000,2021-09-16 10:11:33.897
8278,58,2253,전북,12,12,0,9506,2021-06-03 09:00:00.000,2021-09-16 10:11:33.897
8279,15,1481,전남,3,3,0,9505,2021-06-03 09:00:00.000,2021-09-16 10:11:33.897
8280,85,4724,경북,11,11,0,9504,2021-06-03 09:00:00.000,2021-09-16 10:11:33.897
8281,19,4751,경남,23,23,0,9503,2021-06-03 09:00:00.000,2021-09-16 10:11:33.897
8282,1,1068,제주,12,12,0,9502,2021-06-03 09:00:00.000,2021-09-16 10:11:33.897
8283,4,3860,검역,3,0,3,9501,2021-06-03 09:00:00.000,2021-09-16 10:11:33.897
8284,1965,141473,합계,677,654,23,9500,2021-06-02 09:00:00.000,2021-09-16 10:11:33.897
8285,492,44319,서울,258,256,2,9499,2021-06-02 09:00:00.000,2021-09-16 10:11:33.897
8286,124,5717,부산,21,19,2,9498,2021-06-02 09:00:00.000,2021-09-16 10:11:33.897
8287,222,9997,대구,39,39,0,9497,2021-06-02 09:00:00.000,2021-09-16 10:11:33.897
8288,61,6235,인천,20,19,1,9496,2021-06-02 09:00:00.000,2021-09-16 10:11:33.897
8289,22,2815,광주,5,5,0,9495,2021-06-02 09:00:00.000,2021-09-16 10:11:33.897
8290,24,2120,대전,23,23,0,9494,2021-06-02 09:00:00.000,2021-09-16 10:11:33.897
8291,40,2594,울산,14,14,0,9493,2021-06-02 09:00:00.000,2021-09-16 10:11:33.897
8292,1,486,세종,3,3,0,9492,2021-06-02 09:00:00.000,2021-09-16 10:11:33.897
8293,639,39389,경기,192,188,4,9491,2021-06-02 09:00:00.000,2021-09-16 10:11:33.897
8294,51,3212,강원,14,14,0,9490,2021-06-02 09:00:00.000,2021-09-16 10:11:33.897
8295,68,2959,충북,5,5,0,9489,2021-06-02 09:00:00.000,2021-09-16 10:11:33.897
8296,39,3557,충남,7,7,0,9488,2021-06-02 09:00:00.000,2021-09-16 10:11:33.897
8297,58,2241,전북,10,10,0,9487,2021-06-02 09:00:00.000,2021-09-16 10:11:33.897
8298,15,1478,전남,10,10,0,9486,2021-06-02 09:00:00.000,2021-09-16 10:11:33.897
8299,85,4713,경북,12,9,3,9485,2021-06-02 09:00:00.000,2021-09-16 10:11:33.897
8300,19,4728,경남,21,19,2,9484,2021-06-02 09:00:00.000,2021-09-16 10:11:33.897
8301,1,1056,제주,14,14,0,9483,2021-06-02 09:00:00.000,2021-09-16 10:11:33.897
8302,4,3857,검역,9,0,9,9482,2021-06-02 09:00:00.000,2021-09-16 10:11:33.897
8303,1963,140796,합계,459,449,10,9481,2021-06-01 09:00:00.000,2021-09-16 10:11:33.897
8304,491,44061,서울,147,146,1,9480,2021-06-01 09:00:00.000,2021-09-16 10:11:33.897
8305,124,5696,부산,28,28,0,9479,2021-06-01 09:00:00.000,2021-09-16 10:11:33.897
8306,221,9958,대구,42,39,3,9478,2021-06-01 09:00:00.000,2021-09-16 10:11:33.897
8307,61,6215,인천,17,16,1,9477,2021-06-01 09:00:00.000,2021-09-16 10:11:33.897
8308,22,2810,광주,5,5,0,9476,2021-06-01 09:00:00.000,2021-09-16 10:11:33.897
8309,24,2097,대전,19,19,0,9475,2021-06-01 09:00:00.000,2021-09-16 10:11:33.897
8310,40,2580,울산,2,2,0,9474,2021-06-01 09:00:00.000,2021-09-16 10:11:33.897
8311,1,483,세종,3,3,0,9473,2021-06-01 09:00:00.000,2021-09-16 10:11:33.897
8312,639,39197,경기,116,116,0,9472,2021-06-01 09:00:00.000,2021-09-16 10:11:33.897
8313,51,3198,강원,13,13,0,9471,2021-06-01 09:00:00.000,2021-09-16 10:11:33.897
8314,68,2954,충북,11,11,0,9470,2021-06-01 09:00:00.000,2021-09-16 10:11:33.897
8315,39,3550,충남,12,11,1,9469,2021-06-01 09:00:00.000,2021-09-16 10:11:33.897
8316,58,2231,전북,6,6,0,9468,2021-06-01 09:00:00.000,2021-09-16 10:11:33.897
8317,15,1468,전남,5,5,0,9467,2021-06-01 09:00:00.000,2021-09-16 10:11:33.897
8318,85,4701,경북,9,9,0,9466,2021-06-01 09:00:00.000,2021-09-16 10:11:33.897
8319,19,4707,경남,8,8,0,9465,2021-06-01 09:00:00.000,2021-09-16 10:11:33.897
8320,1,1042,제주,12,12,0,9464,2021-06-01 09:00:00.000,2021-09-16 10:11:33.897
8321,4,3848,검역,4,0,4,9463,2021-06-01 09:00:00.000,2021-09-16 10:11:33.897
8322,1959,140337,합계,430,411,19,9462,2021-05-31 09:00:00.000,2021-09-16 10:11:33.897
8323,488,43914,서울,130,129,1,9461,2021-05-31 09:00:00.000,2021-09-16 10:11:33.897
8324,124,5668,부산,17,16,1,9460,2021-05-31 09:00:00.000,2021-09-16 10:11:33.897
8325,221,9916,대구,31,31,0,9459,2021-05-31 09:00:00.000,2021-09-16 10:11:33.897
8326,61,6198,인천,12,10,2,9458,2021-05-31 09:00:00.000,2021-09-16 10:11:33.897
8327,22,2805,광주,13,13,0,9457,2021-05-31 09:00:00.000,2021-09-16 10:11:33.897
8328,24,2078,대전,6,6,0,9456,2021-05-31 09:00:00.000,2021-09-16 10:11:33.897
8329,40,2578,울산,3,3,0,9455,2021-05-31 09:00:00.000,2021-09-16 10:11:33.897
8330,1,480,세종,3,3,0,9454,2021-05-31 09:00:00.000,2021-09-16 10:11:33.897
8331,638,39081,경기,130,127,3,9453,2021-05-31 09:00:00.000,2021-09-16 10:11:33.897
8332,51,3185,강원,11,11,0,9452,2021-05-31 09:00:00.000,2021-09-16 10:11:33.897
8333,68,2943,충북,7,7,0,9451,2021-05-31 09:00:00.000,2021-09-16 10:11:33.897
8334,39,3538,충남,4,4,0,9450,2021-05-31 09:00:00.000,2021-09-16 10:11:33.897
8335,58,2225,전북,9,9,0,9449,2021-05-31 09:00:00.000,2021-09-16 10:11:33.897
8336,15,1463,전남,6,6,0,9448,2021-05-31 09:00:00.000,2021-09-16 10:11:33.897
8337,85,4692,경북,18,15,3,9447,2021-05-31 09:00:00.000,2021-09-16 10:11:33.897
8338,19,4699,경남,16,15,1,9446,2021-05-31 09:00:00.000,2021-09-16 10:11:33.897
8339,1,1030,제주,7,6,1,9445,2021-05-31 09:00:00.000,2021-09-16 10:11:33.897
8340,4,3844,검역,7,0,7,9444,2021-05-31 09:00:00.000,2021-09-16 10:11:33.897
8341,1957,139907,합계,480,464,16,9443,2021-05-30 09:00:00.000,2021-09-16 10:11:33.897
8342,488,43784,서울,160,159,1,9442,2021-05-30 09:00:00.000,2021-09-16 10:11:33.897
8343,124,5651,부산,13,13,0,9441,2021-05-30 09:00:00.000,2021-09-16 10:11:33.897
8344,221,9885,대구,20,20,0,9440,2021-05-30 09:00:00.000,2021-09-16 10:11:33.897
8345,61,6186,인천,18,18,0,9439,2021-05-30 09:00:00.000,2021-09-16 10:11:33.897
8346,22,2792,광주,9,9,0,9438,2021-05-30 09:00:00.000,2021-09-16 10:11:33.897
8347,24,2072,대전,7,7,0,9437,2021-05-30 09:00:00.000,2021-09-16 10:11:33.897
8348,40,2575,울산,7,6,1,9436,2021-05-30 09:00:00.000,2021-09-16 10:11:33.897
8349,1,477,세종,6,6,0,9435,2021-05-30 09:00:00.000,2021-09-16 10:11:33.897
8350,637,38951,경기,160,156,4,9434,2021-05-30 09:00:00.000,2021-09-16 10:11:33.897
8351,51,3174,강원,17,17,0,9433,2021-05-30 09:00:00.000,2021-09-16 10:11:33.897
8352,68,2936,충북,6,6,0,9432,2021-05-30 09:00:00.000,2021-09-16 10:11:33.897
8353,39,3534,충남,7,5,2,9431,2021-05-30 09:00:00.000,2021-09-16 10:11:33.897
8354,58,2216,전북,7,7,0,9430,2021-05-30 09:00:00.000,2021-09-16 10:11:33.897
8355,14,1457,전남,9,9,0,9429,2021-05-30 09:00:00.000,2021-09-16 10:11:33.897
8356,85,4674,경북,9,9,0,9428,2021-05-30 09:00:00.000,2021-09-16 10:11:33.897
8357,19,4683,경남,10,9,1,9427,2021-05-30 09:00:00.000,2021-09-16 10:11:33.897
8358,1,1023,제주,8,8,0,9426,2021-05-30 09:00:00.000,2021-09-16 10:11:33.897
8359,4,3837,검역,7,0,7,9425,2021-05-30 09:00:00.000,2021-09-16 10:11:33.897
8360,1951,139427,합계,533,505,28,9424,2021-05-29 09:00:00.000,2021-09-16 10:11:33.897
8361,486,43624,서울,194,190,4,9423,2021-05-29 09:00:00.000,2021-09-16 10:11:33.897
8362,124,5638,부산,14,14,0,9422,2021-05-29 09:00:00.000,2021-09-16 10:11:33.897
8363,221,9865,대구,22,22,0,9421,2021-05-29 09:00:00.000,2021-09-16 10:11:33.897
8364,61,6168,인천,18,17,1,9420,2021-05-29 09:00:00.000,2021-09-16 10:11:33.897
8365,22,2783,광주,9,9,0,9419,2021-05-29 09:00:00.000,2021-09-16 10:11:33.897
8366,24,2065,대전,11,11,0,9418,2021-05-29 09:00:00.000,2021-09-16 10:11:33.897
8367,40,2568,울산,8,8,0,9417,2021-05-29 09:00:00.000,2021-09-16 10:11:33.897
8368,1,471,세종,1,1,0,9416,2021-05-29 09:00:00.000,2021-09-16 10:11:33.897
8369,634,38791,경기,139,136,3,9415,2021-05-29 09:00:00.000,2021-09-16 10:11:33.897
8370,51,3157,강원,10,10,0,9414,2021-05-29 09:00:00.000,2021-09-16 10:11:33.897
8371,68,2930,충북,22,22,0,9413,2021-05-29 09:00:00.000,2021-09-16 10:11:33.897
8372,38,3527,충남,12,10,2,9412,2021-05-29 09:00:00.000,2021-09-16 10:11:33.897
8373,58,2209,전북,6,6,0,9411,2021-05-29 09:00:00.000,2021-09-16 10:11:33.897
8374,14,1448,전남,5,5,0,9410,2021-05-29 09:00:00.000,2021-09-16 10:11:33.897
8375,85,4665,경북,13,13,0,9409,2021-05-29 09:00:00.000,2021-09-16 10:11:33.897
8376,19,4673,경남,20,19,1,9408,2021-05-29 09:00:00.000,2021-09-16 10:11:33.897
8377,1,1015,제주,13,12,1,9407,2021-05-29 09:00:00.000,2021-09-16 10:11:33.897
8378,4,3830,검역,16,0,16,9406,2021-05-29 09:00:00.000,2021-09-16 10:11:33.897
8379,1946,138894,합계,587,571,16,9405,2021-05-28 09:00:00.000,2021-09-16 10:11:33.897
8380,485,43430,서울,214,212,2,9404,2021-05-28 09:00:00.000,2021-09-16 10:11:33.897
8381,124,5624,부산,13,13,0,9403,2021-05-28 09:00:00.000,2021-09-16 10:11:33.897
8382,221,9843,대구,24,24,0,9402,2021-05-28 09:00:00.000,2021-09-16 10:11:33.897
8383,61,6150,인천,26,26,0,9401,2021-05-28 09:00:00.000,2021-09-16 10:11:33.897
8384,22,2774,광주,8,8,0,9400,2021-05-28 09:00:00.000,2021-09-16 10:11:33.897
8385,24,2054,대전,18,18,0,9399,2021-05-28 09:00:00.000,2021-09-16 10:11:33.897
8386,40,2560,울산,12,12,0,9398,2021-05-28 09:00:00.000,2021-09-16 10:11:33.897
8387,1,470,세종,8,8,0,9397,2021-05-28 09:00:00.000,2021-09-16 10:11:33.897
8388,631,38652,경기,149,146,3,9396,2021-05-28 09:00:00.000,2021-09-16 10:11:33.897
8389,51,3147,강원,16,16,0,9395,2021-05-28 09:00:00.000,2021-09-16 10:11:33.897
8390,68,2908,충북,14,14,0,9394,2021-05-28 09:00:00.000,2021-09-16 10:11:33.897
8391,37,3515,충남,21,21,0,9393,2021-05-28 09:00:00.000,2021-09-16 10:11:33.897
8392,58,2203,전북,4,4,0,9392,2021-05-28 09:00:00.000,2021-09-16 10:11:33.897
8393,14,1443,전남,7,7,0,9391,2021-05-28 09:00:00.000,2021-09-16 10:11:33.897
8394,85,4652,경북,14,14,0,9390,2021-05-28 09:00:00.000,2021-09-16 10:11:33.897
8395,19,4653,경남,21,21,0,9389,2021-05-28 09:00:00.000,2021-09-16 10:11:33.897
8396,1,1002,제주,7,7,0,9388,2021-05-28 09:00:00.000,2021-09-16 10:11:33.897
8397,4,3814,검역,11,0,11,9387,2021-05-28 09:00:00.000,2021-09-16 10:11:33.897
8398,1943,138307,합계,629,620,9,9386,2021-05-27 09:00:00.000,2021-09-16 10:11:33.897
8399,482,43216,서울,218,216,2,9385,2021-05-27 09:00:00.000,2021-09-16 10:11:33.897
8400,124,5611,부산,18,18,0,9384,2021-05-27 09:00:00.000,2021-09-16 10:11:33.897
8401,221,9819,대구,27,27,0,9383,2021-05-27 09:00:00.000,2021-09-16 10:11:33.897
8402,61,6124,인천,30,30,0,9382,2021-05-27 09:00:00.000,2021-09-16 10:11:33.897
8403,22,2766,광주,15,15,0,9381,2021-05-27 09:00:00.000,2021-09-16 10:11:33.897
8404,24,2036,대전,23,23,0,9380,2021-05-27 09:00:00.000,2021-09-16 10:11:33.897
8405,40,2548,울산,6,6,0,9379,2021-05-27 09:00:00.000,2021-09-16 10:11:33.897
8406,1,462,세종,8,8,0,9378,2021-05-27 09:00:00.000,2021-09-16 10:11:33.897
8407,631,38503,경기,170,168,2,9377,2021-05-27 09:00:00.000,2021-09-16 10:11:33.897
8408,51,3131,강원,7,7,0,9376,2021-05-27 09:00:00.000,2021-09-16 10:11:33.897
8409,68,2894,충북,9,9,0,9375,2021-05-27 09:00:00.000,2021-09-16 10:11:33.897
8410,37,3494,충남,17,17,0,9374,2021-05-27 09:00:00.000,2021-09-16 10:11:33.897
8411,58,2199,전북,6,6,0,9373,2021-05-27 09:00:00.000,2021-09-16 10:11:33.897
8412,14,1436,전남,16,16,0,9372,2021-05-27 09:00:00.000,2021-09-16 10:11:33.897
8413,85,4638,경북,12,10,2,9371,2021-05-27 09:00:00.000,2021-09-16 10:11:33.897
8414,19,4632,경남,18,18,0,9370,2021-05-27 09:00:00.000,2021-09-16 10:11:33.897
8415,1,995,제주,26,26,0,9369,2021-05-27 09:00:00.000,2021-09-16 10:11:33.897
8416,4,3803,검역,3,0,3,9368,2021-05-27 09:00:00.000,2021-09-16 10:11:33.897
8417,1940,137678,합계,705,684,21,9367,2021-05-26 09:00:00.000,2021-09-16 10:11:33.897
8418,481,42998,서울,261,260,1,9366,2021-05-26 09:00:00.000,2021-09-16 10:11:33.897
8419,124,5593,부산,22,21,1,9365,2021-05-26 09:00:00.000,2021-09-16 10:11:33.897
8420,221,9792,대구,30,30,0,9364,2021-05-26 09:00:00.000,2021-09-16 10:11:33.897
8421,61,6094,인천,19,19,0,9363,2021-05-26 09:00:00.000,2021-09-16 10:11:33.897
8422,22,2751,광주,21,20,1,9362,2021-05-26 09:00:00.000,2021-09-16 10:11:33.897
8423,24,2013,대전,17,17,0,9361,2021-05-26 09:00:00.000,2021-09-16 10:11:33.897
8424,40,2542,울산,15,15,0,9360,2021-05-26 09:00:00.000,2021-09-16 10:11:33.897
8425,1,454,세종,9,9,0,9359,2021-05-26 09:00:00.000,2021-09-16 10:11:33.897
8426,630,38333,경기,189,184,5,9358,2021-05-26 09:00:00.000,2021-09-16 10:11:33.897
8427,51,3124,강원,25,25,0,9357,2021-05-26 09:00:00.000,2021-09-16 10:11:33.897
8428,68,2885,충북,13,13,0,9356,2021-05-26 09:00:00.000,2021-09-16 10:11:33.897
8429,37,3477,충남,19,19,0,9355,2021-05-26 09:00:00.000,2021-09-16 10:11:33.897
8430,58,2193,전북,6,6,0,9354,2021-05-26 09:00:00.000,2021-09-16 10:11:33.897
8431,14,1420,전남,11,11,0,9353,2021-05-26 09:00:00.000,2021-09-16 10:11:33.897
8432,84,4626,경북,9,9,0,9352,2021-05-26 09:00:00.000,2021-09-16 10:11:33.897
8433,19,4614,경남,20,20,0,9351,2021-05-26 09:00:00.000,2021-09-16 10:11:33.897
8434,1,969,제주,6,6,0,9350,2021-05-26 09:00:00.000,2021-09-16 10:11:33.897
8435,4,3800,검역,13,0,13,9349,2021-05-26 09:00:00.000,2021-09-16 10:11:33.897
8436,1938,136973,합계,516,481,35,9348,2021-05-25 09:00:00.000,2021-09-16 10:11:33.897
8437,480,42737,서울,138,137,1,9347,2021-05-25 09:00:00.000,2021-09-16 10:11:33.897
8438,124,5571,부산,16,16,0,9346,2021-05-25 09:00:00.000,2021-09-16 10:11:33.897
8439,221,9762,대구,29,27,2,9345,2021-05-25 09:00:00.000,2021-09-16 10:11:33.897
8440,61,6075,인천,11,11,0,9344,2021-05-25 09:00:00.000,2021-09-16 10:11:33.897
8441,22,2730,광주,21,21,0,9343,2021-05-25 09:00:00.000,2021-09-16 10:11:33.897
8442,24,1996,대전,15,15,0,9342,2021-05-25 09:00:00.000,2021-09-16 10:11:33.897
8443,40,2527,울산,7,7,0,9341,2021-05-25 09:00:00.000,2021-09-16 10:11:33.897
8444,1,445,세종,14,14,0,9340,2021-05-25 09:00:00.000,2021-09-16 10:11:33.897
8445,630,38144,경기,136,132,4,9339,2021-05-25 09:00:00.000,2021-09-16 10:11:33.897
8446,51,3099,강원,21,20,1,9338,2021-05-25 09:00:00.000,2021-09-16 10:11:33.897
8447,68,2872,충북,9,8,1,9337,2021-05-25 09:00:00.000,2021-09-16 10:11:33.897
8448,37,3458,충남,22,20,2,9336,2021-05-25 09:00:00.000,2021-09-16 10:11:33.897
8449,58,2187,전북,5,5,0,9335,2021-05-25 09:00:00.000,2021-09-16 10:11:33.897
8450,13,1409,전남,7,7,0,9334,2021-05-25 09:00:00.000,2021-09-16 10:11:33.897
8451,84,4617,경북,12,11,1,9333,2021-05-25 09:00:00.000,2021-09-16 10:11:33.897
8452,19,4594,경남,14,13,1,9332,2021-05-25 09:00:00.000,2021-09-16 10:11:33.897
8453,1,963,제주,17,17,0,9331,2021-05-25 09:00:00.000,2021-09-16 10:11:33.897
8454,4,3787,검역,22,0,22,9330,2021-05-25 09:00:00.000,2021-09-16 10:11:33.897
8455,1934,136457,합계,530,505,25,9329,2021-05-24 09:00:00.000,2021-09-16 10:11:33.897
8456,480,42599,서울,139,136,3,9328,2021-05-24 09:00:00.000,2021-09-16 10:11:33.897
8457,124,5555,부산,15,14,1,9327,2021-05-24 09:00:00.000,2021-09-16 10:11:33.897
8458,221,9733,대구,48,48,0,9326,2021-05-24 09:00:00.000,2021-09-16 10:11:33.897
8459,61,6064,인천,18,18,0,9325,2021-05-24 09:00:00.000,2021-09-16 10:11:33.897
8460,22,2709,광주,16,15,1,9324,2021-05-24 09:00:00.000,2021-09-16 10:11:33.897
8461,24,1981,대전,11,11,0,9323,2021-05-24 09:00:00.000,2021-09-16 10:11:33.897
8462,40,2520,울산,12,12,0,9322,2021-05-24 09:00:00.000,2021-09-16 10:11:33.897
8463,1,431,세종,14,14,0,9321,2021-05-24 09:00:00.000,2021-09-16 10:11:33.897
8464,628,38008,경기,122,120,2,9320,2021-05-24 09:00:00.000,2021-09-16 10:11:33.897
8465,51,3078,강원,20,18,2,9319,2021-05-24 09:00:00.000,2021-09-16 10:11:33.897
8466,68,2863,충북,7,7,0,9318,2021-05-24 09:00:00.000,2021-09-16 10:11:33.897
8467,37,3436,충남,31,28,3,9317,2021-05-24 09:00:00.000,2021-09-16 10:11:33.897
8468,58,2182,전북,4,4,0,9316,2021-05-24 09:00:00.000,2021-09-16 10:11:33.897
8469,12,1402,전남,14,12,2,9315,2021-05-24 09:00:00.000,2021-09-16 10:11:33.897
8470,83,4605,경북,12,12,0,9314,2021-05-24 09:00:00.000,2021-09-16 10:11:33.897
8471,19,4580,경남,17,17,0,9313,2021-05-24 09:00:00.000,2021-09-16 10:11:33.897
8472,1,946,제주,19,19,0,9312,2021-05-24 09:00:00.000,2021-09-16 10:11:33.897
8473,4,3765,검역,11,0,11,9311,2021-05-24 09:00:00.000,2021-09-16 10:11:33.897
8474,1931,135927,합계,585,570,15,9310,2021-05-23 09:00:00.000,2021-09-16 10:11:33.897
8475,480,42460,서울,181,180,1,9309,2021-05-23 09:00:00.000,2021-09-16 10:11:33.897
8476,124,5540,부산,15,14,1,9308,2021-05-23 09:00:00.000,2021-09-16 10:11:33.897
8477,221,9685,대구,57,57,0,9307,2021-05-23 09:00:00.000,2021-09-16 10:11:33.897
8478,61,6046,인천,12,12,0,9306,2021-05-23 09:00:00.000,2021-09-16 10:11:33.897
8479,22,2693,광주,9,9,0,9305,2021-05-23 09:00:00.000,2021-09-16 10:11:33.897
8480,24,1970,대전,12,12,0,9304,2021-05-23 09:00:00.000,2021-09-16 10:11:33.897
8481,40,2508,울산,24,23,1,9303,2021-05-23 09:00:00.000,2021-09-16 10:11:33.897
8482,1,417,세종,1,1,0,9302,2021-05-23 09:00:00.000,2021-09-16 10:11:33.897
8483,627,37886,경기,151,150,1,9301,2021-05-23 09:00:00.000,2021-09-16 10:11:33.897
8484,50,3058,강원,19,18,1,9300,2021-05-23 09:00:00.000,2021-09-16 10:11:33.897
8485,68,2856,충북,9,9,0,9299,2021-05-23 09:00:00.000,2021-09-16 10:11:33.897
8486,37,3405,충남,24,24,0,9298,2021-05-23 09:00:00.000,2021-09-16 10:11:33.897
8487,58,2178,전북,14,14,0,9297,2021-05-23 09:00:00.000,2021-09-16 10:11:33.897
8488,12,1388,전남,10,10,0,9296,2021-05-23 09:00:00.000,2021-09-16 10:11:33.897
8489,82,4593,경북,12,12,0,9295,2021-05-23 09:00:00.000,2021-09-16 10:11:33.897
8490,19,4563,경남,17,17,0,9294,2021-05-23 09:00:00.000,2021-09-16 10:11:33.897
8491,1,927,제주,8,8,0,9293,2021-05-23 09:00:00.000,2021-09-16 10:11:33.897
8492,4,3754,검역,10,0,10,9292,2021-05-23 09:00:00.000,2021-09-16 10:11:33.897
8493,1926,135342,합계,666,633,33,9291,2021-05-22 09:00:00.000,2021-09-16 10:11:33.897
8494,480,42279,서울,208,205,3,9290,2021-05-22 09:00:00.000,2021-09-16 10:11:33.897
8495,123,5525,부산,28,27,1,9289,2021-05-22 09:00:00.000,2021-09-16 10:11:33.897
8496,221,9628,대구,56,55,1,9288,2021-05-22 09:00:00.000,2021-09-16 10:11:33.897
8497,61,6034,인천,15,13,2,9287,2021-05-22 09:00:00.000,2021-09-16 10:11:33.897
8498,22,2684,광주,15,15,0,9286,2021-05-22 09:00:00.000,2021-09-16 10:11:33.897
8499,23,1958,대전,5,5,0,9285,2021-05-22 09:00:00.000,2021-09-16 10:11:33.897
8500,39,2484,울산,29,29,0,9284,2021-05-22 09:00:00.000,2021-09-16 10:11:33.897
8501,1,416,세종,0,0,0,9283,2021-05-22 09:00:00.000,2021-09-16 10:11:33.897
8502,625,37735,경기,165,163,2,9282,2021-05-22 09:00:00.000,2021-09-16 10:11:33.897
8503,50,3039,강원,29,29,0,9281,2021-05-22 09:00:00.000,2021-09-16 10:11:33.897
8504,68,2847,충북,6,4,2,9280,2021-05-22 09:00:00.000,2021-09-16 10:11:33.897
8505,37,3381,충남,17,17,0,9279,2021-05-22 09:00:00.000,2021-09-16 10:11:33.897
8506,58,2164,전북,12,12,0,9278,2021-05-22 09:00:00.000,2021-09-16 10:11:33.897
8507,12,1378,전남,16,16,0,9277,2021-05-22 09:00:00.000,2021-09-16 10:11:33.897
8508,82,4581,경북,16,15,1,9276,2021-05-22 09:00:00.000,2021-09-16 10:11:33.897
8509,19,4546,경남,21,21,0,9275,2021-05-22 09:00:00.000,2021-09-16 10:11:33.897
8510,1,919,제주,7,7,0,9274,2021-05-22 09:00:00.000,2021-09-16 10:11:33.897
8511,4,3744,검역,21,0,21,9273,2021-05-22 09:00:00.000,2021-09-16 10:11:33.897
8512,1922,134676,합계,561,542,19,9272,2021-05-21 09:00:00.000,2021-09-16 10:11:33.897
8513,479,42071,서울,172,171,1,9271,2021-05-21 09:00:00.000,2021-09-16 10:11:33.897
8514,123,5497,부산,15,13,2,9270,2021-05-21 09:00:00.000,2021-09-16 10:11:33.897
8515,221,9572,대구,19,18,1,9269,2021-05-21 09:00:00.000,2021-09-16 10:11:33.897
8516,60,6019,인천,12,12,0,9268,2021-05-21 09:00:00.000,2021-09-16 10:11:33.897
8517,22,2669,광주,13,13,0,9267,2021-05-21 09:00:00.000,2021-09-16 10:11:33.897
8518,22,1953,대전,15,15,0,9266,2021-05-21 09:00:00.000,2021-09-16 10:11:33.897
8519,39,2455,울산,13,13,0,9265,2021-05-21 09:00:00.000,2021-09-16 10:11:33.897
8520,1,416,세종,1,1,0,9264,2021-05-21 09:00:00.000,2021-09-16 10:11:33.897
8521,624,37570,경기,164,161,3,9263,2021-05-21 09:00:00.000,2021-09-16 10:11:33.897
8522,50,3010,강원,7,7,0,9262,2021-05-21 09:00:00.000,2021-09-16 10:11:33.897
8523,68,2841,충북,12,12,0,9261,2021-05-21 09:00:00.000,2021-09-16 10:11:33.897
8524,37,3364,충남,41,40,1,9260,2021-05-21 09:00:00.000,2021-09-16 10:11:33.897
8525,58,2152,전북,16,15,1,9259,2021-05-21 09:00:00.000,2021-09-16 10:11:33.897
8526,12,1362,전남,17,17,0,9258,2021-05-21 09:00:00.000,2021-09-16 10:11:33.897
8527,82,4565,경북,11,11,0,9257,2021-05-21 09:00:00.000,2021-09-16 10:11:33.897
8528,19,4525,경남,18,18,0,9256,2021-05-21 09:00:00.000,2021-09-16 10:11:33.897
8529,1,912,제주,5,5,0,9255,2021-05-21 09:00:00.000,2021-09-16 10:11:33.897
8530,4,3723,검역,10,0,10,9254,2021-05-21 09:00:00.000,2021-09-16 10:11:33.897
8531,1916,134115,합계,646,619,27,9253,2021-05-20 09:00:00.000,2021-09-16 10:11:33.897
8532,475,41899,서울,242,238,4,9252,2021-05-20 09:00:00.000,2021-09-16 10:11:33.897
8533,123,5482,부산,17,17,0,9251,2021-05-20 09:00:00.000,2021-09-16 10:11:33.897
8534,221,9553,대구,9,9,0,9250,2021-05-20 09:00:00.000,2021-09-16 10:11:33.897
8535,60,6007,인천,13,13,0,9249,2021-05-20 09:00:00.000,2021-09-16 10:11:33.897
8536,22,2656,광주,15,15,0,9248,2021-05-20 09:00:00.000,2021-09-16 10:11:33.897
8537,22,1938,대전,8,7,1,9247,2021-05-20 09:00:00.000,2021-09-16 10:11:33.897
8538,39,2442,울산,25,25,0,9246,2021-05-20 09:00:00.000,2021-09-16 10:11:33.897
8539,1,415,세종,9,8,1,9245,2021-05-20 09:00:00.000,2021-09-16 10:11:33.897
8540,623,37406,경기,187,183,4,9244,2021-05-20 09:00:00.000,2021-09-16 10:11:33.897
8541,50,3003,강원,8,8,0,9243,2021-05-20 09:00:00.000,2021-09-16 10:11:33.897
8542,68,2829,충북,13,13,0,9242,2021-05-20 09:00:00.000,2021-09-16 10:11:33.897
8543,37,3323,충남,19,19,0,9241,2021-05-20 09:00:00.000,2021-09-16 10:11:33.897
8544,58,2136,전북,7,7,0,9240,2021-05-20 09:00:00.000,2021-09-16 10:11:33.897
8545,12,1345,전남,7,6,1,9239,2021-05-20 09:00:00.000,2021-09-16 10:11:33.897
8546,81,4554,경북,33,33,0,9238,2021-05-20 09:00:00.000,2021-09-16 10:11:33.897
8547,19,4507,경남,12,12,0,9237,2021-05-20 09:00:00.000,2021-09-16 10:11:33.897
8548,1,907,제주,6,6,0,9236,2021-05-20 09:00:00.000,2021-09-16 10:11:33.897
8549,4,3713,검역,16,0,16,9235,2021-05-20 09:00:00.000,2021-09-16 10:11:33.897
8550,1912,133469,합계,654,637,17,9234,2021-05-19 09:00:00.000,2021-09-16 10:11:33.897
8551,474,41657,서울,249,245,4,9233,2021-05-19 09:00:00.000,2021-09-16 10:11:33.897
8552,123,5465,부산,27,27,0,9232,2021-05-19 09:00:00.000,2021-09-16 10:11:33.897
8553,221,9544,대구,23,23,0,9231,2021-05-19 09:00:00.000,2021-09-16 10:11:33.897
8554,60,5994,인천,23,23,0,9230,2021-05-19 09:00:00.000,2021-09-16 10:11:33.897
8555,22,2641,광주,4,4,0,9229,2021-05-19 09:00:00.000,2021-09-16 10:11:33.897
8556,21,1930,대전,10,10,0,9228,2021-05-19 09:00:00.000,2021-09-16 10:11:33.897
8557,39,2417,울산,27,27,0,9227,2021-05-19 09:00:00.000,2021-09-16 10:11:33.897
8558,1,406,세종,3,3,0,9226,2021-05-19 09:00:00.000,2021-09-16 10:11:33.897
8559,621,37219,경기,164,159,5,9225,2021-05-19 09:00:00.000,2021-09-16 10:11:33.897
8560,50,2995,강원,16,16,0,9224,2021-05-19 09:00:00.000,2021-09-16 10:11:33.897
8561,68,2816,충북,21,21,0,9223,2021-05-19 09:00:00.000,2021-09-16 10:11:33.897
8562,37,3304,충남,17,16,1,9222,2021-05-19 09:00:00.000,2021-09-16 10:11:33.897
8563,58,2129,전북,9,9,0,9221,2021-05-19 09:00:00.000,2021-09-16 10:11:33.897
8564,12,1338,전남,10,10,0,9220,2021-05-19 09:00:00.000,2021-09-16 10:11:33.897
8565,81,4521,경북,24,24,0,9219,2021-05-19 09:00:00.000,2021-09-16 10:11:33.897
8566,19,4495,경남,16,16,0,9218,2021-05-19 09:00:00.000,2021-09-16 10:11:33.897
8567,1,901,제주,4,4,0,9217,2021-05-19 09:00:00.000,2021-09-16 10:11:33.897
8568,4,3697,검역,7,0,7,9216,2021-05-19 09:00:00.000,2021-09-16 10:11:33.897
8569,1904,132815,합계,528,506,22,9215,2021-05-18 09:00:00.000,2021-09-16 10:11:33.897
8570,472,41408,서울,172,169,3,9214,2021-05-18 09:00:00.000,2021-09-16 10:11:33.897
8571,122,5438,부산,13,13,0,9213,2021-05-18 09:00:00.000,2021-09-16 10:11:33.897
8572,221,9521,대구,23,23,0,9212,2021-05-18 09:00:00.000,2021-09-16 10:11:33.897
8573,60,5971,인천,16,16,0,9211,2021-05-18 09:00:00.000,2021-09-16 10:11:33.897
8574,22,2637,광주,11,11,0,9210,2021-05-18 09:00:00.000,2021-09-16 10:11:33.897
8575,21,1920,대전,12,12,0,9209,2021-05-18 09:00:00.000,2021-09-16 10:11:33.897
8576,39,2390,울산,6,6,0,9208,2021-05-18 09:00:00.000,2021-09-16 10:11:33.897
8577,1,403,세종,4,4,0,9207,2021-05-18 09:00:00.000,2021-09-16 10:11:33.897
8578,617,37055,경기,137,134,3,9206,2021-05-18 09:00:00.000,2021-09-16 10:11:33.897
8579,50,2979,강원,25,25,0,9205,2021-05-18 09:00:00.000,2021-09-16 10:11:33.897
8580,68,2795,충북,13,13,0,9204,2021-05-18 09:00:00.000,2021-09-16 10:11:33.897
8581,36,3287,충남,15,15,0,9203,2021-05-18 09:00:00.000,2021-09-16 10:11:33.897
8582,58,2120,전북,7,7,0,9202,2021-05-18 09:00:00.000,2021-09-16 10:11:33.897
8583,12,1328,전남,12,12,0,9201,2021-05-18 09:00:00.000,2021-09-16 10:11:33.897
8584,81,4497,경북,23,21,2,9200,2021-05-18 09:00:00.000,2021-09-16 10:11:33.897
8585,19,4479,경남,16,15,1,9199,2021-05-18 09:00:00.000,2021-09-16 10:11:33.897
8586,1,897,제주,11,10,1,9198,2021-05-18 09:00:00.000,2021-09-16 10:11:33.897
8587,4,3690,검역,12,0,12,9197,2021-05-18 09:00:00.000,2021-09-16 10:11:33.897
8588,1903,132287,합계,619,597,22,9196,2021-05-17 09:00:00.000,2021-09-16 10:11:33.897
8589,472,41236,서울,195,192,3,9195,2021-05-17 09:00:00.000,2021-09-16 10:11:33.897
8590,122,5425,부산,12,12,0,9194,2021-05-17 09:00:00.000,2021-09-16 10:11:33.897
8591,221,9498,대구,19,19,0,9193,2021-05-17 09:00:00.000,2021-09-16 10:11:33.897
8592,60,5955,인천,14,12,2,9192,2021-05-17 09:00:00.000,2021-09-16 10:11:33.897
8593,22,2626,광주,27,27,0,9191,2021-05-17 09:00:00.000,2021-09-16 10:11:33.897
8594,21,1908,대전,2,2,0,9190,2021-05-17 09:00:00.000,2021-09-16 10:11:33.897
8595,39,2384,울산,16,16,0,9189,2021-05-17 09:00:00.000,2021-09-16 10:11:33.897
8596,1,399,세종,0,0,0,9188,2021-05-17 09:00:00.000,2021-09-16 10:11:33.897
8597,617,36918,경기,150,148,2,9187,2021-05-17 09:00:00.000,2021-09-16 10:11:33.897
8598,50,2954,강원,35,35,0,9186,2021-05-17 09:00:00.000,2021-09-16 10:11:33.897
8599,68,2782,충북,23,22,1,9185,2021-05-17 09:00:00.000,2021-09-16 10:11:33.897
8600,36,3272,충남,16,14,2,9184,2021-05-17 09:00:00.000,2021-09-16 10:11:33.897
8601,58,2113,전북,9,9,0,9183,2021-05-17 09:00:00.000,2021-09-16 10:11:33.897
8602,12,1316,전남,20,17,3,9182,2021-05-17 09:00:00.000,2021-09-16 10:11:33.897
8603,80,4474,경북,27,27,0,9181,2021-05-17 09:00:00.000,2021-09-16 10:11:33.897
8604,19,4463,경남,30,30,0,9180,2021-05-17 09:00:00.000,2021-09-16 10:11:33.897
8605,1,886,제주,15,15,0,9179,2021-05-17 09:00:00.000,2021-09-16 10:11:33.897
8606,4,3678,검역,9,0,9,9178,2021-05-17 09:00:00.000,2021-09-16 10:11:33.897
8607,1900,131668,합계,610,572,38,9177,2021-05-16 09:00:00.000,2021-09-16 10:11:33.897
8608,471,41041,서울,213,208,5,9176,2021-05-16 09:00:00.000,2021-09-16 10:11:33.897
8609,122,5413,부산,31,30,1,9175,2021-05-16 09:00:00.000,2021-09-16 10:11:33.897
8610,221,9479,대구,6,6,0,9174,2021-05-16 09:00:00.000,2021-09-16 10:11:33.897
8611,60,5941,인천,15,15,0,9173,2021-05-16 09:00:00.000,2021-09-16 10:11:33.897
8612,22,2599,광주,14,14,0,9172,2021-05-16 09:00:00.000,2021-09-16 10:11:33.897
8613,20,1906,대전,4,4,0,9171,2021-05-16 09:00:00.000,2021-09-16 10:11:33.897
8614,39,2368,울산,11,11,0,9170,2021-05-16 09:00:00.000,2021-09-16 10:11:33.897
8615,1,399,세종,0,0,0,9169,2021-05-16 09:00:00.000,2021-09-16 10:11:33.897
8616,617,36768,경기,161,156,5,9168,2021-05-16 09:00:00.000,2021-09-16 10:11:33.897
8617,50,2919,강원,5,5,0,9167,2021-05-16 09:00:00.000,2021-09-16 10:11:33.897
8618,68,2759,충북,20,19,1,9166,2021-05-16 09:00:00.000,2021-09-16 10:11:33.897
8619,36,3256,충남,18,14,4,9165,2021-05-16 09:00:00.000,2021-09-16 10:11:33.897
8620,58,2104,전북,14,13,1,9164,2021-05-16 09:00:00.000,2021-09-16 10:11:33.897
8621,12,1296,전남,13,13,0,9163,2021-05-16 09:00:00.000,2021-09-16 10:11:33.897
8622,79,4447,경북,11,11,0,9162,2021-05-16 09:00:00.000,2021-09-16 10:11:33.897
8623,19,4433,경남,45,44,1,9161,2021-05-16 09:00:00.000,2021-09-16 10:11:33.897
8624,1,871,제주,9,9,0,9160,2021-05-16 09:00:00.000,2021-09-16 10:11:33.897
8625,4,3669,검역,20,0,20,9159,2021-05-16 09:00:00.000,2021-09-16 10:11:33.897
8626,1896,131058,합계,681,661,20,9158,2021-05-15 09:00:00.000,2021-09-16 10:11:33.897
8627,468,40828,서울,254,253,1,9157,2021-05-15 09:00:00.000,2021-09-16 10:11:33.897
8628,122,5382,부산,42,41,1,9156,2021-05-15 09:00:00.000,2021-09-16 10:11:33.897
8629,221,9473,대구,5,4,1,9155,2021-05-15 09:00:00.000,2021-09-16 10:11:33.897
8630,60,5926,인천,16,16,0,9154,2021-05-15 09:00:00.000,2021-09-16 10:11:33.897
8631,22,2585,광주,11,10,1,9153,2021-05-15 09:00:00.000,2021-09-16 10:11:33.897
8632,20,1902,대전,10,10,0,9152,2021-05-15 09:00:00.000,2021-09-16 10:11:33.897
8633,39,2357,울산,22,22,0,9151,2021-05-15 09:00:00.000,2021-09-16 10:11:33.897
8634,1,399,세종,3,3,0,9150,2021-05-15 09:00:00.000,2021-09-16 10:11:33.897
8635,616,36607,경기,170,168,2,9149,2021-05-15 09:00:00.000,2021-09-16 10:11:33.897
8636,50,2914,강원,12,12,0,9148,2021-05-15 09:00:00.000,2021-09-16 10:11:33.897
8637,68,2739,충북,5,5,0,9147,2021-05-15 09:00:00.000,2021-09-16 10:11:33.897
8638,36,3238,충남,12,10,2,9146,2021-05-15 09:00:00.000,2021-09-16 10:11:33.897
8639,58,2090,전북,11,10,1,9145,2021-05-15 09:00:00.000,2021-09-16 10:11:33.897
8640,12,1283,전남,26,26,0,9144,2021-05-15 09:00:00.000,2021-09-16 10:11:33.897
8641,79,4436,경북,19,19,0,9143,2021-05-15 09:00:00.000,2021-09-16 10:11:33.897
8642,19,4388,경남,40,38,2,9142,2021-05-15 09:00:00.000,2021-09-16 10:11:33.897
8643,1,862,제주,14,14,0,9141,2021-05-15 09:00:00.000,2021-09-16 10:11:33.897
8644,4,3649,검역,9,0,9,9140,2021-05-15 09:00:00.000,2021-09-16 10:11:33.897
8645,1893,130377,합계,747,729,18,9139,2021-05-14 09:00:00.000,2021-09-16 10:11:33.897
8646,468,40574,서울,231,229,2,9138,2021-05-14 09:00:00.000,2021-09-16 10:11:33.897
8647,122,5340,부산,24,24,0,9137,2021-05-14 09:00:00.000,2021-09-16 10:11:33.897
8648,221,9468,대구,9,9,0,9136,2021-05-14 09:00:00.000,2021-09-16 10:11:33.897
8649,60,5910,인천,34,34,0,9135,2021-05-14 09:00:00.000,2021-09-16 10:11:33.897
8650,22,2574,광주,11,10,1,9134,2021-05-14 09:00:00.000,2021-09-16 10:11:33.897
8651,20,1892,대전,31,31,0,9133,2021-05-14 09:00:00.000,2021-09-16 10:11:33.897
8652,38,2335,울산,26,26,0,9132,2021-05-14 09:00:00.000,2021-09-16 10:11:33.897
8653,1,396,세종,7,7,0,9131,2021-05-14 09:00:00.000,2021-09-16 10:11:33.897
8654,615,36437,경기,173,172,1,9130,2021-05-14 09:00:00.000,2021-09-16 10:11:33.897
8655,50,2902,강원,25,25,0,9129,2021-05-14 09:00:00.000,2021-09-16 10:11:33.897
8656,67,2734,충북,4,4,0,9128,2021-05-14 09:00:00.000,2021-09-16 10:11:33.897
8657,36,3226,충남,22,22,0,9127,2021-05-14 09:00:00.000,2021-09-16 10:11:33.897
8658,58,2079,전북,14,14,0,9126,2021-05-14 09:00:00.000,2021-09-16 10:11:33.897
8659,12,1257,전남,50,50,0,9125,2021-05-14 09:00:00.000,2021-09-16 10:11:33.897
8660,79,4417,경북,35,34,1,9124,2021-05-14 09:00:00.000,2021-09-16 10:11:33.897
8661,19,4348,경남,32,28,4,9123,2021-05-14 09:00:00.000,2021-09-16 10:11:33.897
8662,1,848,제주,10,10,0,9122,2021-05-14 09:00:00.000,2021-09-16 10:11:33.897
8663,4,3640,검역,9,0,9,9121,2021-05-14 09:00:00.000,2021-09-16 10:11:33.897
8664,1891,129630,합계,715,692,23,9120,2021-05-13 09:00:00.000,2021-09-16 10:11:33.897
8665,468,40343,서울,227,227,0,9119,2021-05-13 09:00:00.000,2021-09-16 10:11:33.897
8666,122,5316,부산,20,20,0,9118,2021-05-13 09:00:00.000,2021-09-16 10:11:33.897
8667,221,9459,대구,5,5,0,9117,2021-05-13 09:00:00.000,2021-09-16 10:11:33.897
8668,60,5876,인천,17,17,0,9116,2021-05-13 09:00:00.000,2021-09-16 10:11:33.897
8669,22,2563,광주,23,23,0,9115,2021-05-13 09:00:00.000,2021-09-16 10:11:33.897
8670,20,1861,대전,18,18,0,9114,2021-05-13 09:00:00.000,2021-09-16 10:11:33.897
8671,38,2309,울산,31,31,0,9113,2021-05-13 09:00:00.000,2021-09-16 10:11:33.897
8672,1,389,세종,2,2,0,9112,2021-05-13 09:00:00.000,2021-09-16 10:11:33.897
8673,614,36264,경기,226,222,4,9111,2021-05-13 09:00:00.000,2021-09-16 10:11:33.897
8674,50,2877,강원,17,15,2,9110,2021-05-13 09:00:00.000,2021-09-16 10:11:33.897
8675,66,2730,충북,10,10,0,9109,2021-05-13 09:00:00.000,2021-09-16 10:11:33.897
8676,36,3204,충남,19,19,0,9108,2021-05-13 09:00:00.000,2021-09-16 10:11:33.897
8677,58,2065,전북,10,10,0,9107,2021-05-13 09:00:00.000,2021-09-16 10:11:33.897
8678,12,1207,전남,12,12,0,9106,2021-05-13 09:00:00.000,2021-09-16 10:11:33.897
8679,79,4382,경북,23,22,1,9105,2021-05-13 09:00:00.000,2021-09-16 10:11:33.897
8680,19,4316,경남,32,30,2,9104,2021-05-13 09:00:00.000,2021-09-16 10:11:33.897
8681,1,838,제주,9,9,0,9103,2021-05-13 09:00:00.000,2021-09-16 10:11:33.897
8682,4,3631,검역,14,0,14,9102,2021-05-13 09:00:00.000,2021-09-16 10:11:33.897
8683,1884,128915,합계,634,612,22,9101,2021-05-12 09:00:00.000,2021-09-16 10:11:33.897
8684,466,40116,서울,222,219,3,9100,2021-05-12 09:00:00.000,2021-09-16 10:11:33.897
8685,122,5296,부산,10,10,0,9099,2021-05-12 09:00:00.000,2021-09-16 10:11:33.897
8686,221,9454,대구,6,5,1,9098,2021-05-12 09:00:00.000,2021-09-16 10:11:33.897
8687,60,5859,인천,20,20,0,9097,2021-05-12 09:00:00.000,2021-09-16 10:11:33.897
8688,22,2540,광주,22,22,0,9096,2021-05-12 09:00:00.000,2021-09-16 10:11:33.897
8689,20,1843,대전,8,8,0,9095,2021-05-12 09:00:00.000,2021-09-16 10:11:33.897
8690,38,2278,울산,31,31,0,9094,2021-05-12 09:00:00.000,2021-09-16 10:11:33.897
8691,1,387,세종,1,1,0,9093,2021-05-12 09:00:00.000,2021-09-16 10:11:33.897
8692,611,36038,경기,187,184,3,9092,2021-05-12 09:00:00.000,2021-09-16 10:11:33.897
8693,50,2860,강원,17,16,1,9091,2021-05-12 09:00:00.000,2021-09-16 10:11:33.897
8694,65,2720,충북,12,12,0,9090,2021-05-12 09:00:00.000,2021-09-16 10:11:33.897
8695,36,3185,충남,10,10,0,9089,2021-05-12 09:00:00.000,2021-09-16 10:11:33.897
8696,58,2055,전북,22,22,0,9088,2021-05-12 09:00:00.000,2021-09-16 10:11:33.897
8697,11,1195,전남,17,17,0,9087,2021-05-12 09:00:00.000,2021-09-16 10:11:33.897
8698,79,4359,경북,7,7,0,9086,2021-05-12 09:00:00.000,2021-09-16 10:11:33.897
8699,19,4284,경남,16,15,1,9085,2021-05-12 09:00:00.000,2021-09-16 10:11:33.897
8700,1,829,제주,13,13,0,9084,2021-05-12 09:00:00.000,2021-09-16 10:11:33.897
8701,4,3617,검역,13,0,13,9083,2021-05-12 09:00:00.000,2021-09-16 10:11:33.897
8702,1879,128281,합계,510,483,27,9082,2021-05-11 09:00:00.000,2021-09-16 10:11:33.897
8703,464,39894,서울,163,163,0,9081,2021-05-11 09:00:00.000,2021-09-16 10:11:33.897
8704,122,5286,부산,14,13,1,9080,2021-05-11 09:00:00.000,2021-09-16 10:11:33.897
8705,221,9448,대구,8,8,0,9079,2021-05-11 09:00:00.000,2021-09-16 10:11:33.897
8706,60,5839,인천,21,20,1,9078,2021-05-11 09:00:00.000,2021-09-16 10:11:33.897
8707,22,2518,광주,24,23,1,9077,2021-05-11 09:00:00.000,2021-09-16 10:11:33.897
8708,20,1835,대전,7,7,0,9076,2021-05-11 09:00:00.000,2021-09-16 10:11:33.897
8709,38,2247,울산,19,19,0,9075,2021-05-11 09:00:00.000,2021-09-16 10:11:33.897
8710,1,386,세종,0,0,0,9074,2021-05-11 09:00:00.000,2021-09-16 10:11:33.897
8711,608,35851,경기,137,127,10,9073,2021-05-11 09:00:00.000,2021-09-16 10:11:33.897
8712,50,2843,강원,12,12,0,9072,2021-05-11 09:00:00.000,2021-09-16 10:11:33.897
8713,65,2708,충북,4,4,0,9071,2021-05-11 09:00:00.000,2021-09-16 10:11:33.897
8714,36,3175,충남,18,18,0,9070,2021-05-11 09:00:00.000,2021-09-16 10:11:33.897
8715,58,2033,전북,12,12,0,9069,2021-05-11 09:00:00.000,2021-09-16 10:11:33.897
8716,11,1178,전남,10,10,0,9068,2021-05-11 09:00:00.000,2021-09-16 10:11:33.897
8717,79,4352,경북,15,15,0,9067,2021-05-11 09:00:00.000,2021-09-16 10:11:33.897
8718,19,4268,경남,10,9,1,9066,2021-05-11 09:00:00.000,2021-09-16 10:11:33.897
8719,1,816,제주,24,23,1,9065,2021-05-11 09:00:00.000,2021-09-16 10:11:33.897
8720,4,3604,검역,12,0,12,9064,2021-05-11 09:00:00.000,2021-09-16 10:11:33.897
8721,1875,127771,합계,463,436,27,9063,2021-05-10 09:00:00.000,2021-09-16 10:11:33.897
8722,462,39731,서울,141,136,5,9062,2021-05-10 09:00:00.000,2021-09-16 10:11:33.897
8723,122,5272,부산,20,19,1,9061,2021-05-10 09:00:00.000,2021-09-16 10:11:33.897
8724,221,9440,대구,4,3,1,9060,2021-05-10 09:00:00.000,2021-09-16 10:11:33.897
8725,60,5818,인천,13,12,1,9059,2021-05-10 09:00:00.000,2021-09-16 10:11:33.897
8726,22,2494,광주,9,9,0,9058,2021-05-10 09:00:00.000,2021-09-16 10:11:33.897
8727,20,1828,대전,4,4,0,9057,2021-05-10 09:00:00.000,2021-09-16 10:11:33.897
8728,38,2228,울산,24,24,0,9056,2021-05-10 09:00:00.000,2021-09-16 10:11:33.897
8729,1,386,세종,7,7,0,9055,2021-05-10 09:00:00.000,2021-09-16 10:11:33.897
8730,607,35714,경기,137,135,2,9054,2021-05-10 09:00:00.000,2021-09-16 10:11:33.897
8731,50,2831,강원,5,4,1,9053,2021-05-10 09:00:00.000,2021-09-16 10:11:33.897
8732,65,2704,충북,4,4,0,9052,2021-05-10 09:00:00.000,2021-09-16 10:11:33.897
8733,36,3157,충남,15,14,1,9051,2021-05-10 09:00:00.000,2021-09-16 10:11:33.897
8734,58,2021,전북,9,9,0,9050,2021-05-10 09:00:00.000,2021-09-16 10:11:33.897
8735,11,1168,전남,9,9,0,9049,2021-05-10 09:00:00.000,2021-09-16 10:11:33.897
8736,78,4337,경북,19,19,0,9048,2021-05-10 09:00:00.000,2021-09-16 10:11:33.897
8737,19,4258,경남,16,14,2,9047,2021-05-10 09:00:00.000,2021-09-16 10:11:33.897
8738,1,792,제주,14,14,0,9046,2021-05-10 09:00:00.000,2021-09-16 10:11:33.897
8739,4,3592,검역,13,0,13,9045,2021-05-10 09:00:00.000,2021-09-16 10:11:33.897
8740,1874,127308,합계,564,522,42,9044,2021-05-09 09:00:00.000,2021-09-16 10:11:33.897
8741,462,39590,서울,195,191,4,9043,2021-05-09 09:00:00.000,2021-09-16 10:11:33.897
8742,122,5252,부산,10,10,0,9042,2021-05-09 09:00:00.000,2021-09-16 10:11:33.897
8743,221,9436,대구,6,6,0,9041,2021-05-09 09:00:00.000,2021-09-16 10:11:33.897
8744,60,5805,인천,11,11,0,9040,2021-05-09 09:00:00.000,2021-09-16 10:11:33.897
8745,22,2485,광주,6,6,0,9039,2021-05-09 09:00:00.000,2021-09-16 10:11:33.897
8746,20,1824,대전,2,2,0,9038,2021-05-09 09:00:00.000,2021-09-16 10:11:33.897
8747,38,2204,울산,28,28,0,9037,2021-05-09 09:00:00.000,2021-09-16 10:11:33.897
8748,1,379,세종,1,1,0,9036,2021-05-09 09:00:00.000,2021-09-16 10:11:33.897
8749,606,35577,경기,149,144,5,9035,2021-05-09 09:00:00.000,2021-09-16 10:11:33.897
8750,50,2826,강원,7,7,0,9034,2021-05-09 09:00:00.000,2021-09-16 10:11:33.897
8751,65,2700,충북,9,8,1,9033,2021-05-09 09:00:00.000,2021-09-16 10:11:33.897
8752,36,3142,충남,10,10,0,9032,2021-05-09 09:00:00.000,2021-09-16 10:11:33.897
8753,58,2012,전북,8,8,0,9031,2021-05-09 09:00:00.000,2021-09-16 10:11:33.897
8754,11,1159,전남,24,24,0,9030,2021-05-09 09:00:00.000,2021-09-16 10:11:33.897
8755,78,4318,경북,19,19,0,9029,2021-05-09 09:00:00.000,2021-09-16 10:11:33.897
8756,19,4242,경남,30,30,0,9028,2021-05-09 09:00:00.000,2021-09-16 10:11:33.897
8757,1,778,제주,18,17,1,9027,2021-05-09 09:00:00.000,2021-09-16 10:11:33.897
8758,4,3579,검역,31,0,31,9026,2021-05-09 09:00:00.000,2021-09-16 10:11:33.897
8759,1865,126744,합계,701,672,29,9025,2021-05-08 09:00:00.000,2021-09-16 10:11:33.897
8760,459,39395,서울,242,240,2,9024,2021-05-08 09:00:00.000,2021-09-16 10:11:33.897
8761,122,5242,부산,27,26,1,9023,2021-05-08 09:00:00.000,2021-09-16 10:11:33.897
8762,221,9430,대구,13,13,0,9022,2021-05-08 09:00:00.000,2021-09-16 10:11:33.897
8763,59,5794,인천,22,20,2,9021,2021-05-08 09:00:00.000,2021-09-16 10:11:33.897
8764,22,2479,광주,5,5,0,9020,2021-05-08 09:00:00.000,2021-09-16 10:11:33.897
8765,19,1822,대전,9,8,1,9019,2021-05-08 09:00:00.000,2021-09-16 10:11:33.897
8766,38,2176,울산,48,47,1,9018,2021-05-08 09:00:00.000,2021-09-16 10:11:33.897
8767,1,378,세종,5,5,0,9017,2021-05-08 09:00:00.000,2021-09-16 10:11:33.897
8768,602,35428,경기,194,192,2,9016,2021-05-08 09:00:00.000,2021-09-16 10:11:33.897
8769,50,2819,강원,27,27,0,9015,2021-05-08 09:00:00.000,2021-09-16 10:11:33.897
8770,65,2691,충북,9,9,0,9014,2021-05-08 09:00:00.000,2021-09-16 10:11:33.897
8771,36,3132,충남,3,3,0,9013,2021-05-08 09:00:00.000,2021-09-16 10:11:33.897
8772,58,2004,전북,5,4,1,9012,2021-05-08 09:00:00.000,2021-09-16 10:11:33.897
8773,11,1135,전남,12,11,1,9011,2021-05-08 09:00:00.000,2021-09-16 10:11:33.897
8774,78,4299,경북,21,20,1,9010,2021-05-08 09:00:00.000,2021-09-16 10:11:33.897
8775,19,4212,경남,37,37,0,9009,2021-05-08 09:00:00.000,2021-09-16 10:11:33.897
8776,1,760,제주,5,5,0,9008,2021-05-08 09:00:00.000,2021-09-16 10:11:33.897
8777,4,3548,검역,17,0,17,9007,2021-05-08 09:00:00.000,2021-09-16 10:11:33.897
8778,1860,126043,합계,525,509,16,9006,2021-05-07 09:00:00.000,2021-09-16 10:11:33.897
8779,457,39153,서울,179,177,2,9005,2021-05-07 09:00:00.000,2021-09-16 10:11:33.897
8780,122,5215,부산,21,20,1,9004,2021-05-07 09:00:00.000,2021-09-16 10:11:33.897
8781,221,9417,대구,9,9,0,9003,2021-05-07 09:00:00.000,2021-09-16 10:11:33.897
8782,59,5772,인천,14,12,2,9002,2021-05-07 09:00:00.000,2021-09-16 10:11:33.897
8783,22,2474,광주,21,21,0,9001,2021-05-07 09:00:00.000,2021-09-16 10:11:33.897
8784,18,1813,대전,7,7,0,9000,2021-05-07 09:00:00.000,2021-09-16 10:11:33.897
8785,38,2128,울산,35,35,0,8999,2021-05-07 09:00:00.000,2021-09-16 10:11:33.897
8786,1,373,세종,0,0,0,8998,2021-05-07 09:00:00.000,2021-09-16 10:11:33.897
8787,601,35234,경기,139,136,3,8997,2021-05-07 09:00:00.000,2021-09-16 10:11:33.897
8788,50,2792,강원,8,8,0,8996,2021-05-07 09:00:00.000,2021-09-16 10:11:33.897
8789,64,2682,충북,5,4,1,8995,2021-05-07 09:00:00.000,2021-09-16 10:11:33.897
8790,36,3129,충남,9,8,1,8994,2021-05-07 09:00:00.000,2021-09-16 10:11:33.897
8791,58,1999,전북,6,6,0,8993,2021-05-07 09:00:00.000,2021-09-16 10:11:33.897
8792,11,1123,전남,12,12,0,8992,2021-05-07 09:00:00.000,2021-09-16 10:11:33.897
8793,78,4278,경북,12,12,0,8991,2021-05-07 09:00:00.000,2021-09-16 10:11:33.897
8794,19,4175,경남,32,30,2,8990,2021-05-07 09:00:00.000,2021-09-16 10:11:33.897
8795,1,755,제주,12,12,0,8989,2021-05-07 09:00:00.000,2021-09-16 10:11:33.897
8796,4,3531,검역,4,0,4,8988,2021-05-07 09:00:00.000,2021-09-16 10:11:33.897
8797,1851,125518,합계,574,562,12,8987,2021-05-06 09:00:00.000,2021-09-16 10:11:33.897
8798,453,38974,서울,212,211,1,8986,2021-05-06 09:00:00.000,2021-09-16 10:11:33.897
8799,122,5194,부산,28,28,0,8985,2021-05-06 09:00:00.000,2021-09-16 10:11:33.897
8800,221,9408,대구,7,7,0,8984,2021-05-06 09:00:00.000,2021-09-16 10:11:33.897
8801,59,5758,인천,19,19,0,8983,2021-05-06 09:00:00.000,2021-09-16 10:11:33.897
8802,22,2453,광주,8,8,0,8982,2021-05-06 09:00:00.000,2021-09-16 10:11:33.897
8803,17,1806,대전,18,18,0,8981,2021-05-06 09:00:00.000,2021-09-16 10:11:33.897
8804,38,2093,울산,38,38,0,8980,2021-05-06 09:00:00.000,2021-09-16 10:11:33.897
8805,1,373,세종,1,1,0,8979,2021-05-06 09:00:00.000,2021-09-16 10:11:33.897
8806,597,35095,경기,142,142,0,8978,2021-05-06 09:00:00.000,2021-09-16 10:11:33.897
8807,50,2784,강원,12,12,0,8977,2021-05-06 09:00:00.000,2021-09-16 10:11:33.897
8808,64,2677,충북,6,6,0,8976,2021-05-06 09:00:00.000,2021-09-16 10:11:33.897
8809,36,3120,충남,15,13,2,8975,2021-05-06 09:00:00.000,2021-09-16 10:11:33.897
8810,58,1993,전북,5,5,0,8974,2021-05-06 09:00:00.000,2021-09-16 10:11:33.897
8811,11,1111,전남,10,10,0,8973,2021-05-06 09:00:00.000,2021-09-16 10:11:33.897
8812,78,4266,경북,22,21,1,8972,2021-05-06 09:00:00.000,2021-09-16 10:11:33.897
8813,19,4143,경남,17,17,0,8971,2021-05-06 09:00:00.000,2021-09-16 10:11:33.897
8814,1,743,제주,6,6,0,8970,2021-05-06 09:00:00.000,2021-09-16 10:11:33.897
8815,4,3527,검역,8,0,8,8969,2021-05-06 09:00:00.000,2021-09-16 10:11:33.897
8816,1847,124944,합계,676,12,26,8968,2021-05-05 09:00:00.000,2021-09-16 10:11:33.897
8817,452,38762,서울,238,1,4,8967,2021-05-05 09:00:00.000,2021-09-16 10:11:33.897
8818,122,5166,부산,23,0,1,8966,2021-05-05 09:00:00.000,2021-09-16 10:11:33.897
8819,221,9401,대구,6,0,0,8965,2021-05-05 09:00:00.000,2021-09-16 10:11:33.897
8820,59,5739,인천,16,0,0,8964,2021-05-05 09:00:00.000,2021-09-16 10:11:33.897
8821,22,2445,광주,8,0,0,8963,2021-05-05 09:00:00.000,2021-09-16 10:11:33.897
8822,17,1788,대전,18,0,0,8962,2021-05-05 09:00:00.000,2021-09-16 10:11:33.897
8823,38,2055,울산,22,0,1,8961,2021-05-05 09:00:00.000,2021-09-16 10:11:33.897
8824,1,372,세종,0,0,0,8960,2021-05-05 09:00:00.000,2021-09-16 10:11:33.897
8825,594,34953,경기,168,0,7,8959,2021-05-05 09:00:00.000,2021-09-16 10:11:33.897
8826,50,2772,강원,48,0,0,8958,2021-05-05 09:00:00.000,2021-09-16 10:11:33.897
8827,64,2671,충북,11,0,0,8957,2021-05-05 09:00:00.000,2021-09-16 10:11:33.897
8828,36,3105,충남,10,2,0,8956,2021-05-05 09:00:00.000,2021-09-16 10:11:33.897
8829,58,1988,전북,6,0,0,8955,2021-05-05 09:00:00.000,2021-09-16 10:11:33.897
8830,11,1101,전남,12,0,0,8954,2021-05-05 09:00:00.000,2021-09-16 10:11:33.897
8831,78,4244,경북,38,1,0,8953,2021-05-05 09:00:00.000,2021-09-16 10:11:33.897
8832,19,4126,경남,27,0,1,8952,2021-05-05 09:00:00.000,2021-09-16 10:11:33.897
8833,1,737,제주,13,0,0,8951,2021-05-05 09:00:00.000,2021-09-16 10:11:33.897
8834,4,3519,검역,12,8,12,8950,2021-05-05 09:00:00.000,2021-09-16 10:11:33.897
8835,1840,124268,합계,541,514,27,8949,2021-05-04 09:00:00.000,2021-09-16 10:11:33.897
8836,452,38524,서울,184,182,2,8948,2021-05-04 09:00:00.000,2021-09-16 10:11:33.897
8837,122,5143,부산,16,16,0,8947,2021-05-04 09:00:00.000,2021-09-16 10:11:33.897
8838,221,9395,대구,10,9,1,8946,2021-05-04 09:00:00.000,2021-09-16 10:11:33.897
8839,59,5723,인천,13,12,1,8945,2021-05-04 09:00:00.000,2021-09-16 10:11:33.897
8840,22,2437,광주,4,4,0,8944,2021-05-04 09:00:00.000,2021-09-16 10:11:33.897
8841,17,1770,대전,13,13,0,8943,2021-05-04 09:00:00.000,2021-09-16 10:11:33.897
8842,38,2033,울산,29,29,0,8942,2021-05-04 09:00:00.000,2021-09-16 10:11:33.897
8843,1,372,세종,6,5,1,8941,2021-05-04 09:00:00.000,2021-09-16 10:11:33.897
8844,589,34785,경기,124,117,7,8940,2021-05-04 09:00:00.000,2021-09-16 10:11:33.897
8845,50,2724,강원,22,22,0,8939,2021-05-04 09:00:00.000,2021-09-16 10:11:33.897
8846,64,2660,충북,7,5,2,8938,2021-05-04 09:00:00.000,2021-09-16 10:11:33.897
8847,36,3095,충남,19,18,1,8937,2021-05-04 09:00:00.000,2021-09-16 10:11:33.897
8848,58,1982,전북,12,12,0,8936,2021-05-04 09:00:00.000,2021-09-16 10:11:33.897
8849,10,1089,전남,9,9,0,8935,2021-05-04 09:00:00.000,2021-09-16 10:11:33.897
8850,78,4206,경북,22,18,4,8934,2021-05-04 09:00:00.000,2021-09-16 10:11:33.897
8851,18,4099,경남,36,35,1,8933,2021-05-04 09:00:00.000,2021-09-16 10:11:33.897
8852,1,724,제주,8,8,0,8932,2021-05-04 09:00:00.000,2021-09-16 10:11:33.897
8853,4,3507,검역,7,0,7,8931,2021-05-04 09:00:00.000,2021-09-16 10:11:33.897
8854,1834,123727,합계,488,465,23,8930,2021-05-03 09:00:00.000,2021-09-16 10:11:33.897
8855,451,38340,서울,127,123,4,8929,2021-05-03 09:00:00.000,2021-09-16 10:11:33.897
8856,122,5127,부산,16,16,0,8928,2021-05-03 09:00:00.000,2021-09-16 10:11:33.897
8857,221,9385,대구,12,10,2,8927,2021-05-03 09:00:00.000,2021-09-16 10:11:33.897
8858,59,5710,인천,15,14,1,8926,2021-05-03 09:00:00.000,2021-09-16 10:11:33.897
8859,22,2433,광주,5,5,0,8925,2021-05-03 09:00:00.000,2021-09-16 10:11:33.897
8860,17,1757,대전,5,5,0,8924,2021-05-03 09:00:00.000,2021-09-16 10:11:33.897
8861,38,2004,울산,21,21,0,8923,2021-05-03 09:00:00.000,2021-09-16 10:11:33.897
8862,1,366,세종,4,3,1,8922,2021-05-03 09:00:00.000,2021-09-16 10:11:33.897
8863,585,34661,경기,130,129,1,8921,2021-05-03 09:00:00.000,2021-09-16 10:11:33.897
8864,50,2702,강원,10,9,1,8920,2021-05-03 09:00:00.000,2021-09-16 10:11:33.897
8865,64,2653,충북,9,9,0,8919,2021-05-03 09:00:00.000,2021-09-16 10:11:33.897
8866,36,3076,충남,10,10,0,8918,2021-05-03 09:00:00.000,2021-09-16 10:11:33.897
8867,58,1970,전북,12,12,0,8917,2021-05-03 09:00:00.000,2021-09-16 10:11:33.897
8868,10,1080,전남,24,24,0,8916,2021-05-03 09:00:00.000,2021-09-16 10:11:33.897
8869,78,4184,경북,32,31,1,8915,2021-05-03 09:00:00.000,2021-09-16 10:11:33.897
8870,17,4063,경남,44,44,0,8914,2021-05-03 09:00:00.000,2021-09-16 10:11:33.897
8871,1,716,제주,1,0,1,8913,2021-05-03 09:00:00.000,2021-09-16 10:11:33.897
8872,4,3500,검역,11,0,11,8912,2021-05-03 09:00:00.000,2021-09-16 10:11:33.897
8873,1833,123239,합계,606,585,21,8911,2021-05-02 09:00:00.000,2021-09-16 10:11:33.897
8874,451,38213,서울,182,177,5,8910,2021-05-02 09:00:00.000,2021-09-16 10:11:33.897
8875,122,5111,부산,33,31,2,8909,2021-05-02 09:00:00.000,2021-09-16 10:11:33.897
8876,221,9373,대구,10,10,0,8908,2021-05-02 09:00:00.000,2021-09-16 10:11:33.897
8877,59,5695,인천,17,17,0,8907,2021-05-02 09:00:00.000,2021-09-16 10:11:33.897
8878,22,2428,광주,15,15,0,8906,2021-05-02 09:00:00.000,2021-09-16 10:11:33.897
8879,17,1752,대전,9,8,1,8905,2021-05-02 09:00:00.000,2021-09-16 10:11:33.897
8880,38,1983,울산,52,52,0,8904,2021-05-02 09:00:00.000,2021-09-16 10:11:33.897
8881,1,362,세종,1,1,0,8903,2021-05-02 09:00:00.000,2021-09-16 10:11:33.897
8882,584,34531,경기,145,140,5,8902,2021-05-02 09:00:00.000,2021-09-16 10:11:33.897
8883,50,2692,강원,4,4,0,8901,2021-05-02 09:00:00.000,2021-09-16 10:11:33.897
8884,64,2644,충북,11,10,1,8900,2021-05-02 09:00:00.000,2021-09-16 10:11:33.897
8885,36,3066,충남,16,16,0,8899,2021-05-02 09:00:00.000,2021-09-16 10:11:33.897
8886,58,1958,전북,12,12,0,8898,2021-05-02 09:00:00.000,2021-09-16 10:11:33.897
8887,10,1056,전남,1,1,0,8897,2021-05-02 09:00:00.000,2021-09-16 10:11:33.897
8888,78,4152,경북,30,30,0,8896,2021-05-02 09:00:00.000,2021-09-16 10:11:33.897
8889,17,4019,경남,61,61,0,8895,2021-05-02 09:00:00.000,2021-09-16 10:11:33.897
8890,1,715,제주,1,0,1,8894,2021-05-02 09:00:00.000,2021-09-16 10:11:33.897
8891,4,3489,검역,6,0,6,8893,2021-05-02 09:00:00.000,2021-09-16 10:11:33.897
8892,1831,122633,합계,627,593,34,8892,2021-05-01 09:00:00.000,2021-09-16 10:11:33.897
8893,450,38031,서울,195,187,8,8891,2021-05-01 09:00:00.000,2021-09-16 10:11:33.897
8894,122,5078,부산,29,28,1,8890,2021-05-01 09:00:00.000,2021-09-16 10:11:33.897
8895,221,9363,대구,12,12,0,8889,2021-05-01 09:00:00.000,2021-09-16 10:11:33.897
8896,59,5678,인천,13,13,0,8888,2021-05-01 09:00:00.000,2021-09-16 10:11:33.897
8897,22,2413,광주,4,4,0,8887,2021-05-01 09:00:00.000,2021-09-16 10:11:33.897
8898,17,1743,대전,13,12,1,8886,2021-05-01 09:00:00.000,2021-09-16 10:11:33.897
8899,38,1931,울산,52,52,0,8885,2021-05-01 09:00:00.000,2021-09-16 10:11:33.897
8900,1,361,세종,4,4,0,8884,2021-05-01 09:00:00.000,2021-09-16 10:11:33.897
8901,583,34386,경기,190,187,3,8883,2021-05-01 09:00:00.000,2021-09-16 10:11:33.897
8902,50,2688,강원,4,4,0,8882,2021-05-01 09:00:00.000,2021-09-16 10:11:33.897
8903,64,2633,충북,5,4,1,8881,2021-05-01 09:00:00.000,2021-09-16 10:11:33.897
8904,36,3050,충남,17,16,1,8880,2021-05-01 09:00:00.000,2021-09-16 10:11:33.897
8905,58,1946,전북,10,9,1,8879,2021-05-01 09:00:00.000,2021-09-16 10:11:33.897
8906,10,1055,전남,2,2,0,8878,2021-05-01 09:00:00.000,2021-09-16 10:11:33.897
8907,78,4122,경북,12,11,1,8877,2021-05-01 09:00:00.000,2021-09-16 10:11:33.897
8908,17,3958,경남,43,41,2,8876,2021-05-01 09:00:00.000,2021-09-16 10:11:33.897
8909,1,714,제주,7,7,0,8875,2021-05-01 09:00:00.000,2021-09-16 10:11:33.897
8910,4,3483,검역,15,0,15,8874,2021-05-01 09:00:00.000,2021-09-16 10:11:33.897
8911,1828,122006,합계,661,642,19,8873,2021-04-30 09:00:00.000,2021-09-16 10:11:33.897
8912,448,37836,서울,227,222,5,8872,2021-04-30 09:00:00.000,2021-09-16 10:11:33.897
8913,122,5049,부산,32,31,1,8871,2021-04-30 09:00:00.000,2021-09-16 10:11:33.897
8914,221,9351,대구,14,13,1,8870,2021-04-30 09:00:00.000,2021-09-16 10:11:33.897
8915,59,5665,인천,14,14,0,8869,2021-04-30 09:00:00.000,2021-09-16 10:11:33.897
8916,22,2409,광주,4,4,0,8868,2021-04-30 09:00:00.000,2021-09-16 10:11:33.897
8917,17,1730,대전,31,30,1,8867,2021-04-30 09:00:00.000,2021-09-16 10:11:33.897
8918,38,1879,울산,61,61,0,8866,2021-04-30 09:00:00.000,2021-09-16 10:11:33.897
8919,1,357,세종,1,1,0,8865,2021-04-30 09:00:00.000,2021-09-16 10:11:33.897
8920,582,34196,경기,151,148,3,8864,2021-04-30 09:00:00.000,2021-09-16 10:11:33.897
8921,50,2684,강원,4,4,0,8863,2021-04-30 09:00:00.000,2021-09-16 10:11:33.897
8922,64,2628,충북,12,11,1,8862,2021-04-30 09:00:00.000,2021-09-16 10:11:33.897
8923,36,3033,충남,12,12,0,8861,2021-04-30 09:00:00.000,2021-09-16 10:11:33.897
8924,58,1936,전북,21,21,0,8860,2021-04-30 09:00:00.000,2021-09-16 10:11:33.897
8925,10,1053,전남,5,5,0,8859,2021-04-30 09:00:00.000,2021-09-16 10:11:33.897
8926,78,4110,경북,29,28,1,8858,2021-04-30 09:00:00.000,2021-09-16 10:11:33.897
8927,17,3915,경남,37,37,0,8857,2021-04-30 09:00:00.000,2021-09-16 10:11:33.897
8928,1,707,제주,1,0,1,8856,2021-04-30 09:00:00.000,2021-09-16 10:11:33.897
8929,4,3468,검역,5,0,5,8855,2021-04-30 09:00:00.000,2021-09-16 10:11:33.897
8930,1825,121345,합계,679,648,31,8854,2021-04-29 09:00:00.000,2021-09-16 10:11:33.897
8931,447,37609,서울,227,225,2,8853,2021-04-29 09:00:00.000,2021-09-16 10:11:33.897
8932,122,5017,부산,40,39,1,8852,2021-04-29 09:00:00.000,2021-09-16 10:11:33.897
8933,220,9337,대구,19,18,1,8851,2021-04-29 09:00:00.000,2021-09-16 10:11:33.897
8934,59,5651,인천,25,22,3,8850,2021-04-29 09:00:00.000,2021-09-16 10:11:33.897
8935,22,2405,광주,8,8,0,8849,2021-04-29 09:00:00.000,2021-09-16 10:11:33.897
8936,17,1699,대전,4,4,0,8848,2021-04-29 09:00:00.000,2021-09-16 10:11:33.897
8937,38,1818,울산,46,46,0,8847,2021-04-29 09:00:00.000,2021-09-16 10:11:33.897
8938,1,356,세종,0,0,0,8846,2021-04-29 09:00:00.000,2021-09-16 10:11:33.897
8939,581,34045,경기,182,175,7,8845,2021-04-29 09:00:00.000,2021-09-16 10:11:33.897
8940,50,2680,강원,13,12,1,8844,2021-04-29 09:00:00.000,2021-09-16 10:11:33.897
8941,64,2616,충북,10,10,0,8843,2021-04-29 09:00:00.000,2021-09-16 10:11:33.897
8942,36,3021,충남,16,15,1,8842,2021-04-29 09:00:00.000,2021-09-16 10:11:33.897
8943,58,1915,전북,9,9,0,8841,2021-04-29 09:00:00.000,2021-09-16 10:11:33.897
8944,10,1048,전남,2,0,2,8840,2021-04-29 09:00:00.000,2021-09-16 10:11:33.897
8945,78,4081,경북,28,26,2,8839,2021-04-29 09:00:00.000,2021-09-16 10:11:33.897
8946,17,3878,경남,38,38,0,8838,2021-04-29 09:00:00.000,2021-09-16 10:11:33.897
8947,1,706,제주,1,1,0,8837,2021-04-29 09:00:00.000,2021-09-16 10:11:33.897
8948,4,3463,검역,11,0,11,8836,2021-04-29 09:00:00.000,2021-09-16 10:11:33.897
8949,1821,120666,합계,769,748,21,8835,2021-04-28 09:00:00.000,2021-09-16 10:11:33.897
8950,445,37382,서울,257,255,2,8834,2021-04-28 09:00:00.000,2021-09-16 10:11:33.897
8951,122,4977,부산,33,32,1,8833,2021-04-28 09:00:00.000,2021-09-16 10:11:33.897
8952,220,9318,대구,29,27,2,8832,2021-04-28 09:00:00.000,2021-09-16 10:11:33.897
8953,59,5626,인천,20,19,1,8831,2021-04-28 09:00:00.000,2021-09-16 10:11:33.897
8954,22,2397,광주,12,11,1,8830,2021-04-28 09:00:00.000,2021-09-16 10:11:33.897
8955,17,1695,대전,10,10,0,8829,2021-04-28 09:00:00.000,2021-09-16 10:11:33.897
8956,38,1772,울산,33,33,0,8828,2021-04-28 09:00:00.000,2021-09-16 10:11:33.897
8957,1,356,세종,2,2,0,8827,2021-04-28 09:00:00.000,2021-09-16 10:11:33.897
8958,579,33863,경기,194,189,5,8826,2021-04-28 09:00:00.000,2021-09-16 10:11:33.897
8959,50,2667,강원,11,11,0,8825,2021-04-28 09:00:00.000,2021-09-16 10:11:33.897
8960,64,2606,충북,22,22,0,8824,2021-04-28 09:00:00.000,2021-09-16 10:11:33.897
8961,36,3005,충남,38,38,0,8823,2021-04-28 09:00:00.000,2021-09-16 10:11:33.897
8962,58,1906,전북,13,13,0,8822,2021-04-28 09:00:00.000,2021-09-16 10:11:33.897
8963,10,1046,전남,5,5,0,8821,2021-04-28 09:00:00.000,2021-09-16 10:11:33.897
8964,78,4053,경북,25,23,2,8820,2021-04-28 09:00:00.000,2021-09-16 10:11:33.897
8965,17,3840,경남,55,55,0,8819,2021-04-28 09:00:00.000,2021-09-16 10:11:33.897
8966,1,705,제주,3,3,0,8818,2021-04-28 09:00:00.000,2021-09-16 10:11:33.897
8967,4,3452,검역,7,0,7,8817,2021-04-28 09:00:00.000,2021-09-16 10:11:33.897
8968,1820,119897,합계,512,477,35,8816,2021-04-27 09:00:00.000,2021-09-16 10:11:33.897
8969,445,37125,서울,116,116,0,8815,2021-04-27 09:00:00.000,2021-09-16 10:11:33.897
8970,122,4944,부산,30,30,0,8814,2021-04-27 09:00:00.000,2021-09-16 10:11:33.897
8971,220,9289,대구,12,9,3,8813,2021-04-27 09:00:00.000,2021-09-16 10:11:33.897
8972,59,5606,인천,14,14,0,8812,2021-04-27 09:00:00.000,2021-09-16 10:11:33.897
8973,22,2385,광주,6,6,0,8811,2021-04-27 09:00:00.000,2021-09-16 10:11:33.897
8974,17,1685,대전,8,8,0,8810,2021-04-27 09:00:00.000,2021-09-16 10:11:33.897
8975,38,1739,울산,18,18,0,8809,2021-04-27 09:00:00.000,2021-09-16 10:11:33.897
8976,1,354,세종,2,2,0,8808,2021-04-27 09:00:00.000,2021-09-16 10:11:33.897
8977,578,33669,경기,195,191,4,8807,2021-04-27 09:00:00.000,2021-09-16 10:11:33.897
8978,50,2656,강원,2,2,0,8806,2021-04-27 09:00:00.000,2021-09-16 10:11:33.897
8979,64,2584,충북,10,9,1,8805,2021-04-27 09:00:00.000,2021-09-16 10:11:33.897
8980,36,2967,충남,14,14,0,8804,2021-04-27 09:00:00.000,2021-09-16 10:11:33.897
8981,58,1893,전북,5,4,1,8803,2021-04-27 09:00:00.000,2021-09-16 10:11:33.897
8982,10,1041,전남,2,2,0,8802,2021-04-27 09:00:00.000,2021-09-16 10:11:33.897
8983,78,4028,경북,22,20,2,8801,2021-04-27 09:00:00.000,2021-09-16 10:11:33.897
8984,17,3785,경남,28,27,1,8800,2021-04-27 09:00:00.000,2021-09-16 10:11:33.897
8985,1,702,제주,5,5,0,8799,2021-04-27 09:00:00.000,2021-09-16 10:11:33.897
8986,4,3445,검역,23,0,23,8798,2021-04-27 09:00:00.000,2021-09-16 10:11:33.897
8987,1817,119385,합계,499,469,30,8797,2021-04-26 09:00:00.000,2021-09-16 10:11:33.897
8988,445,37009,서울,154,152,2,8796,2021-04-26 09:00:00.000,2021-09-16 10:11:33.897
8989,121,4914,부산,25,23,2,8795,2021-04-26 09:00:00.000,2021-09-16 10:11:33.897
8990,220,9277,대구,7,7,0,8794,2021-04-26 09:00:00.000,2021-09-16 10:11:33.897
8991,59,5592,인천,14,13,1,8793,2021-04-26 09:00:00.000,2021-09-16 10:11:33.897
8992,21,2379,광주,15,15,0,8792,2021-04-26 09:00:00.000,2021-09-16 10:11:33.897
8993,17,1677,대전,4,4,0,8791,2021-04-26 09:00:00.000,2021-09-16 10:11:33.897
8994,38,1721,울산,13,13,0,8790,2021-04-26 09:00:00.000,2021-09-16 10:11:33.897
8995,1,352,세종,1,1,0,8789,2021-04-26 09:00:00.000,2021-09-16 10:11:33.897
8996,577,33474,경기,150,147,3,8788,2021-04-26 09:00:00.000,2021-09-16 10:11:33.897
8997,50,2654,강원,12,12,0,8787,2021-04-26 09:00:00.000,2021-09-16 10:11:33.897
8998,64,2574,충북,16,16,0,8786,2021-04-26 09:00:00.000,2021-09-16 10:11:33.897
8999,36,2953,충남,7,7,0,8785,2021-04-26 09:00:00.000,2021-09-16 10:11:33.897
9000,58,1888,전북,6,5,1,8784,2021-04-26 09:00:00.000,2021-09-16 10:11:33.897
9001,10,1039,전남,0,0,0,8783,2021-04-26 09:00:00.000,2021-09-16 10:11:33.897
9002,78,4006,경북,25,24,1,8782,2021-04-26 09:00:00.000,2021-09-16 10:11:33.897
9003,17,3757,경남,29,29,0,8781,2021-04-26 09:00:00.000,2021-09-16 10:11:33.897
9004,1,697,제주,1,1,0,8780,2021-04-26 09:00:00.000,2021-09-16 10:11:33.897
9005,4,3422,검역,20,0,20,8779,2021-04-26 09:00:00.000,2021-09-16 10:11:33.897
9006,1813,118886,합계,644,603,41,8778,2021-04-25 09:00:00.000,2021-09-16 10:11:33.897
9007,444,36855,서울,175,172,3,8777,2021-04-25 09:00:00.000,2021-09-16 10:11:33.897
9008,121,4889,부산,43,43,0,8776,2021-04-25 09:00:00.000,2021-09-16 10:11:33.897
9009,219,9270,대구,14,13,1,8775,2021-04-25 09:00:00.000,2021-09-16 10:11:33.897
9010,59,5578,인천,15,15,0,8774,2021-04-25 09:00:00.000,2021-09-16 10:11:33.897
9011,21,2364,광주,8,8,0,8773,2021-04-25 09:00:00.000,2021-09-16 10:11:33.897
9012,17,1673,대전,6,6,0,8772,2021-04-25 09:00:00.000,2021-09-16 10:11:33.897
9013,38,1708,울산,43,43,0,8771,2021-04-25 09:00:00.000,2021-09-16 10:11:33.897
9014,1,351,세종,0,0,0,8770,2021-04-25 09:00:00.000,2021-09-16 10:11:33.897
9015,575,33324,경기,191,187,4,8769,2021-04-25 09:00:00.000,2021-09-16 10:11:33.897
9016,50,2642,강원,10,9,1,8768,2021-04-25 09:00:00.000,2021-09-16 10:11:33.897
9017,64,2558,충북,15,15,0,8767,2021-04-25 09:00:00.000,2021-09-16 10:11:33.897
9018,36,2946,충남,6,6,0,8766,2021-04-25 09:00:00.000,2021-09-16 10:11:33.897
9019,58,1882,전북,7,7,0,8765,2021-04-25 09:00:00.000,2021-09-16 10:11:33.897
9020,10,1039,전남,9,9,0,8764,2021-04-25 09:00:00.000,2021-09-16 10:11:33.897
9021,78,3981,경북,24,23,1,8763,2021-04-25 09:00:00.000,2021-09-16 10:11:33.897
9022,17,3728,경남,45,44,1,8762,2021-04-25 09:00:00.000,2021-09-16 10:11:33.897
9023,1,696,제주,3,3,0,8761,2021-04-25 09:00:00.000,2021-09-16 10:11:33.897
9024,4,3402,검역,30,0,30,8760,2021-04-25 09:00:00.000,2021-09-16 10:11:33.897
9025,1812,118242,합계,785,759,26,8759,2021-04-24 09:00:00.000,2021-09-16 10:11:33.897
9026,444,36680,서울,253,251,2,8758,2021-04-24 09:00:00.000,2021-09-16 10:11:33.897
9027,121,4846,부산,44,44,0,8757,2021-04-24 09:00:00.000,2021-09-16 10:11:33.897
9028,219,9256,대구,4,4,0,8756,2021-04-24 09:00:00.000,2021-09-16 10:11:33.897
9029,59,5563,인천,18,17,1,8755,2021-04-24 09:00:00.000,2021-09-16 10:11:33.897
9030,21,2356,광주,15,15,0,8754,2021-04-24 09:00:00.000,2021-09-16 10:11:33.897
9031,17,1667,대전,10,10,0,8753,2021-04-24 09:00:00.000,2021-09-16 10:11:33.897
9032,38,1665,울산,50,50,0,8752,2021-04-24 09:00:00.000,2021-09-16 10:11:33.897
9033,1,351,세종,1,1,0,8751,2021-04-24 09:00:00.000,2021-09-16 10:11:33.897
9034,575,33133,경기,244,240,4,8750,2021-04-24 09:00:00.000,2021-09-16 10:11:33.897
9035,50,2632,강원,9,9,0,8749,2021-04-24 09:00:00.000,2021-09-16 10:11:33.897
9036,64,2543,충북,15,13,2,8748,2021-04-24 09:00:00.000,2021-09-16 10:11:33.897
9037,36,2940,충남,14,13,1,8747,2021-04-24 09:00:00.000,2021-09-16 10:11:33.897
9038,58,1875,전북,9,6,3,8746,2021-04-24 09:00:00.000,2021-09-16 10:11:33.897
9039,10,1030,전남,1,1,0,8745,2021-04-24 09:00:00.000,2021-09-16 10:11:33.897
9040,77,3957,경북,32,30,2,8744,2021-04-24 09:00:00.000,2021-09-16 10:11:33.897
9041,17,3683,경남,52,52,0,8743,2021-04-24 09:00:00.000,2021-09-16 10:11:33.897
9042,1,693,제주,3,3,0,8742,2021-04-24 09:00:00.000,2021-09-16 10:11:33.897
9043,4,3372,검역,11,0,11,8741,2021-04-24 09:00:00.000,2021-09-16 10:11:33.897
9044,1811,117457,합계,797,758,39,8740,2021-04-23 09:00:00.000,2021-09-16 10:11:33.897
9045,444,36427,서울,204,198,6,8739,2021-04-23 09:00:00.000,2021-09-16 10:11:33.897
9046,121,4802,부산,33,33,0,8738,2021-04-23 09:00:00.000,2021-09-16 10:11:33.897
9047,219,9252,대구,12,12,0,8737,2021-04-23 09:00:00.000,2021-09-16 10:11:33.897
9048,59,5545,인천,10,10,0,8736,2021-04-23 09:00:00.000,2021-09-16 10:11:33.897
9049,21,2341,광주,16,16,0,8735,2021-04-23 09:00:00.000,2021-09-16 10:11:33.897
9050,17,1657,대전,2,2,0,8734,2021-04-23 09:00:00.000,2021-09-16 10:11:33.897
9051,37,1615,울산,38,38,0,8733,2021-04-23 09:00:00.000,2021-09-16 10:11:33.897
9052,1,350,세종,3,3,0,8732,2021-04-23 09:00:00.000,2021-09-16 10:11:33.897
9053,575,32889,경기,298,290,8,8731,2021-04-23 09:00:00.000,2021-09-16 10:11:33.897
9054,50,2623,강원,15,15,0,8730,2021-04-23 09:00:00.000,2021-09-16 10:11:33.897
9055,64,2528,충북,30,29,1,8729,2021-04-23 09:00:00.000,2021-09-16 10:11:33.897
9056,36,2926,충남,10,10,0,8728,2021-04-23 09:00:00.000,2021-09-16 10:11:33.897
9057,58,1866,전북,9,8,1,8727,2021-04-23 09:00:00.000,2021-09-16 10:11:33.897
9058,10,1029,전남,6,6,0,8726,2021-04-23 09:00:00.000,2021-09-16 10:11:33.897
9059,77,3925,경북,22,22,0,8725,2021-04-23 09:00:00.000,2021-09-16 10:11:33.897
9060,17,3631,경남,63,63,0,8724,2021-04-23 09:00:00.000,2021-09-16 10:11:33.897
9061,1,690,제주,3,3,0,8723,2021-04-23 09:00:00.000,2021-09-16 10:11:33.897
9062,4,3361,검역,23,0,23,8722,2021-04-23 09:00:00.000,2021-09-16 10:11:33.897
9063,1808,116660,합계,735,715,20,8721,2021-04-22 09:00:00.000,2021-09-16 10:11:33.897
9064,443,36223,서울,230,229,1,8720,2021-04-22 09:00:00.000,2021-09-16 10:11:33.897
9065,121,4769,부산,37,35,2,8719,2021-04-22 09:00:00.000,2021-09-16 10:11:33.897
9066,219,9240,대구,24,24,0,8718,2021-04-22 09:00:00.000,2021-09-16 10:11:33.897
9067,59,5535,인천,14,11,3,8717,2021-04-22 09:00:00.000,2021-09-16 10:11:33.897
9068,21,2325,광주,9,9,0,8716,2021-04-22 09:00:00.000,2021-09-16 10:11:33.897
9069,16,1655,대전,13,13,0,8715,2021-04-22 09:00:00.000,2021-09-16 10:11:33.897
9070,37,1577,울산,32,32,0,8714,2021-04-22 09:00:00.000,2021-09-16 10:11:33.897
9071,1,347,세종,1,1,0,8713,2021-04-22 09:00:00.000,2021-09-16 10:11:33.897
9072,574,32591,경기,222,217,5,8712,2021-04-22 09:00:00.000,2021-09-16 10:11:33.897
9073,50,2608,강원,24,23,1,8711,2021-04-22 09:00:00.000,2021-09-16 10:11:33.897
9074,64,2498,충북,19,19,0,8710,2021-04-22 09:00:00.000,2021-09-16 10:11:33.897
9075,36,2916,충남,6,4,2,8709,2021-04-22 09:00:00.000,2021-09-16 10:11:33.897
9076,58,1857,전북,6,6,0,8708,2021-04-22 09:00:00.000,2021-09-16 10:11:33.897
9077,10,1023,전남,8,7,1,8707,2021-04-22 09:00:00.000,2021-09-16 10:11:33.897
9078,77,3903,경북,23,23,0,8706,2021-04-22 09:00:00.000,2021-09-16 10:11:33.897
9079,17,3568,경남,58,58,0,8705,2021-04-22 09:00:00.000,2021-09-16 10:11:33.897
9080,1,687,제주,4,4,0,8704,2021-04-22 09:00:00.000,2021-09-16 10:11:33.897
9081,4,3338,검역,5,0,5,8703,2021-04-22 09:00:00.000,2021-09-16 10:11:33.897
9082,1806,115925,합계,731,692,39,8702,2021-04-21 09:00:00.000,2021-09-16 10:11:33.897
9083,443,35993,서울,218,211,7,8701,2021-04-21 09:00:00.000,2021-09-16 10:11:33.897
9084,121,4732,부산,33,33,0,8700,2021-04-21 09:00:00.000,2021-09-16 10:11:33.897
9085,219,9216,대구,25,25,0,8699,2021-04-21 09:00:00.000,2021-09-16 10:11:33.897
9086,58,5521,인천,15,13,2,8698,2021-04-21 09:00:00.000,2021-09-16 10:11:33.897
9087,21,2316,광주,17,17,0,8697,2021-04-21 09:00:00.000,2021-09-16 10:11:33.897
9088,16,1642,대전,17,17,0,8696,2021-04-21 09:00:00.000,2021-09-16 10:11:33.897
9089,37,1545,울산,39,39,0,8695,2021-04-21 09:00:00.000,2021-09-16 10:11:33.897
9090,1,346,세종,1,1,0,8694,2021-04-21 09:00:00.000,2021-09-16 10:11:33.897
9091,573,32369,경기,234,225,9,8693,2021-04-21 09:00:00.000,2021-09-16 10:11:33.897
9092,50,2584,강원,15,14,1,8692,2021-04-21 09:00:00.000,2021-09-16 10:11:33.897
9093,64,2479,충북,20,19,1,8691,2021-04-21 09:00:00.000,2021-09-16 10:11:33.897
9094,36,2910,충남,8,7,1,8690,2021-04-21 09:00:00.000,2021-09-16 10:11:33.897
9095,58,1851,전북,8,8,0,8689,2021-04-21 09:00:00.000,2021-09-16 10:11:33.897
9096,10,1015,전남,4,2,2,8688,2021-04-21 09:00:00.000,2021-09-16 10:11:33.897
9097,77,3880,경북,16,15,1,8687,2021-04-21 09:00:00.000,2021-09-16 10:11:33.897
9098,17,3510,경남,41,40,1,8686,2021-04-21 09:00:00.000,2021-09-16 10:11:33.897
9099,1,683,제주,7,6,1,8685,2021-04-21 09:00:00.000,2021-09-16 10:11:33.897
9100,4,3333,검역,13,0,13,8684,2021-04-21 09:00:00.000,2021-09-16 10:11:33.897
9101,1802,115194,합계,549,529,20,8683,2021-04-20 09:00:00.000,2021-09-16 10:11:33.897
9102,443,35775,서울,148,147,1,8682,2021-04-20 09:00:00.000,2021-09-16 10:11:33.897
9103,121,4699,부산,29,29,0,8681,2021-04-20 09:00:00.000,2021-09-16 10:11:33.897
9104,219,9191,대구,15,12,3,8680,2021-04-20 09:00:00.000,2021-09-16 10:11:33.897
9105,58,5506,인천,18,18,0,8679,2021-04-20 09:00:00.000,2021-09-16 10:11:33.897
9106,21,2299,광주,4,4,0,8678,2021-04-20 09:00:00.000,2021-09-16 10:11:33.897
9107,16,1625,대전,8,8,0,8677,2021-04-20 09:00:00.000,2021-09-16 10:11:33.897
9108,37,1506,울산,21,21,0,8676,2021-04-20 09:00:00.000,2021-09-16 10:11:33.897
9109,1,345,세종,1,1,0,8675,2021-04-20 09:00:00.000,2021-09-16 10:11:33.897
9110,571,32135,경기,189,184,5,8674,2021-04-20 09:00:00.000,2021-09-16 10:11:33.897
9111,50,2569,강원,18,18,0,8673,2021-04-20 09:00:00.000,2021-09-16 10:11:33.897
9112,63,2459,충북,14,14,0,8672,2021-04-20 09:00:00.000,2021-09-16 10:11:33.897
9113,36,2902,충남,16,16,0,8671,2021-04-20 09:00:00.000,2021-09-16 10:11:33.897
9114,57,1843,전북,3,3,0,8670,2021-04-20 09:00:00.000,2021-09-16 10:11:33.897
9115,10,1011,전남,4,4,0,8669,2021-04-20 09:00:00.000,2021-09-16 10:11:33.897
9116,77,3864,경북,21,20,1,8668,2021-04-20 09:00:00.000,2021-09-16 10:11:33.897
9117,17,3469,경남,29,29,0,8667,2021-04-20 09:00:00.000,2021-09-16 10:11:33.897
9118,1,676,제주,1,1,0,8666,2021-04-20 09:00:00.000,2021-09-16 10:11:33.897
9119,4,3320,검역,10,0,10,8665,2021-04-20 09:00:00.000,2021-09-16 10:11:33.897
9120,1801,114645,합계,532,512,20,8664,2021-04-19 09:00:00.000,2021-09-16 10:11:33.897
9121,443,35627,서울,137,136,1,8663,2021-04-19 09:00:00.000,2021-09-16 10:11:33.897
9122,121,4670,부산,26,25,1,8662,2021-04-19 09:00:00.000,2021-09-16 10:11:33.897
9123,219,9176,대구,24,23,1,8661,2021-04-19 09:00:00.000,2021-09-16 10:11:33.897
9124,58,5488,인천,11,10,1,8660,2021-04-19 09:00:00.000,2021-09-16 10:11:33.897
9125,21,2295,광주,11,11,0,8659,2021-04-19 09:00:00.000,2021-09-16 10:11:33.897
9126,16,1617,대전,21,21,0,8658,2021-04-19 09:00:00.000,2021-09-16 10:11:33.897
9127,37,1485,울산,28,28,0,8657,2021-04-19 09:00:00.000,2021-09-16 10:11:33.897
9128,1,344,세종,1,1,0,8656,2021-04-19 09:00:00.000,2021-09-16 10:11:33.897
9129,570,31946,경기,146,142,4,8655,2021-04-19 09:00:00.000,2021-09-16 10:11:33.897
9130,50,2551,강원,21,21,0,8654,2021-04-19 09:00:00.000,2021-09-16 10:11:33.897
9131,63,2445,충북,10,9,1,8653,2021-04-19 09:00:00.000,2021-09-16 10:11:33.897
9132,36,2886,충남,13,13,0,8652,2021-04-19 09:00:00.000,2021-09-16 10:11:33.897
9133,57,1840,전북,16,16,0,8651,2021-04-19 09:00:00.000,2021-09-16 10:11:33.897
9134,10,1007,전남,3,2,1,8650,2021-04-19 09:00:00.000,2021-09-16 10:11:33.897
9135,77,3843,경북,19,17,2,8649,2021-04-19 09:00:00.000,2021-09-16 10:11:33.897
9136,17,3440,경남,35,35,0,8648,2021-04-19 09:00:00.000,2021-09-16 10:11:33.897
9137,1,675,제주,2,2,0,8647,2021-04-19 09:00:00.000,2021-09-16 10:11:33.897
9138,4,3310,검역,8,0,8,8646,2021-04-19 09:00:00.000,2021-09-16 10:11:33.897
9139,1797,114113,합계,671,648,23,8645,2021-04-18 09:00:00.000,2021-09-16 10:11:33.897
9140,443,35490,서울,204,201,3,8644,2021-04-18 09:00:00.000,2021-09-16 10:11:33.897
9141,121,4644,부산,31,30,1,8643,2021-04-18 09:00:00.000,2021-09-16 10:11:33.897
9142,219,9152,대구,13,13,0,8642,2021-04-18 09:00:00.000,2021-09-16 10:11:33.897
9143,58,5477,인천,19,19,0,8641,2021-04-18 09:00:00.000,2021-09-16 10:11:33.897
9144,21,2284,광주,13,12,1,8640,2021-04-18 09:00:00.000,2021-09-16 10:11:33.897
9145,16,1596,대전,5,5,0,8639,2021-04-18 09:00:00.000,2021-09-16 10:11:33.897
9146,37,1457,울산,21,20,1,8638,2021-04-18 09:00:00.000,2021-09-16 10:11:33.897
9147,1,343,세종,2,2,0,8637,2021-04-18 09:00:00.000,2021-09-16 10:11:33.897
9148,567,31800,경기,184,181,3,8636,2021-04-18 09:00:00.000,2021-09-16 10:11:33.897
9149,50,2530,강원,19,19,0,8635,2021-04-18 09:00:00.000,2021-09-16 10:11:33.897
9150,62,2435,충북,10,10,0,8634,2021-04-18 09:00:00.000,2021-09-16 10:11:33.897
9151,36,2873,충남,22,19,3,8633,2021-04-18 09:00:00.000,2021-09-16 10:11:33.897
9152,57,1824,전북,21,21,0,8632,2021-04-18 09:00:00.000,2021-09-16 10:11:33.897
9153,10,1004,전남,2,2,0,8631,2021-04-18 09:00:00.000,2021-09-16 10:11:33.897
9154,77,3824,경북,28,26,2,8630,2021-04-18 09:00:00.000,2021-09-16 10:11:33.897
9155,17,3405,경남,67,67,0,8629,2021-04-18 09:00:00.000,2021-09-16 10:11:33.897
9156,1,673,제주,1,1,0,8628,2021-04-18 09:00:00.000,2021-09-16 10:11:33.897
9157,4,3302,검역,9,0,9,8627,2021-04-18 09:00:00.000,2021-09-16 10:11:33.897
9158,1794,113442,합계,658,630,28,8626,2021-04-17 09:00:00.000,2021-09-16 10:11:33.897
9159,443,35286,서울,217,213,4,8625,2021-04-17 09:00:00.000,2021-09-16 10:11:33.897
9160,121,4613,부산,35,33,2,8624,2021-04-17 09:00:00.000,2021-09-16 10:11:33.897
9161,219,9139,대구,12,10,2,8623,2021-04-17 09:00:00.000,2021-09-16 10:11:33.897
9162,58,5458,인천,23,23,0,8622,2021-04-17 09:00:00.000,2021-09-16 10:11:33.897
9163,21,2271,광주,4,4,0,8621,2021-04-17 09:00:00.000,2021-09-16 10:11:33.897
9164,16,1591,대전,4,4,0,8620,2021-04-17 09:00:00.000,2021-09-16 10:11:33.897
9165,37,1436,울산,26,25,1,8619,2021-04-17 09:00:00.000,2021-09-16 10:11:33.897
9166,1,341,세종,0,0,0,8618,2021-04-17 09:00:00.000,2021-09-16 10:11:33.897
9167,565,31616,경기,209,204,5,8617,2021-04-17 09:00:00.000,2021-09-16 10:11:33.897
9168,50,2511,강원,12,11,1,8616,2021-04-17 09:00:00.000,2021-09-16 10:11:33.897
9169,61,2425,충북,12,11,1,8615,2021-04-17 09:00:00.000,2021-09-16 10:11:33.897
9170,36,2851,충남,7,6,1,8614,2021-04-17 09:00:00.000,2021-09-16 10:11:33.897
9171,57,1803,전북,16,15,1,8613,2021-04-17 09:00:00.000,2021-09-16 10:11:33.897
9172,10,1002,전남,6,6,0,8612,2021-04-17 09:00:00.000,2021-09-16 10:11:33.897
9173,77,3796,경북,29,28,1,8611,2021-04-17 09:00:00.000,2021-09-16 10:11:33.897
9174,17,3338,경남,38,36,2,8610,2021-04-17 09:00:00.000,2021-09-16 10:11:33.897
9175,1,672,제주,1,1,0,8609,2021-04-17 09:00:00.000,2021-09-16 10:11:33.897
9176,4,3293,검역,7,0,7,8608,2021-04-17 09:00:00.000,2021-09-16 10:11:33.897
9177,1790,112784,합계,673,652,21,8607,2021-04-16 09:00:00.000,2021-09-16 10:11:33.897
9178,442,35069,서울,216,215,1,8606,2021-04-16 09:00:00.000,2021-09-16 10:11:33.897
9179,120,4578,부산,44,44,0,8605,2021-04-16 09:00:00.000,2021-09-16 10:11:33.897
9180,219,9127,대구,4,4,0,8604,2021-04-16 09:00:00.000,2021-09-16 10:11:33.897
9181,58,5435,인천,12,11,1,8603,2021-04-16 09:00:00.000,2021-09-16 10:11:33.897
9182,21,2267,광주,11,10,1,8602,2021-04-16 09:00:00.000,2021-09-16 10:11:33.897
9183,16,1587,대전,6,6,0,8601,2021-04-16 09:00:00.000,2021-09-16 10:11:33.897
9184,37,1410,울산,24,24,0,8600,2021-04-16 09:00:00.000,2021-09-16 10:11:33.897
9185,1,341,세종,3,3,0,8599,2021-04-16 09:00:00.000,2021-09-16 10:11:33.897
9186,563,31407,경기,221,216,5,8598,2021-04-16 09:00:00.000,2021-09-16 10:11:33.897
9187,50,2499,강원,7,7,0,8597,2021-04-16 09:00:00.000,2021-09-16 10:11:33.897
9188,61,2413,충북,9,9,0,8596,2021-04-16 09:00:00.000,2021-09-16 10:11:33.897
9189,36,2844,충남,13,12,1,8595,2021-04-16 09:00:00.000,2021-09-16 10:11:33.897
9190,57,1787,전북,15,15,0,8594,2021-04-16 09:00:00.000,2021-09-16 10:11:33.897
9191,10,996,전남,6,6,0,8593,2021-04-16 09:00:00.000,2021-09-16 10:11:33.897
9192,77,3767,경북,24,23,1,8592,2021-04-16 09:00:00.000,2021-09-16 10:11:33.897
9193,17,3300,경남,44,44,0,8591,2021-04-16 09:00:00.000,2021-09-16 10:11:33.897
9194,1,671,제주,3,3,0,8590,2021-04-16 09:00:00.000,2021-09-16 10:11:33.897
9195,4,3286,검역,11,0,11,8589,2021-04-16 09:00:00.000,2021-09-16 10:11:33.897
9196,1788,112111,합계,698,670,28,8588,2021-04-15 09:00:00.000,2021-09-16 10:11:33.897
9197,440,34853,서울,217,216,1,8587,2021-04-15 09:00:00.000,2021-09-16 10:11:33.897
9198,120,4534,부산,54,54,0,8586,2021-04-15 09:00:00.000,2021-09-16 10:11:33.897
9199,219,9123,대구,18,16,2,8585,2021-04-15 09:00:00.000,2021-09-16 10:11:33.897
9200,58,5423,인천,17,16,1,8584,2021-04-15 09:00:00.000,2021-09-16 10:11:33.897
9201,21,2256,광주,4,3,1,8583,2021-04-15 09:00:00.000,2021-09-16 10:11:33.897
9202,16,1581,대전,10,10,0,8582,2021-04-15 09:00:00.000,2021-09-16 10:11:33.897
9203,37,1386,울산,21,21,0,8581,2021-04-15 09:00:00.000,2021-09-16 10:11:33.897
9204,1,338,세종,3,3,0,8580,2021-04-15 09:00:00.000,2021-09-16 10:11:33.897
9205,563,31186,경기,224,222,2,8579,2021-04-15 09:00:00.000,2021-09-16 10:11:33.897
9206,50,2492,강원,18,18,0,8578,2021-04-15 09:00:00.000,2021-09-16 10:11:33.897
9207,61,2404,충북,20,19,1,8577,2021-04-15 09:00:00.000,2021-09-16 10:11:33.897
9208,36,2831,충남,4,4,0,8576,2021-04-15 09:00:00.000,2021-09-16 10:11:33.897
9209,57,1772,전북,16,15,1,8575,2021-04-15 09:00:00.000,2021-09-16 10:11:33.897
9210,10,990,전남,11,11,0,8574,2021-04-15 09:00:00.000,2021-09-16 10:11:33.897
9211,77,3743,경북,19,19,0,8573,2021-04-15 09:00:00.000,2021-09-16 10:11:33.897
9212,17,3256,경남,24,22,2,8572,2021-04-15 09:00:00.000,2021-09-16 10:11:33.897
9213,1,668,제주,3,1,2,8571,2021-04-15 09:00:00.000,2021-09-16 10:11:33.897
9214,4,3275,검역,15,0,15,8570,2021-04-15 09:00:00.000,2021-09-16 10:11:33.897
9215,1782,111413,합계,731,714,17,8569,2021-04-14 09:00:00.000,2021-09-16 10:11:33.897
9216,438,34636,서울,247,245,2,8568,2021-04-14 09:00:00.000,2021-09-16 10:11:33.897
9217,120,4480,부산,49,48,1,8567,2021-04-14 09:00:00.000,2021-09-16 10:11:33.897
9218,219,9105,대구,11,11,0,8566,2021-04-14 09:00:00.000,2021-09-16 10:11:33.897
9219,58,5406,인천,26,26,0,8565,2021-04-14 09:00:00.000,2021-09-16 10:11:33.897
9220,21,2252,광주,5,5,0,8564,2021-04-14 09:00:00.000,2021-09-16 10:11:33.897
9221,16,1571,대전,11,11,0,8563,2021-04-14 09:00:00.000,2021-09-16 10:11:33.897
9222,37,1365,울산,30,30,0,8562,2021-04-14 09:00:00.000,2021-09-16 10:11:33.897
9223,1,335,세종,2,2,0,8561,2021-04-14 09:00:00.000,2021-09-16 10:11:33.897
9224,561,30962,경기,238,238,0,8560,2021-04-14 09:00:00.000,2021-09-16 10:11:33.897
9225,49,2474,강원,6,6,0,8559,2021-04-14 09:00:00.000,2021-09-16 10:11:33.897
9226,61,2384,충북,29,29,0,8558,2021-04-14 09:00:00.000,2021-09-16 10:11:33.897
9227,36,2827,충남,10,10,0,8557,2021-04-14 09:00:00.000,2021-09-16 10:11:33.897
9228,57,1756,전북,11,10,1,8556,2021-04-14 09:00:00.000,2021-09-16 10:11:33.897
9229,10,979,전남,1,1,0,8555,2021-04-14 09:00:00.000,2021-09-16 10:11:33.897
9230,76,3724,경북,14,14,0,8554,2021-04-14 09:00:00.000,2021-09-16 10:11:33.897
9231,17,3232,경남,27,27,0,8553,2021-04-14 09:00:00.000,2021-09-16 10:11:33.897
9232,1,665,제주,2,1,1,8552,2021-04-14 09:00:00.000,2021-09-16 10:11:33.897
9233,4,3260,검역,12,0,12,8551,2021-04-14 09:00:00.000,2021-09-16 10:11:33.897
9234,1775,110682,합계,542,528,14,8550,2021-04-13 09:00:00.000,2021-09-16 10:11:33.897
9235,437,34389,서울,158,156,2,8549,2021-04-13 09:00:00.000,2021-09-16 10:11:33.897
9236,120,4431,부산,39,39,0,8548,2021-04-13 09:00:00.000,2021-09-16 10:11:33.897
9237,219,9094,대구,9,9,0,8547,2021-04-13 09:00:00.000,2021-09-16 10:11:33.897
9238,58,5380,인천,16,16,0,8546,2021-04-13 09:00:00.000,2021-09-16 10:11:33.897
9239,21,2247,광주,9,9,0,8545,2021-04-13 09:00:00.000,2021-09-16 10:11:33.897
9240,16,1560,대전,13,13,0,8544,2021-04-13 09:00:00.000,2021-09-16 10:11:33.897
9241,37,1335,울산,32,32,0,8543,2021-04-13 09:00:00.000,2021-09-16 10:11:33.897
9242,1,333,세종,2,2,0,8542,2021-04-13 09:00:00.000,2021-09-16 10:11:33.897
9243,558,30724,경기,168,163,5,8541,2021-04-13 09:00:00.000,2021-09-16 10:11:33.897
9244,48,2468,강원,13,12,1,8540,2021-04-13 09:00:00.000,2021-09-16 10:11:33.897
9245,61,2355,충북,8,7,1,8539,2021-04-13 09:00:00.000,2021-09-16 10:11:33.897
9246,36,2817,충남,14,14,0,8538,2021-04-13 09:00:00.000,2021-09-16 10:11:33.897
9247,57,1745,전북,25,25,0,8537,2021-04-13 09:00:00.000,2021-09-16 10:11:33.897
9248,8,978,전남,6,6,0,8536,2021-04-13 09:00:00.000,2021-09-16 10:11:33.897
9249,76,3710,경북,10,10,0,8535,2021-04-13 09:00:00.000,2021-09-16 10:11:33.897
9250,17,3205,경남,15,15,0,8534,2021-04-13 09:00:00.000,2021-09-16 10:11:33.897
9251,1,663,제주,0,0,0,8533,2021-04-13 09:00:00.000,2021-09-16 10:11:33.897
9252,4,3248,검역,5,0,5,8532,2021-04-13 09:00:00.000,2021-09-16 10:11:33.897
9253,1770,110140,합계,587,560,27,8531,2021-04-12 09:00:00.000,2021-09-16 10:11:33.897
9254,435,34231,서울,162,160,2,8530,2021-04-12 09:00:00.000,2021-09-16 10:11:33.897
9255,120,4392,부산,47,46,1,8529,2021-04-12 09:00:00.000,2021-09-16 10:11:33.897
9256,218,9085,대구,16,15,1,8528,2021-04-12 09:00:00.000,2021-09-16 10:11:33.897
9257,58,5364,인천,12,12,0,8527,2021-04-12 09:00:00.000,2021-09-16 10:11:33.897
9258,21,2238,광주,4,4,0,8526,2021-04-12 09:00:00.000,2021-09-16 10:11:33.897
9259,16,1547,대전,17,17,0,8525,2021-04-12 09:00:00.000,2021-09-16 10:11:33.897
9260,37,1303,울산,34,31,3,8524,2021-04-12 09:00:00.000,2021-09-16 10:11:33.897
9261,1,331,세종,5,5,0,8523,2021-04-12 09:00:00.000,2021-09-16 10:11:33.897
9262,556,30556,경기,176,173,3,8522,2021-04-12 09:00:00.000,2021-09-16 10:11:33.897
9263,48,2455,강원,6,4,2,8521,2021-04-12 09:00:00.000,2021-09-16 10:11:33.897
9264,61,2347,충북,20,17,3,8520,2021-04-12 09:00:00.000,2021-09-16 10:11:33.897
9265,36,2803,충남,18,16,2,8519,2021-04-12 09:00:00.000,2021-09-16 10:11:33.897
9266,57,1720,전북,24,24,0,8518,2021-04-12 09:00:00.000,2021-09-16 10:11:33.897
9267,8,972,전남,3,3,0,8517,2021-04-12 09:00:00.000,2021-09-16 10:11:33.897
9268,76,3700,경북,15,15,0,8516,2021-04-12 09:00:00.000,2021-09-16 10:11:33.897
9269,17,3190,경남,17,15,2,8515,2021-04-12 09:00:00.000,2021-09-16 10:11:33.897
9270,1,663,제주,3,3,0,8514,2021-04-12 09:00:00.000,2021-09-16 10:11:33.897
9271,4,3243,검역,8,0,8,8513,2021-04-12 09:00:00.000,2021-09-16 10:11:33.897
9272,1768,109553,합계,614,594,20,8512,2021-04-11 09:00:00.000,2021-09-16 10:11:33.897
9273,434,34069,서울,214,211,3,8511,2021-04-11 09:00:00.000,2021-09-16 10:11:33.897
9274,120,4345,부산,45,44,1,8510,2021-04-11 09:00:00.000,2021-09-16 10:11:33.897
9275,218,9069,대구,6,6,0,8509,2021-04-11 09:00:00.000,2021-09-16 10:11:33.897
9276,58,5352,인천,17,16,1,8508,2021-04-11 09:00:00.000,2021-09-16 10:11:33.897
9277,21,2234,광주,0,0,0,8507,2021-04-11 09:00:00.000,2021-09-16 10:11:33.897
9278,16,1530,대전,7,7,0,8506,2021-04-11 09:00:00.000,2021-09-16 10:11:33.897
9279,37,1269,울산,11,10,1,8505,2021-04-11 09:00:00.000,2021-09-16 10:11:33.897
9280,1,326,세종,1,1,0,8504,2021-04-11 09:00:00.000,2021-09-16 10:11:33.897
9281,555,30380,경기,186,182,4,8503,2021-04-11 09:00:00.000,2021-09-16 10:11:33.897
9282,48,2449,강원,5,5,0,8502,2021-04-11 09:00:00.000,2021-09-16 10:11:33.897
9283,61,2327,충북,10,10,0,8501,2021-04-11 09:00:00.000,2021-09-16 10:11:33.897
9284,36,2785,충남,22,22,0,8500,2021-04-11 09:00:00.000,2021-09-16 10:11:33.897
9285,57,1696,전북,40,40,0,8499,2021-04-11 09:00:00.000,2021-09-16 10:11:33.897
9286,8,969,전남,6,6,0,8498,2021-04-11 09:00:00.000,2021-09-16 10:11:33.897
9287,76,3685,경북,13,12,1,8497,2021-04-11 09:00:00.000,2021-09-16 10:11:33.897
9288,17,3173,경남,16,15,1,8496,2021-04-11 09:00:00.000,2021-09-16 10:11:33.897
9289,1,660,제주,7,7,0,8495,2021-04-11 09:00:00.000,2021-09-16 10:11:33.897
9290,4,3235,검역,8,0,8,8494,2021-04-11 09:00:00.000,2021-09-16 10:11:33.897
9291,1765,108939,합계,677,662,15,8493,2021-04-10 09:00:00.000,2021-09-16 10:11:33.897
9292,434,33855,서울,201,198,3,8492,2021-04-10 09:00:00.000,2021-09-16 10:11:33.897
9293,120,4300,부산,56,56,0,8491,2021-04-10 09:00:00.000,2021-09-16 10:11:33.897
9294,218,9063,대구,5,4,1,8490,2021-04-10 09:00:00.000,2021-09-16 10:11:33.897
9295,58,5335,인천,24,24,0,8489,2021-04-10 09:00:00.000,2021-09-16 10:11:33.897
9296,21,2234,광주,1,1,0,8488,2021-04-10 09:00:00.000,2021-09-16 10:11:33.897
9297,16,1523,대전,13,13,0,8487,2021-04-10 09:00:00.000,2021-09-16 10:11:33.897
9298,37,1258,울산,25,25,0,8486,2021-04-10 09:00:00.000,2021-09-16 10:11:33.897
9299,1,325,세종,4,4,0,8485,2021-04-10 09:00:00.000,2021-09-16 10:11:33.897
9300,553,30194,경기,202,199,3,8484,2021-04-10 09:00:00.000,2021-09-16 10:11:33.897
9301,48,2444,강원,6,6,0,8483,2021-04-10 09:00:00.000,2021-09-16 10:11:33.897
9302,61,2317,충북,12,10,2,8482,2021-04-10 09:00:00.000,2021-09-16 10:11:33.897
9303,35,2763,충남,15,15,0,8481,2021-04-10 09:00:00.000,2021-09-16 10:11:33.897
9304,57,1656,전북,23,23,0,8480,2021-04-10 09:00:00.000,2021-09-16 10:11:33.897
9305,8,963,전남,7,7,0,8479,2021-04-10 09:00:00.000,2021-09-16 10:11:33.897
9306,76,3672,경북,26,26,0,8478,2021-04-10 09:00:00.000,2021-09-16 10:11:33.897
9307,17,3157,경남,46,44,2,8477,2021-04-10 09:00:00.000,2021-09-16 10:11:33.897
9308,1,653,제주,7,7,0,8476,2021-04-10 09:00:00.000,2021-09-16 10:11:33.897
9309,4,3227,검역,4,0,4,8475,2021-04-10 09:00:00.000,2021-09-16 10:11:33.897
9310,1764,108262,합계,671,644,27,8474,2021-04-09 09:00:00.000,2021-09-16 10:11:33.897
9311,434,33654,서울,215,214,1,8473,2021-04-09 09:00:00.000,2021-09-16 10:11:33.897
9312,119,4244,부산,53,50,3,8472,2021-04-09 09:00:00.000,2021-09-16 10:11:33.897
9313,218,9058,대구,18,17,1,8471,2021-04-09 09:00:00.000,2021-09-16 10:11:33.897
9314,58,5311,인천,45,39,6,8470,2021-04-09 09:00:00.000,2021-09-16 10:11:33.897
9315,21,2233,광주,5,5,0,8469,2021-04-09 09:00:00.000,2021-09-16 10:11:33.897
9316,16,1510,대전,26,26,0,8468,2021-04-09 09:00:00.000,2021-09-16 10:11:33.897
9317,37,1233,울산,9,9,0,8467,2021-04-09 09:00:00.000,2021-09-16 10:11:33.897
9318,1,321,세종,5,5,0,8466,2021-04-09 09:00:00.000,2021-09-16 10:11:33.897
9319,553,29992,경기,203,197,6,8465,2021-04-09 09:00:00.000,2021-09-16 10:11:33.897
9320,48,2438,강원,3,3,0,8464,2021-04-09 09:00:00.000,2021-09-16 10:11:33.897
9321,61,2305,충북,7,7,0,8463,2021-04-09 09:00:00.000,2021-09-16 10:11:33.897
9322,35,2748,충남,18,17,1,8462,2021-04-09 09:00:00.000,2021-09-16 10:11:33.897
9323,57,1633,전북,22,22,0,8461,2021-04-09 09:00:00.000,2021-09-16 10:11:33.897
9324,8,956,전남,11,9,2,8460,2021-04-09 09:00:00.000,2021-09-16 10:11:33.897
9325,76,3646,경북,7,7,0,8459,2021-04-09 09:00:00.000,2021-09-16 10:11:33.897
9326,17,3111,경남,15,15,0,8458,2021-04-09 09:00:00.000,2021-09-16 10:11:33.897
9327,1,646,제주,2,2,0,8457,2021-04-09 09:00:00.000,2021-09-16 10:11:33.897
9328,4,3223,검역,7,0,7,8456,2021-04-09 09:00:00.000,2021-09-16 10:11:33.897
9329,1758,107591,합계,700,674,26,8455,2021-04-08 09:00:00.000,2021-09-16 10:11:33.897
9330,431,33439,서울,244,239,5,8454,2021-04-08 09:00:00.000,2021-09-16 10:11:33.897
9331,119,4191,부산,52,51,1,8453,2021-04-08 09:00:00.000,2021-09-16 10:11:33.897
9332,218,9040,대구,10,10,0,8452,2021-04-08 09:00:00.000,2021-09-16 10:11:33.897
9333,58,5266,인천,25,23,2,8451,2021-04-08 09:00:00.000,2021-09-16 10:11:33.897
9334,21,2228,광주,0,0,0,8450,2021-04-08 09:00:00.000,2021-09-16 10:11:33.897
9335,16,1484,대전,25,25,0,8449,2021-04-08 09:00:00.000,2021-09-16 10:11:33.897
9336,37,1224,울산,13,13,0,8448,2021-04-08 09:00:00.000,2021-09-16 10:11:33.897
9337,1,316,세종,7,7,0,8447,2021-04-08 09:00:00.000,2021-09-16 10:11:33.897
9338,550,29789,경기,230,223,7,8446,2021-04-08 09:00:00.000,2021-09-16 10:11:33.897
9339,48,2435,강원,7,6,1,8445,2021-04-08 09:00:00.000,2021-09-16 10:11:33.897
9340,61,2298,충북,8,8,0,8444,2021-04-08 09:00:00.000,2021-09-16 10:11:33.897
9341,35,2730,충남,20,18,2,8443,2021-04-08 09:00:00.000,2021-09-16 10:11:33.897
9342,57,1611,전북,24,24,0,8442,2021-04-08 09:00:00.000,2021-09-16 10:11:33.897
9343,8,945,전남,1,1,0,8441,2021-04-08 09:00:00.000,2021-09-16 10:11:33.897
9344,76,3639,경북,11,11,0,8440,2021-04-08 09:00:00.000,2021-09-16 10:11:33.897
9345,17,3096,경남,11,10,1,8439,2021-04-08 09:00:00.000,2021-09-16 10:11:33.897
9346,1,644,제주,5,5,0,8438,2021-04-08 09:00:00.000,2021-09-16 10:11:33.897
9347,4,3216,검역,7,0,7,8437,2021-04-08 09:00:00.000,2021-09-16 10:11:33.897
9348,1756,106891,합계,668,653,15,8436,2021-04-07 09:00:00.000,2021-09-16 10:11:33.897
9349,431,33195,서울,198,196,2,8435,2021-04-07 09:00:00.000,2021-09-16 10:11:33.897
9350,119,4139,부산,38,38,0,8434,2021-04-07 09:00:00.000,2021-09-16 10:11:33.897
9351,218,9030,대구,16,16,0,8433,2021-04-07 09:00:00.000,2021-09-16 10:11:33.897
9352,58,5241,인천,48,44,4,8432,2021-04-07 09:00:00.000,2021-09-16 10:11:33.897
9353,21,2228,광주,2,2,0,8431,2021-04-07 09:00:00.000,2021-09-16 10:11:33.897
9354,16,1459,대전,61,61,0,8430,2021-04-07 09:00:00.000,2021-09-16 10:11:33.897
9355,37,1211,울산,26,26,0,8429,2021-04-07 09:00:00.000,2021-09-16 10:11:33.897
9356,1,309,세종,1,1,0,8428,2021-04-07 09:00:00.000,2021-09-16 10:11:33.897
9357,549,29559,경기,175,173,2,8427,2021-04-07 09:00:00.000,2021-09-16 10:11:33.897
9358,48,2428,강원,16,16,0,8426,2021-04-07 09:00:00.000,2021-09-16 10:11:33.897
9359,61,2290,충북,17,15,2,8425,2021-04-07 09:00:00.000,2021-09-16 10:11:33.897
9360,35,2710,충남,12,11,1,8424,2021-04-07 09:00:00.000,2021-09-16 10:11:33.897
9361,57,1587,전북,10,10,0,8423,2021-04-07 09:00:00.000,2021-09-16 10:11:33.897
9362,8,944,전남,7,7,0,8422,2021-04-07 09:00:00.000,2021-09-16 10:11:33.897
9363,76,3628,경북,9,9,0,8421,2021-04-07 09:00:00.000,2021-09-16 10:11:33.897
9364,16,3085,경남,25,25,0,8420,2021-04-07 09:00:00.000,2021-09-16 10:11:33.897
9365,1,639,제주,3,3,0,8419,2021-04-07 09:00:00.000,2021-09-16 10:11:33.897
9366,4,3209,검역,4,0,4,8418,2021-04-07 09:00:00.000,2021-09-16 10:11:33.897
9367,1752,106223,합계,477,459,18,8417,2021-04-06 09:00:00.000,2021-09-16 10:11:33.897
9368,429,32997,서울,147,145,2,8416,2021-04-06 09:00:00.000,2021-09-16 10:11:33.897
9369,119,4101,부산,34,34,0,8415,2021-04-06 09:00:00.000,2021-09-16 10:11:33.897
9370,218,9014,대구,16,16,0,8414,2021-04-06 09:00:00.000,2021-09-16 10:11:33.897
9371,58,5193,인천,27,27,0,8413,2021-04-06 09:00:00.000,2021-09-16 10:11:33.897
9372,21,2226,광주,6,6,0,8412,2021-04-06 09:00:00.000,2021-09-16 10:11:33.897
9373,16,1398,대전,22,22,0,8411,2021-04-06 09:00:00.000,2021-09-16 10:11:33.897
9374,37,1185,울산,4,4,0,8410,2021-04-06 09:00:00.000,2021-09-16 10:11:33.897
9375,1,308,세종,0,0,0,8409,2021-04-06 09:00:00.000,2021-09-16 10:11:33.897
9376,547,29384,경기,107,100,7,8408,2021-04-06 09:00:00.000,2021-09-16 10:11:33.897
9377,48,2412,강원,15,15,0,8407,2021-04-06 09:00:00.000,2021-09-16 10:11:33.897
9378,61,2273,충북,12,10,2,8406,2021-04-06 09:00:00.000,2021-09-16 10:11:33.897
9379,35,2698,충남,6,4,2,8405,2021-04-06 09:00:00.000,2021-09-16 10:11:33.897
9380,57,1577,전북,29,29,0,8404,2021-04-06 09:00:00.000,2021-09-16 10:11:33.897
9381,8,937,전남,15,15,0,8403,2021-04-06 09:00:00.000,2021-09-16 10:11:33.897
9382,76,3619,경북,25,25,0,8402,2021-04-06 09:00:00.000,2021-09-16 10:11:33.897
9383,16,3060,경남,7,7,0,8401,2021-04-06 09:00:00.000,2021-09-16 10:11:33.897
9384,1,636,제주,0,0,0,8400,2021-04-06 09:00:00.000,2021-09-16 10:11:33.897
9385,4,3205,검역,5,0,5,8399,2021-04-06 09:00:00.000,2021-09-16 10:11:33.897
9386,1748,105746,합계,473,449,24,8398,2021-04-05 09:00:00.000,2021-09-16 10:11:33.897
9387,429,32850,서울,152,149,3,8397,2021-04-05 09:00:00.000,2021-09-16 10:11:33.897
9388,119,4067,부산,48,46,2,8396,2021-04-05 09:00:00.000,2021-09-16 10:11:33.897
9389,218,8998,대구,22,22,0,8395,2021-04-05 09:00:00.000,2021-09-16 10:11:33.897
9390,57,5166,인천,22,19,3,8394,2021-04-05 09:00:00.000,2021-09-16 10:11:33.897
9391,21,2220,광주,0,0,0,8393,2021-04-05 09:00:00.000,2021-09-16 10:11:33.897
9392,16,1376,대전,13,13,0,8392,2021-04-05 09:00:00.000,2021-09-16 10:11:33.897
9393,37,1181,울산,1,1,0,8391,2021-04-05 09:00:00.000,2021-09-16 10:11:33.897
9394,1,308,세종,4,4,0,8390,2021-04-05 09:00:00.000,2021-09-16 10:11:33.897
9395,544,29277,경기,111,108,3,8389,2021-04-05 09:00:00.000,2021-09-16 10:11:33.897
9396,48,2397,강원,14,14,0,8388,2021-04-05 09:00:00.000,2021-09-16 10:11:33.897
9397,61,2261,충북,7,7,0,8387,2021-04-05 09:00:00.000,2021-09-16 10:11:33.897
9398,35,2692,충남,14,14,0,8386,2021-04-05 09:00:00.000,2021-09-16 10:11:33.897
9399,57,1548,전북,16,16,0,8385,2021-04-05 09:00:00.000,2021-09-16 10:11:33.897
9400,8,922,전남,5,3,2,8384,2021-04-05 09:00:00.000,2021-09-16 10:11:33.897
9401,76,3594,경북,20,20,0,8383,2021-04-05 09:00:00.000,2021-09-16 10:11:33.897
9402,16,3053,경남,12,11,1,8382,2021-04-05 09:00:00.000,2021-09-16 10:11:33.897
9403,1,636,제주,2,2,0,8381,2021-04-05 09:00:00.000,2021-09-16 10:11:33.897
9404,4,3200,검역,10,0,10,8380,2021-04-05 09:00:00.000,2021-09-16 10:11:33.897
9405,1744,105273,합계,543,514,29,8379,2021-04-04 09:00:00.000,2021-09-16 10:11:33.897
9406,429,32698,서울,149,146,3,8378,2021-04-04 09:00:00.000,2021-09-16 10:11:33.897
9407,119,4019,부산,61,60,1,8377,2021-04-04 09:00:00.000,2021-09-16 10:11:33.897
9408,218,8976,대구,15,15,0,8376,2021-04-04 09:00:00.000,2021-09-16 10:11:33.897
9409,57,5144,인천,22,19,3,8375,2021-04-04 09:00:00.000,2021-09-16 10:11:33.897
9410,21,2220,광주,4,4,0,8374,2021-04-04 09:00:00.000,2021-09-16 10:11:33.897
9411,16,1363,대전,29,28,1,8373,2021-04-04 09:00:00.000,2021-09-16 10:11:33.897
9412,37,1180,울산,11,11,0,8372,2021-04-04 09:00:00.000,2021-09-16 10:11:33.897
9413,1,304,세종,3,3,0,8371,2021-04-04 09:00:00.000,2021-09-16 10:11:33.897
9414,541,29166,경기,150,146,4,8370,2021-04-04 09:00:00.000,2021-09-16 10:11:33.897
9415,47,2383,강원,6,6,0,8369,2021-04-04 09:00:00.000,2021-09-16 10:11:33.897
9416,61,2254,충북,14,14,0,8368,2021-04-04 09:00:00.000,2021-09-16 10:11:33.897
9417,35,2678,충남,12,10,2,8367,2021-04-04 09:00:00.000,2021-09-16 10:11:33.897
9418,57,1532,전북,24,23,1,8366,2021-04-04 09:00:00.000,2021-09-16 10:11:33.897
9419,8,917,전남,1,1,0,8365,2021-04-04 09:00:00.000,2021-09-16 10:11:33.897
9420,76,3574,경북,16,13,3,8364,2021-04-04 09:00:00.000,2021-09-16 10:11:33.897
9421,16,3041,경남,14,13,1,8363,2021-04-04 09:00:00.000,2021-09-16 10:11:33.897
9422,1,634,제주,2,2,0,8362,2021-04-04 09:00:00.000,2021-09-16 10:11:33.897
9423,4,3190,검역,10,0,10,8361,2021-04-04 09:00:00.000,2021-09-16 10:11:33.897
9424,1740,104730,합계,543,521,22,8360,2021-04-03 09:00:00.000,2021-09-16 10:11:33.897
9425,427,32549,서울,155,154,1,8359,2021-04-03 09:00:00.000,2021-09-16 10:11:33.897
9426,119,3958,부산,61,61,0,8358,2021-04-03 09:00:00.000,2021-09-16 10:11:33.897
9427,218,8961,대구,10,10,0,8357,2021-04-03 09:00:00.000,2021-09-16 10:11:33.897
9428,57,5122,인천,21,19,2,8356,2021-04-03 09:00:00.000,2021-09-16 10:11:33.897
9429,21,2216,광주,3,2,1,8355,2021-04-03 09:00:00.000,2021-09-16 10:11:33.897
9430,16,1334,대전,19,19,0,8354,2021-04-03 09:00:00.000,2021-09-16 10:11:33.897
9431,37,1169,울산,3,3,0,8353,2021-04-03 09:00:00.000,2021-09-16 10:11:33.897
9432,1,301,세종,10,10,0,8352,2021-04-03 09:00:00.000,2021-09-16 10:11:33.897
9433,539,29016,경기,147,143,4,8351,2021-04-03 09:00:00.000,2021-09-16 10:11:33.897
9434,47,2377,강원,17,16,1,8350,2021-04-03 09:00:00.000,2021-09-16 10:11:33.897
9435,61,2240,충북,11,11,0,8349,2021-04-03 09:00:00.000,2021-09-16 10:11:33.897
9436,35,2666,충남,10,7,3,8348,2021-04-03 09:00:00.000,2021-09-16 10:11:33.897
9437,57,1508,전북,20,20,0,8347,2021-04-03 09:00:00.000,2021-09-16 10:11:33.897
9438,8,916,전남,1,1,0,8346,2021-04-03 09:00:00.000,2021-09-16 10:11:33.897
9439,76,3558,경북,17,16,1,8345,2021-04-03 09:00:00.000,2021-09-16 10:11:33.897
9440,16,3027,경남,28,28,0,8344,2021-04-03 09:00:00.000,2021-09-16 10:11:33.897
9441,1,632,제주,1,1,0,8343,2021-04-03 09:00:00.000,2021-09-16 10:11:33.897
9442,4,3180,검역,9,0,9,8342,2021-04-03 09:00:00.000,2021-09-16 10:11:33.897
9443,1737,104187,합계,557,532,25,8341,2021-04-02 09:00:00.000,2021-09-16 10:11:33.897
9444,426,32394,서울,166,164,2,8340,2021-04-02 09:00:00.000,2021-09-16 10:11:33.897
9445,118,3897,부산,38,35,3,8339,2021-04-02 09:00:00.000,2021-09-16 10:11:33.897
9446,218,8951,대구,17,17,0,8338,2021-04-02 09:00:00.000,2021-09-16 10:11:33.897
9447,57,5101,인천,23,22,1,8337,2021-04-02 09:00:00.000,2021-09-16 10:11:33.897
9448,21,2213,광주,1,1,0,8336,2021-04-02 09:00:00.000,2021-09-16 10:11:33.897
9449,16,1315,대전,19,19,0,8335,2021-04-02 09:00:00.000,2021-09-16 10:11:33.897
9450,37,1166,울산,7,7,0,8334,2021-04-02 09:00:00.000,2021-09-16 10:11:33.897
9451,1,291,세종,8,8,0,8333,2021-04-02 09:00:00.000,2021-09-16 10:11:33.897
9452,539,28869,경기,160,156,4,8332,2021-04-02 09:00:00.000,2021-09-16 10:11:33.897
9453,47,2360,강원,10,10,0,8331,2021-04-02 09:00:00.000,2021-09-16 10:11:33.897
9454,61,2229,충북,19,19,0,8330,2021-04-02 09:00:00.000,2021-09-16 10:11:33.897
9455,35,2656,충남,10,8,2,8329,2021-04-02 09:00:00.000,2021-09-16 10:11:33.897
9456,57,1488,전북,15,15,0,8328,2021-04-02 09:00:00.000,2021-09-16 10:11:33.897
9457,8,915,전남,1,1,0,8327,2021-04-02 09:00:00.000,2021-09-16 10:11:33.897
9458,75,3541,경북,30,28,2,8326,2021-04-02 09:00:00.000,2021-09-16 10:11:33.897
9459,16,2999,경남,18,18,0,8325,2021-04-02 09:00:00.000,2021-09-16 10:11:33.897
9460,1,631,제주,4,4,0,8324,2021-04-02 09:00:00.000,2021-09-16 10:11:33.897
9461,4,3171,검역,11,0,11,8323,2021-04-02 09:00:00.000,2021-09-16 10:11:33.897
9462,1735,103630,합계,551,537,14,8322,2021-04-01 09:00:00.000,2021-09-16 10:11:33.897
9463,425,32228,서울,199,197,2,8321,2021-04-01 09:00:00.000,2021-09-16 10:11:33.897
9464,118,3859,부산,54,53,1,8320,2021-04-01 09:00:00.000,2021-09-16 10:11:33.897
9465,218,8934,대구,7,7,0,8319,2021-04-01 09:00:00.000,2021-09-16 10:11:33.897
9466,57,5078,인천,20,20,0,8318,2021-04-01 09:00:00.000,2021-09-16 10:11:33.897
9467,21,2212,광주,3,1,2,8317,2021-04-01 09:00:00.000,2021-09-16 10:11:33.897
9468,16,1296,대전,10,10,0,8316,2021-04-01 09:00:00.000,2021-09-16 10:11:33.897
9469,37,1159,울산,5,5,0,8315,2021-04-01 09:00:00.000,2021-09-16 10:11:33.897
9470,1,283,세종,13,13,0,8314,2021-04-01 09:00:00.000,2021-09-16 10:11:33.897
9471,538,28709,경기,130,125,5,8313,2021-04-01 09:00:00.000,2021-09-16 10:11:33.897
9472,47,2350,강원,20,20,0,8312,2021-04-01 09:00:00.000,2021-09-16 10:11:33.897
9473,61,2210,충북,20,19,1,8311,2021-04-01 09:00:00.000,2021-09-16 10:11:33.897
9474,35,2646,충남,15,15,0,8310,2021-04-01 09:00:00.000,2021-09-16 10:11:33.897
9475,57,1473,전북,22,22,0,8309,2021-04-01 09:00:00.000,2021-09-16 10:11:33.897
9476,8,914,전남,1,1,0,8308,2021-04-01 09:00:00.000,2021-09-16 10:11:33.897
9477,75,3511,경북,7,6,1,8307,2021-04-01 09:00:00.000,2021-09-16 10:11:33.897
9478,16,2981,경남,21,21,0,8306,2021-04-01 09:00:00.000,2021-09-16 10:11:33.897
9479,1,627,제주,2,2,0,8305,2021-04-01 09:00:00.000,2021-09-16 10:11:33.897
9480,4,3160,검역,2,0,2,8304,2021-04-01 09:00:00.000,2021-09-16 10:11:33.897
9481,1731,103079,합계,506,491,15,8303,2021-03-31 09:00:00.000,2021-09-16 10:11:33.897
9482,424,32029,서울,158,156,2,8302,2021-03-31 09:00:00.000,2021-09-16 10:11:33.897
9483,118,3805,부산,58,58,0,8301,2021-03-31 09:00:00.000,2021-09-16 10:11:33.897
9484,217,8927,대구,15,15,0,8300,2021-03-31 09:00:00.000,2021-09-16 10:11:33.897
9485,57,5058,인천,25,25,0,8299,2021-03-31 09:00:00.000,2021-09-16 10:11:33.897
9486,21,2209,광주,2,2,0,8298,2021-03-31 09:00:00.000,2021-09-16 10:11:33.897
9487,16,1286,대전,7,7,0,8297,2021-03-31 09:00:00.000,2021-09-16 10:11:33.897
9488,37,1154,울산,11,11,0,8296,2021-03-31 09:00:00.000,2021-09-16 10:11:33.897
9489,1,270,세종,17,17,0,8295,2021-03-31 09:00:00.000,2021-09-16 10:11:33.897
9490,537,28579,경기,111,106,5,8294,2021-03-31 09:00:00.000,2021-09-16 10:11:33.897
9491,47,2330,강원,16,16,0,8293,2021-03-31 09:00:00.000,2021-09-16 10:11:33.897
9492,61,2190,충북,21,21,0,8292,2021-03-31 09:00:00.000,2021-09-16 10:11:33.897
9493,35,2631,충남,8,8,0,8291,2021-03-31 09:00:00.000,2021-09-16 10:11:33.897
9494,57,1451,전북,20,20,0,8290,2021-03-31 09:00:00.000,2021-09-16 10:11:33.897
9495,8,913,전남,0,0,0,8289,2021-03-31 09:00:00.000,2021-09-16 10:11:33.897
9496,75,3504,경북,6,6,0,8288,2021-03-31 09:00:00.000,2021-09-16 10:11:33.897
9497,15,2960,경남,22,21,1,8287,2021-03-31 09:00:00.000,2021-09-16 10:11:33.897
9498,1,625,제주,2,2,0,8286,2021-03-31 09:00:00.000,2021-09-16 10:11:33.897
9499,4,3158,검역,7,0,7,8285,2021-03-31 09:00:00.000,2021-09-16 10:11:33.897
9500,1729,102573,합계,447,429,18,8284,2021-03-30 09:00:00.000,2021-09-16 10:11:33.897
9501,424,31871,서울,145,140,5,8283,2021-03-30 09:00:00.000,2021-09-16 10:11:33.897
9502,118,3747,부산,43,42,1,8282,2021-03-30 09:00:00.000,2021-09-16 10:11:33.897
9503,217,8912,대구,12,12,0,8281,2021-03-30 09:00:00.000,2021-09-16 10:11:33.897
9504,57,5033,인천,18,18,0,8280,2021-03-30 09:00:00.000,2021-09-16 10:11:33.897
9505,21,2207,광주,1,1,0,8279,2021-03-30 09:00:00.000,2021-09-16 10:11:33.897
9506,16,1279,대전,11,11,0,8278,2021-03-30 09:00:00.000,2021-09-16 10:11:33.897
9507,37,1143,울산,3,3,0,8277,2021-03-30 09:00:00.000,2021-09-16 10:11:33.897
9508,1,253,세종,2,2,0,8276,2021-03-30 09:00:00.000,2021-09-16 10:11:33.897
9509,536,28468,경기,117,112,5,8275,2021-03-30 09:00:00.000,2021-09-16 10:11:33.897
9510,46,2314,강원,13,13,0,8274,2021-03-30 09:00:00.000,2021-09-16 10:11:33.897
9511,61,2169,충북,28,27,1,8273,2021-03-30 09:00:00.000,2021-09-16 10:11:33.897
9512,35,2623,충남,5,4,1,8272,2021-03-30 09:00:00.000,2021-09-16 10:11:33.897
9513,57,1431,전북,25,25,0,8271,2021-03-30 09:00:00.000,2021-09-16 10:11:33.897
9514,8,913,전남,0,0,0,8270,2021-03-30 09:00:00.000,2021-09-16 10:11:33.897
9515,75,3498,경북,5,4,1,8269,2021-03-30 09:00:00.000,2021-09-16 10:11:33.897
9516,15,2938,경남,16,15,1,8268,2021-03-30 09:00:00.000,2021-09-16 10:11:33.897
9517,1,623,제주,0,0,0,8267,2021-03-30 09:00:00.000,2021-09-16 10:11:33.897
9518,4,3151,검역,3,0,3,8266,2021-03-30 09:00:00.000,2021-09-16 10:11:33.897
9519,1726,102126,합계,382,369,13,8265,2021-03-29 09:00:00.000,2021-09-16 10:11:33.897
9520,423,31726,서울,107,105,2,8264,2021-03-29 09:00:00.000,2021-09-16 10:11:33.897
9521,118,3704,부산,53,53,0,8263,2021-03-29 09:00:00.000,2021-09-16 10:11:33.897
9522,217,8900,대구,10,9,1,8262,2021-03-29 09:00:00.000,2021-09-16 10:11:33.897
9523,57,5015,인천,18,18,0,8261,2021-03-29 09:00:00.000,2021-09-16 10:11:33.897
9524,21,2206,광주,2,2,0,8260,2021-03-29 09:00:00.000,2021-09-16 10:11:33.897
9525,16,1268,대전,2,2,0,8259,2021-03-29 09:00:00.000,2021-09-16 10:11:33.897
9526,37,1140,울산,3,3,0,8258,2021-03-29 09:00:00.000,2021-09-16 10:11:33.897
9527,1,251,세종,0,0,0,8257,2021-03-29 09:00:00.000,2021-09-16 10:11:33.897
9528,535,28351,경기,131,130,1,8256,2021-03-29 09:00:00.000,2021-09-16 10:11:33.897
9529,46,2301,강원,6,6,0,8255,2021-03-29 09:00:00.000,2021-09-16 10:11:33.897
9530,61,2141,충북,12,11,1,8254,2021-03-29 09:00:00.000,2021-09-16 10:11:33.897
9531,35,2618,충남,1,1,0,8253,2021-03-29 09:00:00.000,2021-09-16 10:11:33.897
9532,56,1406,전북,8,8,0,8252,2021-03-29 09:00:00.000,2021-09-16 10:11:33.897
9533,8,913,전남,1,0,1,8251,2021-03-29 09:00:00.000,2021-09-16 10:11:33.897
9534,75,3493,경북,3,3,0,8250,2021-03-29 09:00:00.000,2021-09-16 10:11:33.897
9535,15,2922,경남,20,18,2,8249,2021-03-29 09:00:00.000,2021-09-16 10:11:33.897
9536,1,623,제주,1,0,1,8248,2021-03-29 09:00:00.000,2021-09-16 10:11:33.897
9537,4,3148,검역,4,0,4,8247,2021-03-29 09:00:00.000,2021-09-16 10:11:33.897
9538,1722,101744,합계,482,462,20,8246,2021-03-28 09:00:00.000,2021-09-16 10:11:33.897
9539,423,31619,서울,138,135,3,8245,2021-03-28 09:00:00.000,2021-09-16 10:11:33.897
9540,118,3651,부산,56,56,0,8244,2021-03-28 09:00:00.000,2021-09-16 10:11:33.897
9541,216,8890,대구,10,9,1,8243,2021-03-28 09:00:00.000,2021-09-16 10:11:33.897
9542,57,4997,인천,33,32,1,8242,2021-03-28 09:00:00.000,2021-09-16 10:11:33.897
9543,21,2204,광주,2,2,0,8241,2021-03-28 09:00:00.000,2021-09-16 10:11:33.897
9544,16,1266,대전,8,6,2,8240,2021-03-28 09:00:00.000,2021-09-16 10:11:33.897
9545,37,1137,울산,4,4,0,8239,2021-03-28 09:00:00.000,2021-09-16 10:11:33.897
9546,1,251,세종,0,0,0,8238,2021-03-28 09:00:00.000,2021-09-16 10:11:33.897
9547,534,28220,경기,153,150,3,8237,2021-03-28 09:00:00.000,2021-09-16 10:11:33.897
9548,45,2295,강원,19,19,0,8236,2021-03-28 09:00:00.000,2021-09-16 10:11:33.897
9549,60,2129,충북,16,16,0,8235,2021-03-28 09:00:00.000,2021-09-16 10:11:33.897
9550,35,2617,충남,8,8,0,8234,2021-03-28 09:00:00.000,2021-09-16 10:11:33.897
9551,56,1398,전북,5,5,0,8233,2021-03-28 09:00:00.000,2021-09-16 10:11:33.897
9552,8,912,전남,1,0,1,8232,2021-03-28 09:00:00.000,2021-09-16 10:11:33.897
9553,75,3490,경북,7,7,0,8231,2021-03-28 09:00:00.000,2021-09-16 10:11:33.897
9554,15,2902,경남,13,13,0,8230,2021-03-28 09:00:00.000,2021-09-16 10:11:33.897
9555,1,622,제주,0,0,0,8229,2021-03-28 09:00:00.000,2021-09-16 10:11:33.897
9556,4,3144,검역,9,0,9,8228,2021-03-28 09:00:00.000,2021-09-16 10:11:33.897
9557,1721,101262,합계,505,490,15,8227,2021-03-27 09:00:00.000,2021-09-16 10:11:33.897
9558,422,31481,서울,127,126,1,8226,2021-03-27 09:00:00.000,2021-09-16 10:11:33.897
9559,118,3595,부산,33,33,0,8225,2021-03-27 09:00:00.000,2021-09-16 10:11:33.897
9560,216,8880,대구,23,22,1,8224,2021-03-27 09:00:00.000,2021-09-16 10:11:33.897
9561,57,4964,인천,39,39,0,8223,2021-03-27 09:00:00.000,2021-09-16 10:11:33.897
9562,21,2202,광주,5,5,0,8222,2021-03-27 09:00:00.000,2021-09-16 10:11:33.897
9563,16,1258,대전,10,10,0,8221,2021-03-27 09:00:00.000,2021-09-16 10:11:33.897
9564,37,1133,울산,5,3,2,8220,2021-03-27 09:00:00.000,2021-09-16 10:11:33.897
9565,1,251,세종,1,1,0,8219,2021-03-27 09:00:00.000,2021-09-16 10:11:33.897
9566,534,28067,경기,145,141,4,8218,2021-03-27 09:00:00.000,2021-09-16 10:11:33.897
9567,45,2276,강원,36,35,1,8217,2021-03-27 09:00:00.000,2021-09-16 10:11:33.897
9568,60,2113,충북,39,38,1,8216,2021-03-27 09:00:00.000,2021-09-16 10:11:33.897
9569,35,2609,충남,2,2,0,8215,2021-03-27 09:00:00.000,2021-09-16 10:11:33.897
9570,56,1393,전북,5,4,1,8214,2021-03-27 09:00:00.000,2021-09-16 10:11:33.897
9571,8,911,전남,0,0,0,8213,2021-03-27 09:00:00.000,2021-09-16 10:11:33.897
9572,75,3483,경북,11,10,1,8212,2021-03-27 09:00:00.000,2021-09-16 10:11:33.897
9573,15,2889,경남,19,19,0,8211,2021-03-27 09:00:00.000,2021-09-16 10:11:33.897
9574,1,622,제주,2,2,0,8210,2021-03-27 09:00:00.000,2021-09-16 10:11:33.897
9575,4,3135,검역,3,0,3,8209,2021-03-27 09:00:00.000,2021-09-16 10:11:33.897
9576,1716,100757,합계,489,466,23,8208,2021-03-26 09:00:00.000,2021-09-16 10:11:33.897
9577,420,31354,서울,121,120,1,8207,2021-03-26 09:00:00.000,2021-09-16 10:11:33.897
9578,118,3562,부산,11,11,0,8206,2021-03-26 09:00:00.000,2021-09-16 10:11:33.897
9579,216,8857,대구,14,14,0,8205,2021-03-26 09:00:00.000,2021-09-16 10:11:33.897
9580,57,4925,인천,29,28,1,8204,2021-03-26 09:00:00.000,2021-09-16 10:11:33.897
9581,21,2197,광주,3,2,1,8203,2021-03-26 09:00:00.000,2021-09-16 10:11:33.897
9582,16,1248,대전,14,13,1,8202,2021-03-26 09:00:00.000,2021-09-16 10:11:33.897
9583,37,1128,울산,0,0,0,8201,2021-03-26 09:00:00.000,2021-09-16 10:11:33.897
9584,1,250,세종,0,0,0,8200,2021-03-26 09:00:00.000,2021-09-16 10:11:33.897
9585,533,27922,경기,196,187,9,8199,2021-03-26 09:00:00.000,2021-09-16 10:11:33.897
9586,44,2240,강원,24,24,0,8198,2021-03-26 09:00:00.000,2021-09-16 10:11:33.897
9587,60,2074,충북,13,9,4,8197,2021-03-26 09:00:00.000,2021-09-16 10:11:33.897
9588,35,2607,충남,3,2,1,8196,2021-03-26 09:00:00.000,2021-09-16 10:11:33.897
9589,56,1388,전북,3,3,0,8195,2021-03-26 09:00:00.000,2021-09-16 10:11:33.897
9590,8,911,전남,2,2,0,8194,2021-03-26 09:00:00.000,2021-09-16 10:11:33.897
9591,75,3472,경북,13,12,1,8193,2021-03-26 09:00:00.000,2021-09-16 10:11:33.897
9592,14,2870,경남,37,37,0,8192,2021-03-26 09:00:00.000,2021-09-16 10:11:33.897
9593,1,620,제주,3,2,1,8191,2021-03-26 09:00:00.000,2021-09-16 10:11:33.897
9594,4,3132,검역,3,0,3,8190,2021-03-26 09:00:00.000,2021-09-16 10:11:33.897
9595,1709,100268,합계,430,419,11,8189,2021-03-25 09:00:00.000,2021-09-16 10:11:33.897
9596,418,31233,서울,127,125,2,8188,2021-03-25 09:00:00.000,2021-09-16 10:11:33.897
9597,116,3551,부산,20,20,0,8187,2021-03-25 09:00:00.000,2021-09-16 10:11:33.897
9598,216,8843,대구,17,17,0,8186,2021-03-25 09:00:00.000,2021-09-16 10:11:33.897
9599,57,4896,인천,12,11,1,8185,2021-03-25 09:00:00.000,2021-09-16 10:11:33.897
9600,21,2194,광주,5,4,1,8184,2021-03-25 09:00:00.000,2021-09-16 10:11:33.897
9601,16,1234,대전,3,3,0,8183,2021-03-25 09:00:00.000,2021-09-16 10:11:33.897
9602,37,1128,울산,0,0,0,8182,2021-03-25 09:00:00.000,2021-09-16 10:11:33.897
9603,1,250,세종,0,0,0,8181,2021-03-25 09:00:00.000,2021-09-16 10:11:33.897
9604,530,27726,경기,147,147,0,8180,2021-03-25 09:00:00.000,2021-09-16 10:11:33.897
9605,44,2216,강원,27,27,0,8179,2021-03-25 09:00:00.000,2021-09-16 10:11:33.897
9606,60,2061,충북,17,17,0,8178,2021-03-25 09:00:00.000,2021-09-16 10:11:33.897
9607,35,2604,충남,4,4,0,8177,2021-03-25 09:00:00.000,2021-09-16 10:11:33.897
9608,56,1385,전북,5,4,1,8176,2021-03-25 09:00:00.000,2021-09-16 10:11:33.897
9609,8,909,전남,1,1,0,8175,2021-03-25 09:00:00.000,2021-09-16 10:11:33.897
9610,75,3459,경북,10,9,1,8174,2021-03-25 09:00:00.000,2021-09-16 10:11:33.897
9611,14,2833,경남,30,30,0,8173,2021-03-25 09:00:00.000,2021-09-16 10:11:33.897
9612,1,617,제주,0,0,0,8172,2021-03-25 09:00:00.000,2021-09-16 10:11:33.897
9613,4,3129,검역,5,0,5,8171,2021-03-25 09:00:00.000,2021-09-16 10:11:33.897
9614,1707,99838,합계,428,411,17,8170,2021-03-24 09:00:00.000,2021-09-16 10:11:33.897
9615,417,31106,서울,137,135,2,8169,2021-03-24 09:00:00.000,2021-09-16 10:11:33.897
9616,116,3531,부산,17,16,1,8168,2021-03-24 09:00:00.000,2021-09-16 10:11:33.897
9617,216,8826,대구,17,17,0,8167,2021-03-24 09:00:00.000,2021-09-16 10:11:33.897
9618,57,4884,인천,21,21,0,8166,2021-03-24 09:00:00.000,2021-09-16 10:11:33.897
9619,21,2189,광주,2,2,0,8165,2021-03-24 09:00:00.000,2021-09-16 10:11:33.897
9620,16,1231,대전,2,2,0,8164,2021-03-24 09:00:00.000,2021-09-16 10:11:33.897
9621,37,1128,울산,2,1,1,8163,2021-03-24 09:00:00.000,2021-09-16 10:11:33.897
9622,1,250,세종,0,0,0,8162,2021-03-24 09:00:00.000,2021-09-16 10:11:33.897
9623,530,27579,경기,154,150,4,8161,2021-03-24 09:00:00.000,2021-09-16 10:11:33.897
9624,43,2189,강원,18,18,0,8160,2021-03-24 09:00:00.000,2021-09-16 10:11:33.897
9625,60,2044,충북,6,6,0,8159,2021-03-24 09:00:00.000,2021-09-16 10:11:33.897
9626,35,2600,충남,0,0,0,8158,2021-03-24 09:00:00.000,2021-09-16 10:11:33.897
9627,56,1380,전북,5,4,1,8157,2021-03-24 09:00:00.000,2021-09-16 10:11:33.897
9628,8,908,전남,0,0,0,8156,2021-03-24 09:00:00.000,2021-09-16 10:11:33.897
9629,75,3449,경북,12,12,0,8155,2021-03-24 09:00:00.000,2021-09-16 10:11:33.897
9630,14,2803,경남,27,27,0,8154,2021-03-24 09:00:00.000,2021-09-16 10:11:33.897
9631,1,617,제주,0,0,0,8153,2021-03-24 09:00:00.000,2021-09-16 10:11:33.897
9632,4,3124,검역,8,0,8,8152,2021-03-24 09:00:00.000,2021-09-16 10:11:33.897
9633,1704,99410,합계,346,331,15,8151,2021-03-23 09:00:00.000,2021-09-16 10:11:33.897
9634,415,30969,서울,97,97,0,8150,2021-03-23 09:00:00.000,2021-09-16 10:11:33.897
9635,116,3514,부산,8,8,0,8149,2021-03-23 09:00:00.000,2021-09-16 10:11:33.897
9636,216,8809,대구,3,3,0,8148,2021-03-23 09:00:00.000,2021-09-16 10:11:33.897
9637,57,4863,인천,13,12,1,8147,2021-03-23 09:00:00.000,2021-09-16 10:11:33.897
9638,21,2187,광주,1,1,0,8146,2021-03-23 09:00:00.000,2021-09-16 10:11:33.897
9639,15,1229,대전,4,4,0,8145,2021-03-23 09:00:00.000,2021-09-16 10:11:33.897
9640,37,1126,울산,8,8,0,8144,2021-03-23 09:00:00.000,2021-09-16 10:11:33.897
9641,1,250,세종,0,0,0,8143,2021-03-23 09:00:00.000,2021-09-16 10:11:33.897
9642,530,27425,경기,124,120,4,8142,2021-03-23 09:00:00.000,2021-09-16 10:11:33.897
9643,43,2171,강원,9,9,0,8141,2021-03-23 09:00:00.000,2021-09-16 10:11:33.897
9644,60,2038,충북,6,6,0,8140,2021-03-23 09:00:00.000,2021-09-16 10:11:33.897
9645,35,2600,충남,8,7,1,8139,2021-03-23 09:00:00.000,2021-09-16 10:11:33.897
9646,56,1375,전북,7,7,0,8138,2021-03-23 09:00:00.000,2021-09-16 10:11:33.897
9647,8,908,전남,1,1,0,8137,2021-03-23 09:00:00.000,2021-09-16 10:11:33.897
9648,75,3437,경북,20,19,1,8136,2021-03-23 09:00:00.000,2021-09-16 10:11:33.897
9649,14,2776,경남,29,29,0,8135,2021-03-23 09:00:00.000,2021-09-16 10:11:33.897
9650,1,617,제주,0,0,0,8134,2021-03-23 09:00:00.000,2021-09-16 10:11:33.897
9651,4,3116,검역,8,0,8,8133,2021-03-23 09:00:00.000,2021-09-16 10:11:33.897
9652,1697,99064,합계,415,396,19,8132,2021-03-22 09:00:00.000,2021-09-16 10:11:33.897
9653,415,30872,서울,109,108,1,8131,2021-03-22 09:00:00.000,2021-09-16 10:11:33.897
9654,115,3506,부산,26,24,2,8130,2021-03-22 09:00:00.000,2021-09-16 10:11:33.897
9655,215,8806,대구,14,14,0,8129,2021-03-22 09:00:00.000,2021-09-16 10:11:33.897
9656,56,4850,인천,10,10,0,8128,2021-03-22 09:00:00.000,2021-09-16 10:11:33.897
9657,21,2186,광주,2,2,0,8127,2021-03-22 09:00:00.000,2021-09-16 10:11:33.897
9658,15,1225,대전,0,0,0,8126,2021-03-22 09:00:00.000,2021-09-16 10:11:33.897
9659,37,1118,울산,1,1,0,8125,2021-03-22 09:00:00.000,2021-09-16 10:11:33.897
9660,1,250,세종,0,0,0,8124,2021-03-22 09:00:00.000,2021-09-16 10:11:33.897
9661,526,27301,경기,151,143,8,8123,2021-03-22 09:00:00.000,2021-09-16 10:11:33.897
9662,43,2162,강원,21,21,0,8122,2021-03-22 09:00:00.000,2021-09-16 10:11:33.897
9663,60,2032,충북,5,5,0,8121,2021-03-22 09:00:00.000,2021-09-16 10:11:33.897
9664,35,2592,충남,11,11,0,8120,2021-03-22 09:00:00.000,2021-09-16 10:11:33.897
9665,56,1368,전북,7,7,0,8119,2021-03-22 09:00:00.000,2021-09-16 10:11:33.897
9666,8,907,전남,2,2,0,8118,2021-03-22 09:00:00.000,2021-09-16 10:11:33.897
9667,75,3417,경북,11,10,1,8117,2021-03-22 09:00:00.000,2021-09-16 10:11:33.897
9668,14,2747,경남,37,37,0,8116,2021-03-22 09:00:00.000,2021-09-16 10:11:33.897
9669,1,617,제주,1,1,0,8115,2021-03-22 09:00:00.000,2021-09-16 10:11:33.897
9670,4,3108,검역,7,0,7,8114,2021-03-22 09:00:00.000,2021-09-16 10:11:33.897
9671,1696,98649,합계,456,437,19,8113,2021-03-21 09:00:00.000,2021-09-16 10:11:33.897
9672,414,30763,서울,125,124,1,8112,2021-03-21 09:00:00.000,2021-09-16 10:11:33.897
9673,115,3480,부산,19,18,1,8111,2021-03-21 09:00:00.000,2021-09-16 10:11:33.897
9674,215,8792,대구,14,12,2,8110,2021-03-21 09:00:00.000,2021-09-16 10:11:33.897
9675,56,4840,인천,22,20,2,8109,2021-03-21 09:00:00.000,2021-09-16 10:11:33.897
9676,21,2184,광주,2,2,0,8108,2021-03-21 09:00:00.000,2021-09-16 10:11:33.897
9677,15,1225,대전,1,1,0,8107,2021-03-21 09:00:00.000,2021-09-16 10:11:33.897
9678,37,1117,울산,7,7,0,8106,2021-03-21 09:00:00.000,2021-09-16 10:11:33.897
9679,1,250,세종,0,0,0,8105,2021-03-21 09:00:00.000,2021-09-16 10:11:33.897
9680,526,27150,경기,157,155,2,8104,2021-03-21 09:00:00.000,2021-09-16 10:11:33.897
9681,43,2141,강원,14,13,1,8103,2021-03-21 09:00:00.000,2021-09-16 10:11:33.897
9682,60,2027,충북,10,10,0,8102,2021-03-21 09:00:00.000,2021-09-16 10:11:33.897
9683,35,2581,충남,5,5,0,8101,2021-03-21 09:00:00.000,2021-09-16 10:11:33.897
9684,56,1361,전북,11,10,1,8100,2021-03-21 09:00:00.000,2021-09-16 10:11:33.897
9685,8,905,전남,0,0,0,8099,2021-03-21 09:00:00.000,2021-09-16 10:11:33.897
9686,75,3406,경북,5,5,0,8098,2021-03-21 09:00:00.000,2021-09-16 10:11:33.897
9687,14,2710,경남,54,54,0,8097,2021-03-21 09:00:00.000,2021-09-16 10:11:33.897
9688,1,616,제주,1,1,0,8096,2021-03-21 09:00:00.000,2021-09-16 10:11:33.897
9689,4,3101,검역,9,0,9,8095,2021-03-21 09:00:00.000,2021-09-16 10:11:33.897
9690,1693,98193,합계,447,435,12,8094,2021-03-20 09:00:00.000,2021-09-16 10:11:33.897
9691,413,30638,서울,115,114,1,8093,2021-03-20 09:00:00.000,2021-09-16 10:11:33.897
9692,115,3461,부산,9,9,0,8092,2021-03-20 09:00:00.000,2021-09-16 10:11:33.897
9693,215,8778,대구,16,16,0,8091,2021-03-20 09:00:00.000,2021-09-16 10:11:33.897
9694,56,4818,인천,12,11,1,8090,2021-03-20 09:00:00.000,2021-09-16 10:11:33.897
9695,21,2182,광주,1,0,1,8089,2021-03-20 09:00:00.000,2021-09-16 10:11:33.897
9696,15,1224,대전,8,8,0,8088,2021-03-20 09:00:00.000,2021-09-16 10:11:33.897
9697,37,1110,울산,3,3,0,8087,2021-03-20 09:00:00.000,2021-09-16 10:11:33.897
9698,1,250,세종,0,0,0,8086,2021-03-20 09:00:00.000,2021-09-16 10:11:33.897
9699,524,26993,경기,189,187,2,8085,2021-03-20 09:00:00.000,2021-09-16 10:11:33.897
9700,43,2127,강원,17,17,0,8084,2021-03-20 09:00:00.000,2021-09-16 10:11:33.897
9701,60,2017,충북,8,8,0,8083,2021-03-20 09:00:00.000,2021-09-16 10:11:33.897
9702,35,2576,충남,6,5,1,8082,2021-03-20 09:00:00.000,2021-09-16 10:11:33.897
9703,56,1350,전북,16,14,2,8081,2021-03-20 09:00:00.000,2021-09-16 10:11:33.897
9704,8,905,전남,0,0,0,8080,2021-03-20 09:00:00.000,2021-09-16 10:11:33.897
9705,75,3401,경북,11,11,0,8079,2021-03-20 09:00:00.000,2021-09-16 10:11:33.897
9706,14,2656,경남,31,31,0,8078,2021-03-20 09:00:00.000,2021-09-16 10:11:33.897
9707,1,615,제주,1,1,0,8077,2021-03-20 09:00:00.000,2021-09-16 10:11:33.897
9708,4,3092,검역,4,0,4,8076,2021-03-20 09:00:00.000,2021-09-16 10:11:33.897
9709,1690,97746,합계,463,441,22,8075,2021-03-19 09:00:00.000,2021-09-16 10:11:33.897
9710,413,30523,서울,146,144,2,8074,2021-03-19 09:00:00.000,2021-09-16 10:11:33.897
9711,115,3452,부산,7,6,1,8073,2021-03-19 09:00:00.000,2021-09-16 10:11:33.897
9712,215,8762,대구,5,4,1,8072,2021-03-19 09:00:00.000,2021-09-16 10:11:33.897
9713,56,4806,인천,24,23,1,8071,2021-03-19 09:00:00.000,2021-09-16 10:11:33.897
9714,21,2181,광주,2,2,0,8070,2021-03-19 09:00:00.000,2021-09-16 10:11:33.897
9715,15,1216,대전,7,7,0,8069,2021-03-19 09:00:00.000,2021-09-16 10:11:33.897
9716,37,1107,울산,3,2,1,8068,2021-03-19 09:00:00.000,2021-09-16 10:11:33.897
9717,1,250,세종,0,0,0,8067,2021-03-19 09:00:00.000,2021-09-16 10:11:33.897
9718,523,26804,경기,157,153,4,8066,2021-03-19 09:00:00.000,2021-09-16 10:11:33.897
9719,43,2110,강원,31,30,1,8065,2021-03-19 09:00:00.000,2021-09-16 10:11:33.897
9720,60,2009,충북,8,6,2,8064,2021-03-19 09:00:00.000,2021-09-16 10:11:33.897
9721,35,2570,충남,5,3,2,8063,2021-03-19 09:00:00.000,2021-09-16 10:11:33.897
9722,56,1334,전북,15,15,0,8062,2021-03-19 09:00:00.000,2021-09-16 10:11:33.897
9723,8,905,전남,0,0,0,8061,2021-03-19 09:00:00.000,2021-09-16 10:11:33.897
9724,73,3390,경북,4,4,0,8060,2021-03-19 09:00:00.000,2021-09-16 10:11:33.897
9725,14,2625,경남,42,42,0,8059,2021-03-19 09:00:00.000,2021-09-16 10:11:33.897
9726,1,614,제주,0,0,0,8058,2021-03-19 09:00:00.000,2021-09-16 10:11:33.897
9727,4,3088,검역,7,0,7,8057,2021-03-19 09:00:00.000,2021-09-16 10:11:33.897
9728,1688,97283,합계,445,427,18,8056,2021-03-18 09:00:00.000,2021-09-16 10:11:33.897
9729,412,30377,서울,124,124,0,8055,2021-03-18 09:00:00.000,2021-09-16 10:11:33.897
9730,115,3445,부산,7,7,0,8054,2021-03-18 09:00:00.000,2021-09-16 10:11:33.897
9731,215,8757,대구,14,13,1,8053,2021-03-18 09:00:00.000,2021-09-16 10:11:33.897
9732,56,4782,인천,21,20,1,8052,2021-03-18 09:00:00.000,2021-09-16 10:11:33.897
9733,21,2179,광주,1,0,1,8051,2021-03-18 09:00:00.000,2021-09-16 10:11:33.897
9734,15,1209,대전,2,2,0,8050,2021-03-18 09:00:00.000,2021-09-16 10:11:33.897
9735,37,1104,울산,5,5,0,8049,2021-03-18 09:00:00.000,2021-09-16 10:11:33.897
9736,1,250,세종,1,1,0,8048,2021-03-18 09:00:00.000,2021-09-16 10:11:33.897
9737,523,26647,경기,159,155,4,8047,2021-03-18 09:00:00.000,2021-09-16 10:11:33.897
9738,42,2079,강원,23,23,0,8046,2021-03-18 09:00:00.000,2021-09-16 10:11:33.897
9739,60,2001,충북,8,8,0,8045,2021-03-18 09:00:00.000,2021-09-16 10:11:33.897
9740,35,2565,충남,14,13,1,8044,2021-03-18 09:00:00.000,2021-09-16 10:11:33.897
9741,56,1319,전북,15,15,0,8043,2021-03-18 09:00:00.000,2021-09-16 10:11:33.897
9742,8,905,전남,0,0,0,8042,2021-03-18 09:00:00.000,2021-09-16 10:11:33.897
9743,73,3386,경북,5,5,0,8041,2021-03-18 09:00:00.000,2021-09-16 10:11:33.897
9744,14,2583,경남,35,35,0,8040,2021-03-18 09:00:00.000,2021-09-16 10:11:33.897
9745,1,614,제주,2,1,1,8039,2021-03-18 09:00:00.000,2021-09-16 10:11:33.897
9746,4,3081,검역,9,0,9,8038,2021-03-18 09:00:00.000,2021-09-16 10:11:33.897
9747,1686,96838,합계,469,452,17,8037,2021-03-17 09:00:00.000,2021-09-16 10:11:33.897
9748,412,30253,서울,120,120,0,8036,2021-03-17 09:00:00.000,2021-09-16 10:11:33.897
9749,115,3438,부산,11,10,1,8035,2021-03-17 09:00:00.000,2021-09-16 10:11:33.897
9750,215,8743,대구,14,14,0,8034,2021-03-17 09:00:00.000,2021-09-16 10:11:33.897
9751,56,4761,인천,21,21,0,8033,2021-03-17 09:00:00.000,2021-09-16 10:11:33.897
9752,21,2178,광주,1,0,1,8032,2021-03-17 09:00:00.000,2021-09-16 10:11:33.897
9753,15,1207,대전,1,1,0,8031,2021-03-17 09:00:00.000,2021-09-16 10:11:33.897
9754,37,1099,울산,4,3,1,8030,2021-03-17 09:00:00.000,2021-09-16 10:11:33.897
9755,1,249,세종,3,2,1,8029,2021-03-17 09:00:00.000,2021-09-16 10:11:33.897
9756,521,26488,경기,186,182,4,8028,2021-03-17 09:00:00.000,2021-09-16 10:11:33.897
9757,42,2056,강원,10,10,0,8027,2021-03-17 09:00:00.000,2021-09-16 10:11:33.897
9758,60,1993,충북,12,12,0,8026,2021-03-17 09:00:00.000,2021-09-16 10:11:33.897
9759,35,2551,충남,6,6,0,8025,2021-03-17 09:00:00.000,2021-09-16 10:11:33.897
9760,56,1304,전북,21,21,0,8024,2021-03-17 09:00:00.000,2021-09-16 10:11:33.897
9761,8,905,전남,0,0,0,8023,2021-03-17 09:00:00.000,2021-09-16 10:11:33.897
9762,73,3381,경북,4,4,0,8022,2021-03-17 09:00:00.000,2021-09-16 10:11:33.897
9763,14,2548,경남,45,45,0,8021,2021-03-17 09:00:00.000,2021-09-16 10:11:33.897
9764,1,612,제주,1,1,0,8020,2021-03-17 09:00:00.000,2021-09-16 10:11:33.897
9765,4,3072,검역,9,0,9,8019,2021-03-17 09:00:00.000,2021-09-16 10:11:33.897
9766,1678,96369,합계,363,345,18,8018,2021-03-16 09:00:00.000,2021-09-16 10:11:33.897
9767,409,30133,서울,79,75,4,8017,2021-03-16 09:00:00.000,2021-09-16 10:11:33.897
9768,114,3427,부산,7,6,1,8016,2021-03-16 09:00:00.000,2021-09-16 10:11:33.897
9769,215,8729,대구,3,3,0,8015,2021-03-16 09:00:00.000,2021-09-16 10:11:33.897
9770,56,4740,인천,14,14,0,8014,2021-03-16 09:00:00.000,2021-09-16 10:11:33.897
9771,21,2177,광주,2,1,1,8013,2021-03-16 09:00:00.000,2021-09-16 10:11:33.897
9772,15,1206,대전,1,1,0,8012,2021-03-16 09:00:00.000,2021-09-16 10:11:33.897
9773,37,1095,울산,3,3,0,8011,2021-03-16 09:00:00.000,2021-09-16 10:11:33.897
9774,1,246,세종,0,0,0,8010,2021-03-16 09:00:00.000,2021-09-16 10:11:33.897
9775,518,26302,경기,148,146,2,8009,2021-03-16 09:00:00.000,2021-09-16 10:11:33.897
9776,42,2046,강원,13,12,1,8008,2021-03-16 09:00:00.000,2021-09-16 10:11:33.897
9777,60,1981,충북,3,3,0,8007,2021-03-16 09:00:00.000,2021-09-16 10:11:33.897
9778,35,2545,충남,4,4,0,8006,2021-03-16 09:00:00.000,2021-09-16 10:11:33.897
9779,56,1283,전북,7,6,1,8005,2021-03-16 09:00:00.000,2021-09-16 10:11:33.897
9780,8,905,전남,1,1,0,8004,2021-03-16 09:00:00.000,2021-09-16 10:11:33.897
9781,72,3377,경북,4,4,0,8003,2021-03-16 09:00:00.000,2021-09-16 10:11:33.897
9782,14,2503,경남,65,64,1,8002,2021-03-16 09:00:00.000,2021-09-16 10:11:33.897
9783,1,611,제주,2,2,0,8001,2021-03-16 09:00:00.000,2021-09-16 10:11:33.897
9784,4,3063,검역,7,0,7,8000,2021-03-16 09:00:00.000,2021-09-16 10:11:33.897
9785,1675,96006,합계,379,367,12,7999,2021-03-15 09:00:00.000,2021-09-16 10:11:33.897
9786,407,30054,서울,109,109,0,7998,2021-03-15 09:00:00.000,2021-09-16 10:11:33.897
9787,114,3420,부산,4,4,0,7997,2021-03-15 09:00:00.000,2021-09-16 10:11:33.897
9788,215,8726,대구,5,4,1,7996,2021-03-15 09:00:00.000,2021-09-16 10:11:33.897
9789,56,4726,인천,18,18,0,7995,2021-03-15 09:00:00.000,2021-09-16 10:11:33.897
9790,21,2175,광주,1,1,0,7994,2021-03-15 09:00:00.000,2021-09-16 10:11:33.897
9791,15,1205,대전,2,2,0,7993,2021-03-15 09:00:00.000,2021-09-16 10:11:33.897
9792,37,1092,울산,2,1,1,7992,2021-03-15 09:00:00.000,2021-09-16 10:11:33.897
9793,1,246,세종,2,2,0,7991,2021-03-15 09:00:00.000,2021-09-16 10:11:33.897
9794,517,26154,경기,161,161,0,7990,2021-03-15 09:00:00.000,2021-09-16 10:11:33.897
9795,42,2033,강원,10,10,0,7989,2021-03-15 09:00:00.000,2021-09-16 10:11:33.897
9796,60,1978,충북,9,9,0,7988,2021-03-15 09:00:00.000,2021-09-16 10:11:33.897
9797,35,2541,충남,6,5,1,7987,2021-03-15 09:00:00.000,2021-09-16 10:11:33.897
9798,56,1276,전북,5,4,1,7986,2021-03-15 09:00:00.000,2021-09-16 10:11:33.897
9799,8,904,전남,1,0,1,7985,2021-03-15 09:00:00.000,2021-09-16 10:11:33.897
9800,72,3373,경북,3,3,0,7984,2021-03-15 09:00:00.000,2021-09-16 10:11:33.897
9801,14,2438,경남,31,31,0,7983,2021-03-15 09:00:00.000,2021-09-16 10:11:33.897
9802,1,609,제주,3,3,0,7982,2021-03-15 09:00:00.000,2021-09-16 10:11:33.897
9803,4,3056,검역,7,0,7,7981,2021-03-15 09:00:00.000,2021-09-16 10:11:33.897
9804,1669,95627,합계,459,436,23,7980,2021-03-14 09:00:00.000,2021-09-16 10:11:33.897
9805,404,29945,서울,112,108,4,7979,2021-03-14 09:00:00.000,2021-09-16 10:11:33.897
9806,114,3416,부산,13,13,0,7978,2021-03-14 09:00:00.000,2021-09-16 10:11:33.897
9807,215,8721,대구,6,4,2,7977,2021-03-14 09:00:00.000,2021-09-16 10:11:33.897
9808,55,4708,인천,20,19,1,7976,2021-03-14 09:00:00.000,2021-09-16 10:11:33.897
9809,21,2174,광주,1,1,0,7975,2021-03-14 09:00:00.000,2021-09-16 10:11:33.897
9810,15,1203,대전,0,0,0,7974,2021-03-14 09:00:00.000,2021-09-16 10:11:33.897
9811,37,1090,울산,1,1,0,7973,2021-03-14 09:00:00.000,2021-09-16 10:11:33.897
9812,1,244,세종,0,0,0,7972,2021-03-14 09:00:00.000,2021-09-16 10:11:33.897
9813,515,25993,경기,203,199,4,7971,2021-03-14 09:00:00.000,2021-09-16 10:11:33.897
9814,42,2023,강원,16,16,0,7970,2021-03-14 09:00:00.000,2021-09-16 10:11:33.897
9815,60,1969,충북,7,7,0,7969,2021-03-14 09:00:00.000,2021-09-16 10:11:33.897
9816,35,2535,충남,2,1,1,7968,2021-03-14 09:00:00.000,2021-09-16 10:11:33.897
9817,56,1271,전북,7,5,2,7967,2021-03-14 09:00:00.000,2021-09-16 10:11:33.897
9818,8,903,전남,2,2,0,7966,2021-03-14 09:00:00.000,2021-09-16 10:11:33.897
9819,72,3370,경북,9,7,2,7965,2021-03-14 09:00:00.000,2021-09-16 10:11:33.897
9820,14,2407,경남,53,52,1,7964,2021-03-14 09:00:00.000,2021-09-16 10:11:33.897
9821,1,606,제주,1,1,0,7963,2021-03-14 09:00:00.000,2021-09-16 10:11:33.897
9822,4,3049,검역,6,0,6,7962,2021-03-14 09:00:00.000,2021-09-16 10:11:33.897
9823,1667,95168,합계,490,474,16,7961,2021-03-13 09:00:00.000,2021-09-16 10:11:33.897
9824,403,29833,서울,140,138,2,7960,2021-03-13 09:00:00.000,2021-09-16 10:11:33.897
9825,113,3403,부산,17,17,0,7959,2021-03-13 09:00:00.000,2021-09-16 10:11:33.897
9826,215,8715,대구,9,9,0,7958,2021-03-13 09:00:00.000,2021-09-16 10:11:33.897
9827,55,4688,인천,26,26,0,7957,2021-03-13 09:00:00.000,2021-09-16 10:11:33.897
9828,21,2173,광주,3,2,1,7956,2021-03-13 09:00:00.000,2021-09-16 10:11:33.897
9829,15,1203,대전,1,1,0,7955,2021-03-13 09:00:00.000,2021-09-16 10:11:33.897
9830,37,1089,울산,1,1,0,7954,2021-03-13 09:00:00.000,2021-09-16 10:11:33.897
9831,1,244,세종,0,0,0,7953,2021-03-13 09:00:00.000,2021-09-16 10:11:33.897
9832,515,25790,경기,164,160,4,7952,2021-03-13 09:00:00.000,2021-09-16 10:11:33.897
9833,42,2007,강원,18,18,0,7951,2021-03-13 09:00:00.000,2021-09-16 10:11:33.897
9834,60,1962,충북,16,16,0,7950,2021-03-13 09:00:00.000,2021-09-16 10:11:33.897
9835,35,2533,충남,9,9,0,7949,2021-03-13 09:00:00.000,2021-09-16 10:11:33.897
9836,56,1264,전북,2,2,0,7948,2021-03-13 09:00:00.000,2021-09-16 10:11:33.897
9837,8,901,전남,1,1,0,7947,2021-03-13 09:00:00.000,2021-09-16 10:11:33.897
9838,72,3361,경북,14,12,2,7946,2021-03-13 09:00:00.000,2021-09-16 10:11:33.897
9839,14,2354,경남,62,61,1,7945,2021-03-13 09:00:00.000,2021-09-16 10:11:33.897
9840,1,605,제주,1,1,0,7944,2021-03-13 09:00:00.000,2021-09-16 10:11:33.897
9841,4,3043,검역,6,0,6,7943,2021-03-13 09:00:00.000,2021-09-16 10:11:33.897
9842,1662,94678,합계,488,467,21,7942,2021-03-12 09:00:00.000,2021-09-16 10:11:33.897
9843,400,29693,서울,140,138,2,7941,2021-03-12 09:00:00.000,2021-09-16 10:11:33.897
9844,113,3386,부산,15,14,1,7940,2021-03-12 09:00:00.000,2021-09-16 10:11:33.897
9845,214,8706,대구,4,4,0,7939,2021-03-12 09:00:00.000,2021-09-16 10:11:33.897
9846,55,4662,인천,31,29,2,7938,2021-03-12 09:00:00.000,2021-09-16 10:11:33.897
9847,21,2170,광주,2,2,0,7937,2021-03-12 09:00:00.000,2021-09-16 10:11:33.897
9848,15,1202,대전,0,0,0,7936,2021-03-12 09:00:00.000,2021-09-16 10:11:33.897
9849,37,1088,울산,5,4,1,7935,2021-03-12 09:00:00.000,2021-09-16 10:11:33.897
9850,1,244,세종,2,2,0,7934,2021-03-12 09:00:00.000,2021-09-16 10:11:33.897
9851,514,25626,경기,166,157,9,7933,2021-03-12 09:00:00.000,2021-09-16 10:11:33.897
9852,42,1989,강원,12,12,0,7932,2021-03-12 09:00:00.000,2021-09-16 10:11:33.897
9853,60,1946,충북,27,27,0,7931,2021-03-12 09:00:00.000,2021-09-16 10:11:33.897
9854,35,2524,충남,3,3,0,7930,2021-03-12 09:00:00.000,2021-09-16 10:11:33.897
9855,56,1262,전북,4,4,0,7929,2021-03-12 09:00:00.000,2021-09-16 10:11:33.897
9856,8,900,전남,4,4,0,7928,2021-03-12 09:00:00.000,2021-09-16 10:11:33.897
9857,72,3347,경북,9,9,0,7927,2021-03-12 09:00:00.000,2021-09-16 10:11:33.897
9858,14,2292,경남,56,56,0,7926,2021-03-12 09:00:00.000,2021-09-16 10:11:33.897
9859,1,604,제주,2,2,0,7925,2021-03-12 09:00:00.000,2021-09-16 10:11:33.897
9860,4,3037,검역,6,0,6,7924,2021-03-12 09:00:00.000,2021-09-16 10:11:33.897
9861,1652,94190,합계,465,444,21,7923,2021-03-11 09:00:00.000,2021-09-16 10:11:33.897
9862,399,29553,서울,138,137,1,7922,2021-03-11 09:00:00.000,2021-09-16 10:11:33.897
9863,110,3371,부산,14,13,1,7921,2021-03-11 09:00:00.000,2021-09-16 10:11:33.897
9864,214,8702,대구,4,4,0,7920,2021-03-11 09:00:00.000,2021-09-16 10:11:33.897
9865,54,4631,인천,18,18,0,7919,2021-03-11 09:00:00.000,2021-09-16 10:11:33.897
9866,21,2168,광주,1,1,0,7918,2021-03-11 09:00:00.000,2021-09-16 10:11:33.897
9867,15,1202,대전,1,1,0,7917,2021-03-11 09:00:00.000,2021-09-16 10:11:33.897
9868,37,1083,울산,23,23,0,7916,2021-03-11 09:00:00.000,2021-09-16 10:11:33.897
9869,1,242,세종,0,0,0,7915,2021-03-11 09:00:00.000,2021-09-16 10:11:33.897
9870,510,25460,경기,184,178,6,7914,2021-03-11 09:00:00.000,2021-09-16 10:11:33.897
9871,42,1977,강원,30,30,0,7913,2021-03-11 09:00:00.000,2021-09-16 10:11:33.897
9872,60,1919,충북,6,6,0,7912,2021-03-11 09:00:00.000,2021-09-16 10:11:33.897
9873,35,2521,충남,4,4,0,7911,2021-03-11 09:00:00.000,2021-09-16 10:11:33.897
9874,56,1258,전북,8,7,1,7910,2021-03-11 09:00:00.000,2021-09-16 10:11:33.897
9875,8,896,전남,3,3,0,7909,2021-03-11 09:00:00.000,2021-09-16 10:11:33.897
9876,71,3338,경북,11,10,1,7908,2021-03-11 09:00:00.000,2021-09-16 10:11:33.897
9877,14,2236,경남,8,7,1,7907,2021-03-11 09:00:00.000,2021-09-16 10:11:33.897
9878,1,602,제주,2,2,0,7906,2021-03-11 09:00:00.000,2021-09-16 10:11:33.897
9879,4,3031,검역,10,0,10,7905,2021-03-11 09:00:00.000,2021-09-16 10:11:33.897
9880,1648,93725,합계,470,452,18,7904,2021-03-10 09:00:00.000,2021-09-16 10:11:33.897
9881,398,29415,서울,138,132,6,7903,2021-03-10 09:00:00.000,2021-09-16 10:11:33.897
9882,110,3357,부산,7,7,0,7902,2021-03-10 09:00:00.000,2021-09-16 10:11:33.897
9883,214,8698,대구,1,1,0,7901,2021-03-10 09:00:00.000,2021-09-16 10:11:33.897
9884,54,4613,인천,23,23,0,7900,2021-03-10 09:00:00.000,2021-09-16 10:11:33.897
9885,21,2167,광주,1,1,0,7899,2021-03-10 09:00:00.000,2021-09-16 10:11:33.897
9886,15,1201,대전,3,3,0,7898,2021-03-10 09:00:00.000,2021-09-16 10:11:33.897
9887,37,1060,울산,21,21,0,7897,2021-03-10 09:00:00.000,2021-09-16 10:11:33.897
9888,1,242,세종,0,0,0,7896,2021-03-10 09:00:00.000,2021-09-16 10:11:33.897
9889,508,25276,경기,203,199,4,7895,2021-03-10 09:00:00.000,2021-09-16 10:11:33.897
9890,42,1947,강원,20,20,0,7894,2021-03-10 09:00:00.000,2021-09-16 10:11:33.897
9891,59,1913,충북,21,18,3,7893,2021-03-10 09:00:00.000,2021-09-16 10:11:33.897
9892,35,2517,충남,6,6,0,7892,2021-03-10 09:00:00.000,2021-09-16 10:11:33.897
9893,56,1250,전북,5,5,0,7891,2021-03-10 09:00:00.000,2021-09-16 10:11:33.897
9894,8,893,전남,3,3,0,7890,2021-03-10 09:00:00.000,2021-09-16 10:11:33.897
9895,71,3327,경북,4,4,0,7889,2021-03-10 09:00:00.000,2021-09-16 10:11:33.897
9896,14,2228,경남,7,7,0,7888,2021-03-10 09:00:00.000,2021-09-16 10:11:33.897
9897,1,600,제주,2,2,0,7887,2021-03-10 09:00:00.000,2021-09-16 10:11:33.897
9898,4,3021,검역,5,0,5,7886,2021-03-10 09:00:00.000,2021-09-16 10:11:33.897
9899,1645,93255,합계,446,427,19,7885,2021-03-09 09:00:00.000,2021-09-16 10:11:33.897
9900,396,29277,서울,102,98,4,7884,2021-03-09 09:00:00.000,2021-09-16 10:11:33.897
9901,110,3350,부산,19,19,0,7883,2021-03-09 09:00:00.000,2021-09-16 10:11:33.897
9902,214,8697,대구,3,3,0,7882,2021-03-09 09:00:00.000,2021-09-16 10:11:33.897
9903,54,4590,인천,20,20,0,7881,2021-03-09 09:00:00.000,2021-09-16 10:11:33.897
9904,21,2166,광주,33,32,1,7880,2021-03-09 09:00:00.000,2021-09-16 10:11:33.897
9905,15,1198,대전,1,1,0,7879,2021-03-09 09:00:00.000,2021-09-16 10:11:33.897
9906,37,1039,울산,11,11,0,7878,2021-03-09 09:00:00.000,2021-09-16 10:11:33.897
9907,1,242,세종,0,0,0,7877,2021-03-09 09:00:00.000,2021-09-16 10:11:33.897
9908,508,25073,경기,188,181,7,7876,2021-03-09 09:00:00.000,2021-09-16 10:11:33.897
9909,42,1927,강원,13,13,0,7875,2021-03-09 09:00:00.000,2021-09-16 10:11:33.897
9910,58,1892,충북,21,21,0,7874,2021-03-09 09:00:00.000,2021-09-16 10:11:33.897
9911,35,2511,충남,15,14,1,7873,2021-03-09 09:00:00.000,2021-09-16 10:11:33.897
9912,56,1245,전북,8,7,1,7872,2021-03-09 09:00:00.000,2021-09-16 10:11:33.897
9913,8,890,전남,3,2,1,7871,2021-03-09 09:00:00.000,2021-09-16 10:11:33.897
9914,71,3323,경북,2,2,0,7870,2021-03-09 09:00:00.000,2021-09-16 10:11:33.897
9915,14,2221,경남,1,1,0,7869,2021-03-09 09:00:00.000,2021-09-16 10:11:33.897
9916,1,598,제주,2,2,0,7868,2021-03-09 09:00:00.000,2021-09-16 10:11:33.897
9917,4,3016,검역,4,0,4,7867,2021-03-09 09:00:00.000,2021-09-16 10:11:33.897
9918,1642,92809,합계,346,335,11,7866,2021-03-08 09:00:00.000,2021-09-16 10:11:33.897
9919,396,29175,서울,100,97,3,7865,2021-03-08 09:00:00.000,2021-09-16 10:11:33.897
9920,109,3331,부산,12,12,0,7864,2021-03-08 09:00:00.000,2021-09-16 10:11:33.897
9921,214,8694,대구,6,6,0,7863,2021-03-08 09:00:00.000,2021-09-16 10:11:33.897
9922,53,4570,인천,15,15,0,7862,2021-03-08 09:00:00.000,2021-09-16 10:11:33.897
9923,21,2133,광주,15,14,1,7861,2021-03-08 09:00:00.000,2021-09-16 10:11:33.897
9924,15,1197,대전,0,0,0,7860,2021-03-08 09:00:00.000,2021-09-16 10:11:33.897
9925,37,1028,울산,3,3,0,7859,2021-03-08 09:00:00.000,2021-09-16 10:11:33.897
9926,1,242,세종,1,1,0,7858,2021-03-08 09:00:00.000,2021-09-16 10:11:33.897
9927,507,24885,경기,128,128,0,7857,2021-03-08 09:00:00.000,2021-09-16 10:11:33.897
9928,42,1914,강원,10,10,0,7856,2021-03-08 09:00:00.000,2021-09-16 10:11:33.897
9929,58,1871,충북,20,20,0,7855,2021-03-08 09:00:00.000,2021-09-16 10:11:33.897
9930,35,2496,충남,14,14,0,7854,2021-03-08 09:00:00.000,2021-09-16 10:11:33.897
9931,56,1237,전북,4,4,0,7853,2021-03-08 09:00:00.000,2021-09-16 10:11:33.897
9932,8,887,전남,6,6,0,7852,2021-03-08 09:00:00.000,2021-09-16 10:11:33.897
9933,71,3321,경북,3,2,1,7851,2021-03-08 09:00:00.000,2021-09-16 10:11:33.897
9934,14,2220,경남,1,0,1,7850,2021-03-08 09:00:00.000,2021-09-16 10:11:33.897
9935,1,596,제주,3,3,0,7849,2021-03-08 09:00:00.000,2021-09-16 10:11:33.897
9936,4,3012,검역,5,0,5,7848,2021-03-08 09:00:00.000,2021-09-16 10:11:33.897
9937,1634,92463,합계,416,398,18,7847,2021-03-07 09:00:00.000,2021-09-16 10:11:33.897
9938,394,29075,서울,132,127,5,7846,2021-03-07 09:00:00.000,2021-09-16 10:11:33.897
9939,109,3319,부산,6,6,0,7845,2021-03-07 09:00:00.000,2021-09-16 10:11:33.897
9940,214,8688,대구,8,8,0,7844,2021-03-07 09:00:00.000,2021-09-16 10:11:33.897
9941,53,4555,인천,28,27,1,7843,2021-03-07 09:00:00.000,2021-09-16 10:11:33.897
9942,21,2118,광주,4,4,0,7842,2021-03-07 09:00:00.000,2021-09-16 10:11:33.897
9943,15,1197,대전,1,1,0,7841,2021-03-07 09:00:00.000,2021-09-16 10:11:33.897
9944,37,1025,울산,2,2,0,7840,2021-03-07 09:00:00.000,2021-09-16 10:11:33.897
9945,1,241,세종,2,2,0,7839,2021-03-07 09:00:00.000,2021-09-16 10:11:33.897
9946,502,24757,경기,172,168,4,7838,2021-03-07 09:00:00.000,2021-09-16 10:11:33.897
9947,42,1904,강원,10,10,0,7837,2021-03-07 09:00:00.000,2021-09-16 10:11:33.897
9948,58,1851,충북,9,8,1,7836,2021-03-07 09:00:00.000,2021-09-16 10:11:33.897
9949,35,2482,충남,6,6,0,7835,2021-03-07 09:00:00.000,2021-09-16 10:11:33.897
9950,55,1233,전북,5,5,0,7834,2021-03-07 09:00:00.000,2021-09-16 10:11:33.897
9951,8,881,전남,6,6,0,7833,2021-03-07 09:00:00.000,2021-09-16 10:11:33.897
9952,71,3318,경북,13,11,2,7832,2021-03-07 09:00:00.000,2021-09-16 10:11:33.897
9953,14,2219,경남,3,3,0,7831,2021-03-07 09:00:00.000,2021-09-16 10:11:33.897
9954,1,593,제주,4,4,0,7830,2021-03-07 09:00:00.000,2021-09-16 10:11:33.897
9955,4,3007,검역,5,0,5,7829,2021-03-07 09:00:00.000,2021-09-16 10:11:33.897
9956,1632,92047,합계,418,404,14,7828,2021-03-06 09:00:00.000,2021-09-16 10:11:33.897
9957,393,28943,서울,128,126,2,7827,2021-03-06 09:00:00.000,2021-09-16 10:11:33.897
9958,109,3313,부산,12,12,0,7826,2021-03-06 09:00:00.000,2021-09-16 10:11:33.897
9959,214,8680,대구,4,3,1,7825,2021-03-06 09:00:00.000,2021-09-16 10:11:33.897
9960,53,4527,인천,20,19,1,7824,2021-03-06 09:00:00.000,2021-09-16 10:11:33.897
9961,21,2114,광주,3,1,2,7823,2021-03-06 09:00:00.000,2021-09-16 10:11:33.897
9962,15,1196,대전,0,0,0,7822,2021-03-06 09:00:00.000,2021-09-16 10:11:33.897
9963,37,1023,울산,4,4,0,7821,2021-03-06 09:00:00.000,2021-09-16 10:11:33.897
9964,1,239,세종,2,1,1,7820,2021-03-06 09:00:00.000,2021-09-16 10:11:33.897
9965,502,24585,경기,173,172,1,7819,2021-03-06 09:00:00.000,2021-09-16 10:11:33.897
9966,42,1894,강원,7,7,0,7818,2021-03-06 09:00:00.000,2021-09-16 10:11:33.897
9967,58,1842,충북,22,22,0,7817,2021-03-06 09:00:00.000,2021-09-16 10:11:33.897
9968,35,2476,충남,7,7,0,7816,2021-03-06 09:00:00.000,2021-09-16 10:11:33.897
9969,55,1228,전북,4,4,0,7815,2021-03-06 09:00:00.000,2021-09-16 10:11:33.897
9970,8,875,전남,3,3,0,7814,2021-03-06 09:00:00.000,2021-09-16 10:11:33.897
9971,71,3305,경북,13,13,0,7813,2021-03-06 09:00:00.000,2021-09-16 10:11:33.897
9972,13,2216,경남,5,5,0,7812,2021-03-06 09:00:00.000,2021-09-16 10:11:33.897
9973,1,589,제주,5,5,0,7811,2021-03-06 09:00:00.000,2021-09-16 10:11:33.897
9974,4,3002,검역,6,0,6,7810,2021-03-06 09:00:00.000,2021-09-16 10:11:33.897
9975,1627,91629,합계,398,381,17,7809,2021-03-05 09:00:00.000,2021-09-16 10:11:33.897
9976,391,28815,서울,129,129,0,7808,2021-03-05 09:00:00.000,2021-09-16 10:11:33.897
9977,108,3301,부산,20,20,0,7807,2021-03-05 09:00:00.000,2021-09-16 10:11:33.897
9978,214,8676,대구,3,3,0,7806,2021-03-05 09:00:00.000,2021-09-16 10:11:33.897
9979,53,4507,인천,13,12,1,7805,2021-03-05 09:00:00.000,2021-09-16 10:11:33.897
9980,21,2111,광주,6,5,1,7804,2021-03-05 09:00:00.000,2021-09-16 10:11:33.897
9981,15,1196,대전,0,0,0,7803,2021-03-05 09:00:00.000,2021-09-16 10:11:33.897
9982,37,1019,울산,3,0,3,7802,2021-03-05 09:00:00.000,2021-09-16 10:11:33.897
9983,1,237,세종,1,1,0,7801,2021-03-05 09:00:00.000,2021-09-16 10:11:33.897
9984,500,24412,경기,173,168,5,7800,2021-03-05 09:00:00.000,2021-09-16 10:11:33.897
9985,42,1887,강원,4,4,0,7799,2021-03-05 09:00:00.000,2021-09-16 10:11:33.897
9986,58,1820,충북,19,19,0,7798,2021-03-05 09:00:00.000,2021-09-16 10:11:33.897
9987,35,2469,충남,9,8,1,7797,2021-03-05 09:00:00.000,2021-09-16 10:11:33.897
9988,55,1224,전북,3,3,0,7796,2021-03-05 09:00:00.000,2021-09-16 10:11:33.897
9989,8,872,전남,0,0,0,7795,2021-03-05 09:00:00.000,2021-09-16 10:11:33.897
9990,71,3292,경북,6,4,2,7794,2021-03-05 09:00:00.000,2021-09-16 10:11:33.897
9991,13,2211,경남,3,3,0,7793,2021-03-05 09:00:00.000,2021-09-16 10:11:33.897
9992,1,584,제주,2,2,0,7792,2021-03-05 09:00:00.000,2021-09-16 10:11:33.897
9993,4,2996,검역,4,0,4,7791,2021-03-05 09:00:00.000,2021-09-16 10:11:33.897
9994,1619,91231,합계,424,401,23,7790,2021-03-04 09:00:00.000,2021-09-16 10:11:33.897
9995,388,28686,서울,118,117,1,7789,2021-03-04 09:00:00.000,2021-09-16 10:11:33.897
9996,108,3281,부산,18,17,1,7788,2021-03-04 09:00:00.000,2021-09-16 10:11:33.897
9997,214,8673,대구,20,19,1,7787,2021-03-04 09:00:00.000,2021-09-16 10:11:33.897
9998,53,4494,인천,18,18,0,7786,2021-03-04 09:00:00.000,2021-09-16 10:11:33.897
9999,21,2105,광주,6,6,0,7785,2021-03-04 09:00:00.000,2021-09-16 10:11:33.897
10000,15,1196,대전,3,3,0,7784,2021-03-04 09:00:00.000,2021-09-16 10:11:33.897
10001,37,1016,울산,0,0,0,7783,2021-03-04 09:00:00.000,2021-09-16 10:11:33.897
10002,1,236,세종,0,0,0,7782,2021-03-04 09:00:00.000,2021-09-16 10:11:33.897
10003,496,24239,경기,186,177,9,7781,2021-03-04 09:00:00.000,2021-09-16 10:11:33.897
10004,41,1883,강원,6,6,0,7780,2021-03-04 09:00:00.000,2021-09-16 10:11:33.897
10005,58,1801,충북,12,12,0,7779,2021-03-04 09:00:00.000,2021-09-16 10:11:33.897
10006,35,2460,충남,4,2,2,7778,2021-03-04 09:00:00.000,2021-09-16 10:11:33.897
10007,55,1221,전북,6,6,0,7777,2021-03-04 09:00:00.000,2021-09-16 10:11:33.897
10008,8,872,전남,1,1,0,7776,2021-03-04 09:00:00.000,2021-09-16 10:11:33.897
10009,71,3286,경북,7,5,2,7775,2021-03-04 09:00:00.000,2021-09-16 10:11:33.897
10010,13,2208,경남,10,9,1,7774,2021-03-04 09:00:00.000,2021-09-16 10:11:33.897
10011,1,582,제주,3,3,0,7773,2021-03-04 09:00:00.000,2021-09-16 10:11:33.897
10012,4,2992,검역,6,0,6,7772,2021-03-04 09:00:00.000,2021-09-16 10:11:33.897
10013,1612,90807,합계,444,426,18,7771,2021-03-03 09:00:00.000,2021-09-16 10:11:33.897
10014,385,28568,서울,119,116,3,7770,2021-03-03 09:00:00.000,2021-09-16 10:11:33.897
10015,108,3263,부산,8,8,0,7769,2021-03-03 09:00:00.000,2021-09-16 10:11:33.897
10016,214,8653,대구,6,5,1,7768,2021-03-03 09:00:00.000,2021-09-16 10:11:33.897
10017,52,4476,인천,20,19,1,7767,2021-03-03 09:00:00.000,2021-09-16 10:11:33.897
10018,21,2099,광주,3,3,0,7766,2021-03-03 09:00:00.000,2021-09-16 10:11:33.897
10019,15,1193,대전,2,2,0,7765,2021-03-03 09:00:00.000,2021-09-16 10:11:33.897
10020,37,1016,울산,1,1,0,7764,2021-03-03 09:00:00.000,2021-09-16 10:11:33.897
10021,1,236,세종,4,4,0,7763,2021-03-03 09:00:00.000,2021-09-16 10:11:33.897
10022,494,24053,경기,227,218,9,7762,2021-03-03 09:00:00.000,2021-09-16 10:11:33.897
10023,41,1877,강원,6,6,0,7761,2021-03-03 09:00:00.000,2021-09-16 10:11:33.897
10024,58,1789,충북,19,19,0,7760,2021-03-03 09:00:00.000,2021-09-16 10:11:33.897
10025,35,2456,충남,4,4,0,7759,2021-03-03 09:00:00.000,2021-09-16 10:11:33.897
10026,55,1215,전북,5,5,0,7758,2021-03-03 09:00:00.000,2021-09-16 10:11:33.897
10027,8,871,전남,3,3,0,7757,2021-03-03 09:00:00.000,2021-09-16 10:11:33.897
10028,71,3279,경북,6,5,1,7756,2021-03-03 09:00:00.000,2021-09-16 10:11:33.897
10029,12,2198,경남,5,4,1,7755,2021-03-03 09:00:00.000,2021-09-16 10:11:33.897
10030,1,579,제주,4,4,0,7754,2021-03-03 09:00:00.000,2021-09-16 10:11:33.897
10031,4,2986,검역,2,0,2,7753,2021-03-03 09:00:00.000,2021-09-16 10:11:33.897
10032,1606,90363,합계,344,319,25,7752,2021-03-02 09:00:00.000,2021-09-16 10:11:33.897
10033,381,28449,서울,122,120,2,7751,2021-03-02 09:00:00.000,2021-09-16 10:11:33.897
10034,108,3255,부산,17,17,0,7750,2021-03-02 09:00:00.000,2021-09-16 10:11:33.897
10035,213,8647,대구,14,12,2,7749,2021-03-02 09:00:00.000,2021-09-16 10:11:33.897
10036,52,4456,인천,11,10,1,7748,2021-03-02 09:00:00.000,2021-09-16 10:11:33.897
10037,21,2096,광주,4,4,0,7747,2021-03-02 09:00:00.000,2021-09-16 10:11:33.897
10038,15,1191,대전,1,1,0,7746,2021-03-02 09:00:00.000,2021-09-16 10:11:33.897
10039,37,1015,울산,0,0,0,7745,2021-03-02 09:00:00.000,2021-09-16 10:11:33.897
10040,1,232,세종,5,5,0,7744,2021-03-02 09:00:00.000,2021-09-16 10:11:33.897
10041,493,23826,경기,116,111,5,7743,2021-03-02 09:00:00.000,2021-09-16 10:11:33.897
10042,41,1871,강원,2,2,0,7742,2021-03-02 09:00:00.000,2021-09-16 10:11:33.897
10043,58,1770,충북,6,5,1,7741,2021-03-02 09:00:00.000,2021-09-16 10:11:33.897
10044,35,2452,충남,4,4,0,7740,2021-03-02 09:00:00.000,2021-09-16 10:11:33.897
10045,55,1210,전북,9,9,0,7739,2021-03-02 09:00:00.000,2021-09-16 10:11:33.897
10046,8,868,전남,7,7,0,7738,2021-03-02 09:00:00.000,2021-09-16 10:11:33.897
10047,71,3273,경북,7,4,3,7737,2021-03-02 09:00:00.000,2021-09-16 10:11:33.897
10048,12,2193,경남,5,3,2,7736,2021-03-02 09:00:00.000,2021-09-16 10:11:33.897
10049,1,575,제주,5,5,0,7735,2021-03-02 09:00:00.000,2021-09-16 10:11:33.897
10050,4,2984,검역,9,0,9,7734,2021-03-02 09:00:00.000,2021-09-16 10:11:33.897
10051,1605,90019,합계,355,338,17,7733,2021-03-01 09:00:00.000,2021-09-16 10:11:33.897
10052,381,28327,서울,92,92,0,7732,2021-03-01 09:00:00.000,2021-09-16 10:11:33.897
10053,108,3238,부산,16,16,0,7731,2021-03-01 09:00:00.000,2021-09-16 10:11:33.897
10054,213,8633,대구,10,10,0,7730,2021-03-01 09:00:00.000,2021-09-16 10:11:33.897
10055,52,4445,인천,14,14,0,7729,2021-03-01 09:00:00.000,2021-09-16 10:11:33.897
10056,21,2092,광주,8,6,2,7728,2021-03-01 09:00:00.000,2021-09-16 10:11:33.897
10057,15,1190,대전,0,0,0,7727,2021-03-01 09:00:00.000,2021-09-16 10:11:33.897
10058,37,1015,울산,2,2,0,7726,2021-03-01 09:00:00.000,2021-09-16 10:11:33.897
10059,1,227,세종,1,1,0,7725,2021-03-01 09:00:00.000,2021-09-16 10:11:33.897
10060,493,23710,경기,160,156,4,7724,2021-03-01 09:00:00.000,2021-09-16 10:11:33.897
10061,41,1869,강원,5,5,0,7723,2021-03-01 09:00:00.000,2021-09-16 10:11:33.897
10062,58,1764,충북,8,8,0,7722,2021-03-01 09:00:00.000,2021-09-16 10:11:33.897
10063,35,2448,충남,4,2,2,7721,2021-03-01 09:00:00.000,2021-09-16 10:11:33.897
10064,55,1201,전북,10,10,0,7720,2021-03-01 09:00:00.000,2021-09-16 10:11:33.897
10065,8,861,전남,2,2,0,7719,2021-03-01 09:00:00.000,2021-09-16 10:11:33.897
10066,71,3266,경북,13,10,3,7718,2021-03-01 09:00:00.000,2021-09-16 10:11:33.897
10067,11,2188,경남,5,4,1,7717,2021-03-01 09:00:00.000,2021-09-16 10:11:33.897
10068,1,570,제주,0,0,0,7716,2021-03-01 09:00:00.000,2021-09-16 10:11:33.897
10069,4,2975,검역,5,0,5,7715,2021-03-01 09:00:00.000,2021-09-16 10:11:33.897
10070,1603,89664,합계,355,333,22,7714,2021-02-28 09:00:00.000,2021-09-16 10:11:33.897
10071,380,28235,서울,120,117,3,7713,2021-02-28 09:00:00.000,2021-09-16 10:11:33.897
10072,108,3222,부산,5,4,1,7712,2021-02-28 09:00:00.000,2021-09-16 10:11:33.897
10073,213,8623,대구,6,5,1,7711,2021-02-28 09:00:00.000,2021-09-16 10:11:33.897
10074,52,4431,인천,13,13,0,7710,2021-02-28 09:00:00.000,2021-09-16 10:11:33.897
10075,21,2084,광주,14,14,0,7709,2021-02-28 09:00:00.000,2021-09-16 10:11:33.897
10076,15,1190,대전,1,1,0,7708,2021-02-28 09:00:00.000,2021-09-16 10:11:33.897
10077,37,1013,울산,5,5,0,7707,2021-02-28 09:00:00.000,2021-09-16 10:11:33.897
10078,1,226,세종,6,6,0,7706,2021-02-28 09:00:00.000,2021-09-16 10:11:33.897
10079,492,23550,경기,141,138,3,7705,2021-02-28 09:00:00.000,2021-09-16 10:11:33.897
10080,41,1864,강원,4,3,1,7704,2021-02-28 09:00:00.000,2021-09-16 10:11:33.897
10081,58,1756,충북,10,10,0,7703,2021-02-28 09:00:00.000,2021-09-16 10:11:33.897
10082,35,2444,충남,7,4,3,7702,2021-02-28 09:00:00.000,2021-09-16 10:11:33.897
10083,55,1191,전북,7,7,0,7701,2021-02-28 09:00:00.000,2021-09-16 10:11:33.897
10084,8,859,전남,0,0,0,7700,2021-02-28 09:00:00.000,2021-09-16 10:11:33.897
10085,71,3253,경북,4,3,1,7699,2021-02-28 09:00:00.000,2021-09-16 10:11:33.897
10086,11,2183,경남,2,2,0,7698,2021-02-28 09:00:00.000,2021-09-16 10:11:33.897
10087,1,570,제주,1,1,0,7697,2021-02-28 09:00:00.000,2021-09-16 10:11:33.897
10088,4,2970,검역,9,0,9,7696,2021-02-28 09:00:00.000,2021-09-16 10:11:33.897
10089,1595,89309,합계,415,405,10,7695,2021-02-27 09:00:00.000,2021-09-16 10:11:33.897
10090,378,28115,서울,131,130,1,7694,2021-02-27 09:00:00.000,2021-09-16 10:11:33.897
10091,108,3217,부산,9,9,0,7693,2021-02-27 09:00:00.000,2021-09-16 10:11:33.897
10092,213,8617,대구,6,6,0,7692,2021-02-27 09:00:00.000,2021-09-16 10:11:33.897
10093,52,4418,인천,27,27,0,7691,2021-02-27 09:00:00.000,2021-09-16 10:11:33.897
10094,21,2070,광주,12,12,0,7690,2021-02-27 09:00:00.000,2021-09-16 10:11:33.897
10095,15,1189,대전,2,2,0,7689,2021-02-27 09:00:00.000,2021-09-16 10:11:33.897
10096,37,1008,울산,3,3,0,7688,2021-02-27 09:00:00.000,2021-09-16 10:11:33.897
10097,1,220,세종,1,1,0,7687,2021-02-27 09:00:00.000,2021-09-16 10:11:33.897
10098,487,23409,경기,169,166,3,7686,2021-02-27 09:00:00.000,2021-09-16 10:11:33.897
10099,41,1860,강원,6,5,1,7685,2021-02-27 09:00:00.000,2021-09-16 10:11:33.897
10100,58,1746,충북,8,8,0,7684,2021-02-27 09:00:00.000,2021-09-16 10:11:33.897
10101,35,2437,충남,4,4,0,7683,2021-02-27 09:00:00.000,2021-09-16 10:11:33.897
10102,55,1184,전북,20,20,0,7682,2021-02-27 09:00:00.000,2021-09-16 10:11:33.897
10103,8,859,전남,5,4,1,7681,2021-02-27 09:00:00.000,2021-09-16 10:11:33.897
10104,71,3249,경북,7,6,1,7680,2021-02-27 09:00:00.000,2021-09-16 10:11:33.897
10105,11,2181,경남,1,1,0,7679,2021-02-27 09:00:00.000,2021-09-16 10:11:33.897
10106,1,569,제주,1,1,0,7678,2021-02-27 09:00:00.000,2021-09-16 10:11:33.897
10107,3,2961,검역,3,0,3,7677,2021-02-27 09:00:00.000,2021-09-16 10:11:33.897
10108,1585,88894,합계,387,363,24,7676,2021-02-26 09:00:00.000,2021-09-16 10:11:33.897
10109,375,27984,서울,131,128,3,7675,2021-02-26 09:00:00.000,2021-09-16 10:11:33.897
10110,105,3208,부산,11,10,1,7674,2021-02-26 09:00:00.000,2021-09-16 10:11:33.897
10111,213,8611,대구,10,10,0,7673,2021-02-26 09:00:00.000,2021-09-16 10:11:33.897
10112,52,4391,인천,15,14,1,7672,2021-02-26 09:00:00.000,2021-09-16 10:11:33.897
10113,21,2058,광주,11,11,0,7671,2021-02-26 09:00:00.000,2021-09-16 10:11:33.897
10114,15,1187,대전,6,6,0,7670,2021-02-26 09:00:00.000,2021-09-16 10:11:33.897
10115,37,1005,울산,1,1,0,7669,2021-02-26 09:00:00.000,2021-09-16 10:11:33.897
10116,1,219,세종,1,1,0,7668,2021-02-26 09:00:00.000,2021-09-16 10:11:33.897
10117,484,23240,경기,141,135,6,7667,2021-02-26 09:00:00.000,2021-09-16 10:11:33.897
10118,41,1854,강원,6,5,1,7666,2021-02-26 09:00:00.000,2021-09-16 10:11:33.897
10119,58,1738,충북,10,10,0,7665,2021-02-26 09:00:00.000,2021-09-16 10:11:33.897
10120,35,2433,충남,3,2,1,7664,2021-02-26 09:00:00.000,2021-09-16 10:11:33.897
10121,55,1164,전북,16,15,1,7663,2021-02-26 09:00:00.000,2021-09-16 10:11:33.897
10122,8,854,전남,5,5,0,7662,2021-02-26 09:00:00.000,2021-09-16 10:11:33.897
10123,71,3242,경북,6,5,1,7661,2021-02-26 09:00:00.000,2021-09-16 10:11:33.897
10124,10,2180,경남,6,5,1,7660,2021-02-26 09:00:00.000,2021-09-16 10:11:33.897
10125,1,568,제주,0,0,0,7659,2021-02-26 09:00:00.000,2021-09-16 10:11:33.897
10126,3,2958,검역,8,0,8,7658,2021-02-26 09:00:00.000,2021-09-16 10:11:33.897
10127,1581,88507,합계,395,368,27,7657,2021-02-25 09:00:00.000,2021-09-16 10:11:33.897
10128,373,27853,서울,122,114,8,7656,2021-02-25 09:00:00.000,2021-09-16 10:11:33.897
10129,105,3197,부산,18,18,0,7655,2021-02-25 09:00:00.000,2021-09-16 10:11:33.897
10130,213,8601,대구,14,12,2,7654,2021-02-25 09:00:00.000,2021-09-16 10:11:33.897
10131,52,4376,인천,22,22,0,7653,2021-02-25 09:00:00.000,2021-09-16 10:11:33.897
10132,21,2047,광주,15,15,0,7652,2021-02-25 09:00:00.000,2021-09-16 10:11:33.897
10133,15,1181,대전,0,0,0,7651,2021-02-25 09:00:00.000,2021-09-16 10:11:33.897
10134,37,1004,울산,2,1,1,7650,2021-02-25 09:00:00.000,2021-09-16 10:11:33.897
10135,1,218,세종,0,0,0,7649,2021-02-25 09:00:00.000,2021-09-16 10:11:33.897
10136,482,23099,경기,138,132,6,7648,2021-02-25 09:00:00.000,2021-09-16 10:11:33.897
10137,41,1848,강원,2,2,0,7647,2021-02-25 09:00:00.000,2021-09-16 10:11:33.897
10138,58,1728,충북,4,4,0,7646,2021-02-25 09:00:00.000,2021-09-16 10:11:33.897
10139,35,2430,충남,16,16,0,7645,2021-02-25 09:00:00.000,2021-09-16 10:11:33.897
10140,55,1148,전북,5,5,0,7644,2021-02-25 09:00:00.000,2021-09-16 10:11:33.897
10141,8,849,전남,11,11,0,7643,2021-02-25 09:00:00.000,2021-09-16 10:11:33.897
10142,71,3236,경북,9,9,0,7642,2021-02-25 09:00:00.000,2021-09-16 10:11:33.897
10143,10,2174,경남,2,2,0,7641,2021-02-25 09:00:00.000,2021-09-16 10:11:33.897
10144,1,568,제주,5,5,0,7640,2021-02-25 09:00:00.000,2021-09-16 10:11:33.897
10145,3,2950,검역,10,0,10,7639,2021-02-25 09:00:00.000,2021-09-16 10:11:33.897
10146,1576,88112,합계,440,417,23,7638,2021-02-24 09:00:00.000,2021-09-16 10:11:33.897
10147,372,27731,서울,144,138,6,7637,2021-02-24 09:00:00.000,2021-09-16 10:11:33.897
10148,104,3179,부산,13,13,0,7636,2021-02-24 09:00:00.000,2021-09-16 10:11:33.897
10149,213,8587,대구,19,17,2,7635,2021-02-24 09:00:00.000,2021-09-16 10:11:33.897
10150,52,4354,인천,18,17,1,7634,2021-02-24 09:00:00.000,2021-09-16 10:11:33.897
10151,20,2032,광주,35,35,0,7633,2021-02-24 09:00:00.000,2021-09-16 10:11:33.897
10152,15,1181,대전,2,2,0,7632,2021-02-24 09:00:00.000,2021-09-16 10:11:33.897
10153,37,1002,울산,1,1,0,7631,2021-02-24 09:00:00.000,2021-09-16 10:11:33.897
10154,1,218,세종,2,2,0,7630,2021-02-24 09:00:00.000,2021-09-16 10:11:33.897
10155,481,22961,경기,143,137,6,7629,2021-02-24 09:00:00.000,2021-09-16 10:11:33.897
10156,41,1846,강원,9,9,0,7628,2021-02-24 09:00:00.000,2021-09-16 10:11:33.897
10157,58,1724,충북,1,1,0,7627,2021-02-24 09:00:00.000,2021-09-16 10:11:33.897
10158,35,2414,충남,12,12,0,7626,2021-02-24 09:00:00.000,2021-09-16 10:11:33.897
10159,54,1143,전북,8,8,0,7625,2021-02-24 09:00:00.000,2021-09-16 10:11:33.897
10160,8,838,전남,1,1,0,7624,2021-02-24 09:00:00.000,2021-09-16 10:11:33.897
10161,71,3227,경북,18,15,3,7623,2021-02-24 09:00:00.000,2021-09-16 10:11:33.897
10162,10,2172,경남,8,7,1,7622,2021-02-24 09:00:00.000,2021-09-16 10:11:33.897
10163,1,563,제주,2,2,0,7621,2021-02-24 09:00:00.000,2021-09-16 10:11:33.897
10164,3,2940,검역,4,0,4,7620,2021-02-24 09:00:00.000,2021-09-16 10:11:33.897
10165,1573,87672,합계,356,329,27,7619,2021-02-23 09:00:00.000,2021-09-16 10:11:33.897
10166,371,27587,서울,125,117,8,7618,2021-02-23 09:00:00.000,2021-09-16 10:11:33.897
10167,104,3166,부산,12,12,0,7617,2021-02-23 09:00:00.000,2021-09-16 10:11:33.897
10168,213,8568,대구,10,7,3,7616,2021-02-23 09:00:00.000,2021-09-16 10:11:33.897
10169,52,4336,인천,14,12,2,7615,2021-02-23 09:00:00.000,2021-09-16 10:11:33.897
10170,20,1997,광주,7,6,1,7614,2021-02-23 09:00:00.000,2021-09-16 10:11:33.897
10171,15,1179,대전,1,0,1,7613,2021-02-23 09:00:00.000,2021-09-16 10:11:33.897
10172,37,1001,울산,2,1,1,7612,2021-02-23 09:00:00.000,2021-09-16 10:11:33.897
10173,1,216,세종,1,1,0,7611,2021-02-23 09:00:00.000,2021-09-16 10:11:33.897
10174,480,22818,경기,127,122,5,7610,2021-02-23 09:00:00.000,2021-09-16 10:11:33.897
10175,41,1837,강원,14,14,0,7609,2021-02-23 09:00:00.000,2021-09-16 10:11:33.897
10176,58,1723,충북,4,4,0,7608,2021-02-23 09:00:00.000,2021-09-16 10:11:33.897
10177,35,2402,충남,8,8,0,7607,2021-02-23 09:00:00.000,2021-09-16 10:11:33.897
10178,54,1135,전북,7,7,0,7606,2021-02-23 09:00:00.000,2021-09-16 10:11:33.897
10179,8,837,전남,6,6,0,7605,2021-02-23 09:00:00.000,2021-09-16 10:11:33.897
10180,70,3209,경북,8,7,1,7604,2021-02-23 09:00:00.000,2021-09-16 10:11:33.897
10181,10,2164,경남,5,5,0,7603,2021-02-23 09:00:00.000,2021-09-16 10:11:33.897
10182,1,561,제주,0,0,0,7602,2021-02-23 09:00:00.000,2021-09-16 10:11:33.897
10183,3,2936,검역,5,0,5,7601,2021-02-23 09:00:00.000,2021-09-16 10:11:33.897
10184,1562,87316,합계,332,313,19,7600,2021-02-22 09:00:00.000,2021-09-16 10:11:33.897
10185,369,27462,서울,106,102,4,7599,2021-02-22 09:00:00.000,2021-09-16 10:11:33.897
10186,102,3154,부산,12,12,0,7598,2021-02-22 09:00:00.000,2021-09-16 10:11:33.897
10187,213,8558,대구,4,4,0,7597,2021-02-22 09:00:00.000,2021-09-16 10:11:33.897
10188,52,4322,인천,19,18,1,7596,2021-02-22 09:00:00.000,2021-09-16 10:11:33.897
10189,19,1990,광주,5,4,1,7595,2021-02-22 09:00:00.000,2021-09-16 10:11:33.897
10190,15,1178,대전,3,2,1,7594,2021-02-22 09:00:00.000,2021-09-16 10:11:33.897
10191,37,999,울산,1,0,1,7593,2021-02-22 09:00:00.000,2021-09-16 10:11:33.897
10192,1,215,세종,0,0,0,7592,2021-02-22 09:00:00.000,2021-09-16 10:11:33.897
10193,477,22691,경기,121,116,5,7591,2021-02-22 09:00:00.000,2021-09-16 10:11:33.897
10194,38,1823,강원,20,19,1,7590,2021-02-22 09:00:00.000,2021-09-16 10:11:33.897
10195,58,1719,충북,7,7,0,7589,2021-02-22 09:00:00.000,2021-09-16 10:11:33.897
10196,35,2394,충남,6,6,0,7588,2021-02-22 09:00:00.000,2021-09-16 10:11:33.897
10197,54,1128,전북,4,4,0,7587,2021-02-22 09:00:00.000,2021-09-16 10:11:33.897
10198,8,831,전남,3,3,0,7586,2021-02-22 09:00:00.000,2021-09-16 10:11:33.897
10199,70,3201,경북,11,11,0,7585,2021-02-22 09:00:00.000,2021-09-16 10:11:33.897
10200,10,2159,경남,6,5,1,7584,2021-02-22 09:00:00.000,2021-09-16 10:11:33.897
10201,1,561,제주,0,0,0,7583,2021-02-22 09:00:00.000,2021-09-16 10:11:33.897
10202,3,2931,검역,4,0,4,7582,2021-02-22 09:00:00.000,2021-09-16 10:11:33.897
10203,1557,86984,합계,416,391,25,7581,2021-02-21 09:00:00.000,2021-09-16 10:11:33.897
10204,365,27356,서울,130,120,10,7580,2021-02-21 09:00:00.000,2021-09-16 10:11:33.897
10205,102,3142,부산,12,11,1,7579,2021-02-21 09:00:00.000,2021-09-16 10:11:33.897
10206,213,8554,대구,8,6,2,7578,2021-02-21 09:00:00.000,2021-09-16 10:11:33.897
10207,52,4303,인천,21,21,0,7577,2021-02-21 09:00:00.000,2021-09-16 10:11:33.897
10208,19,1985,광주,6,5,1,7576,2021-02-21 09:00:00.000,2021-09-16 10:11:33.897
10209,15,1175,대전,0,0,0,7575,2021-02-21 09:00:00.000,2021-09-16 10:11:33.897
10210,37,998,울산,4,4,0,7574,2021-02-21 09:00:00.000,2021-09-16 10:11:33.897
10211,1,215,세종,1,1,0,7573,2021-02-21 09:00:00.000,2021-09-16 10:11:33.897
10212,477,22570,경기,171,170,1,7572,2021-02-21 09:00:00.000,2021-09-16 10:11:33.897
10213,38,1803,강원,6,6,0,7571,2021-02-21 09:00:00.000,2021-09-16 10:11:33.897
10214,58,1712,충북,6,6,0,7570,2021-02-21 09:00:00.000,2021-09-16 10:11:33.897
10215,34,2388,충남,10,10,0,7569,2021-02-21 09:00:00.000,2021-09-16 10:11:33.897
10216,54,1124,전북,8,7,1,7568,2021-02-21 09:00:00.000,2021-09-16 10:11:33.897
10217,8,828,전남,8,8,0,7567,2021-02-21 09:00:00.000,2021-09-16 10:11:33.897
10218,70,3190,경북,7,6,1,7566,2021-02-21 09:00:00.000,2021-09-16 10:11:33.897
10219,10,2153,경남,7,7,0,7565,2021-02-21 09:00:00.000,2021-09-16 10:11:33.897
10220,1,561,제주,3,3,0,7564,2021-02-21 09:00:00.000,2021-09-16 10:11:33.897
10221,3,2927,검역,8,0,8,7563,2021-02-21 09:00:00.000,2021-09-16 10:11:33.897
10222,1553,86568,합계,448,416,32,7562,2021-02-20 09:00:00.000,2021-09-16 10:11:33.897
10223,365,27226,서울,123,119,4,7561,2021-02-20 09:00:00.000,2021-09-16 10:11:33.897
10224,102,3130,부산,14,14,0,7560,2021-02-20 09:00:00.000,2021-09-16 10:11:33.897
10225,213,8546,대구,9,9,0,7559,2021-02-20 09:00:00.000,2021-09-16 10:11:33.897
10226,52,4282,인천,37,35,2,7558,2021-02-20 09:00:00.000,2021-09-16 10:11:33.897
10227,19,1979,광주,5,1,4,7557,2021-02-20 09:00:00.000,2021-09-16 10:11:33.897
10228,15,1175,대전,2,2,0,7556,2021-02-20 09:00:00.000,2021-09-16 10:11:33.897
10229,37,994,울산,1,0,1,7555,2021-02-20 09:00:00.000,2021-09-16 10:11:33.897
10230,1,214,세종,0,0,0,7554,2021-02-20 09:00:00.000,2021-09-16 10:11:33.897
10231,474,22399,경기,170,161,9,7553,2021-02-20 09:00:00.000,2021-09-16 10:11:33.897
10232,37,1797,강원,5,3,2,7552,2021-02-20 09:00:00.000,2021-09-16 10:11:33.897
10233,58,1706,충북,16,16,0,7551,2021-02-20 09:00:00.000,2021-09-16 10:11:33.897
10234,34,2378,충남,12,12,0,7550,2021-02-20 09:00:00.000,2021-09-16 10:11:33.897
10235,54,1116,전북,8,8,0,7549,2021-02-20 09:00:00.000,2021-09-16 10:11:33.897
10236,8,820,전남,10,10,0,7548,2021-02-20 09:00:00.000,2021-09-16 10:11:33.897
10237,70,3183,경북,19,16,3,7547,2021-02-20 09:00:00.000,2021-09-16 10:11:33.897
10238,10,2146,경남,8,8,0,7546,2021-02-20 09:00:00.000,2021-09-16 10:11:33.897
10239,1,558,제주,2,2,0,7545,2021-02-20 09:00:00.000,2021-09-16 10:11:33.897
10240,3,2919,검역,7,0,7,7544,2021-02-20 09:00:00.000,2021-09-16 10:11:33.897
10241,1550,86120,합계,561,533,28,7543,2021-02-19 09:00:00.000,2021-09-16 10:11:33.897
10242,364,27103,서울,180,177,3,7542,2021-02-19 09:00:00.000,2021-09-16 10:11:33.897
10243,102,3116,부산,16,16,0,7541,2021-02-19 09:00:00.000,2021-09-16 10:11:33.897
10244,212,8537,대구,11,10,1,7540,2021-02-19 09:00:00.000,2021-09-16 10:11:33.897
10245,52,4245,인천,38,37,1,7539,2021-02-19 09:00:00.000,2021-09-16 10:11:33.897
10246,19,1974,광주,4,3,1,7538,2021-02-19 09:00:00.000,2021-09-16 10:11:33.897
10247,15,1173,대전,4,4,0,7537,2021-02-19 09:00:00.000,2021-09-16 10:11:33.897
10248,37,993,울산,12,12,0,7536,2021-02-19 09:00:00.000,2021-09-16 10:11:33.897
10249,1,214,세종,1,1,0,7535,2021-02-19 09:00:00.000,2021-09-16 10:11:33.897
10250,473,22229,경기,189,182,7,7534,2021-02-19 09:00:00.000,2021-09-16 10:11:33.897
10251,37,1792,강원,7,5,2,7533,2021-02-19 09:00:00.000,2021-09-16 10:11:33.897
10252,58,1690,충북,18,18,0,7532,2021-02-19 09:00:00.000,2021-09-16 10:11:33.897
10253,34,2366,충남,24,21,3,7531,2021-02-19 09:00:00.000,2021-09-16 10:11:33.897
10254,54,1108,전북,3,3,0,7530,2021-02-19 09:00:00.000,2021-09-16 10:11:33.897
10255,8,810,전남,10,10,0,7529,2021-02-19 09:00:00.000,2021-09-16 10:11:33.897
10256,70,3164,경북,22,22,0,7528,2021-02-19 09:00:00.000,2021-09-16 10:11:33.897
10257,10,2138,경남,9,9,0,7527,2021-02-19 09:00:00.000,2021-09-16 10:11:33.897
10258,1,556,제주,3,3,0,7526,2021-02-19 09:00:00.000,2021-09-16 10:11:33.897
10259,3,2912,검역,10,0,10,7525,2021-02-19 09:00:00.000,2021-09-16 10:11:33.897
10260,1544,85559,합계,621,590,31,7524,2021-02-18 09:00:00.000,2021-09-16 10:11:33.897
10261,362,26923,서울,185,179,6,7523,2021-02-18 09:00:00.000,2021-09-16 10:11:33.897
10262,101,3100,부산,28,28,0,7522,2021-02-18 09:00:00.000,2021-09-16 10:11:33.897
10263,212,8526,대구,9,9,0,7521,2021-02-18 09:00:00.000,2021-09-16 10:11:33.897
10264,52,4207,인천,17,16,1,7520,2021-02-18 09:00:00.000,2021-09-16 10:11:33.897
10265,19,1970,광주,16,12,4,7519,2021-02-18 09:00:00.000,2021-09-16 10:11:33.897
10266,15,1169,대전,12,12,0,7518,2021-02-18 09:00:00.000,2021-09-16 10:11:33.897
10267,37,981,울산,6,6,0,7517,2021-02-18 09:00:00.000,2021-09-16 10:11:33.897
10268,1,213,세종,1,1,0,7516,2021-02-18 09:00:00.000,2021-09-16 10:11:33.897
10269,471,22040,경기,241,237,4,7515,2021-02-18 09:00:00.000,2021-09-16 10:11:33.897
10270,36,1785,강원,4,3,1,7514,2021-02-18 09:00:00.000,2021-09-16 10:11:33.897
10271,58,1672,충북,17,16,1,7513,2021-02-18 09:00:00.000,2021-09-16 10:11:33.897
10272,34,2342,충남,28,28,0,7512,2021-02-18 09:00:00.000,2021-09-16 10:11:33.897
10273,54,1105,전북,6,5,1,7511,2021-02-18 09:00:00.000,2021-09-16 10:11:33.897
10274,8,800,전남,4,4,0,7510,2021-02-18 09:00:00.000,2021-09-16 10:11:33.897
10275,70,3142,경북,23,22,1,7509,2021-02-18 09:00:00.000,2021-09-16 10:11:33.897
10276,10,2129,경남,7,7,0,7508,2021-02-18 09:00:00.000,2021-09-16 10:11:33.897
10277,1,553,제주,5,5,0,7507,2021-02-18 09:00:00.000,2021-09-16 10:11:33.897
10278,3,2902,검역,12,0,12,7506,2021-02-18 09:00:00.000,2021-09-16 10:11:33.897
10279,1538,84938,합계,621,590,31,7505,2021-02-17 09:00:00.000,2021-09-16 10:11:33.897
10280,360,26738,서울,258,247,11,7504,2021-02-17 09:00:00.000,2021-09-16 10:11:33.897
10281,101,3072,부산,19,18,1,7503,2021-02-17 09:00:00.000,2021-09-16 10:11:33.897
10282,211,8517,대구,14,12,2,7502,2021-02-17 09:00:00.000,2021-09-16 10:11:33.897
10283,51,4190,인천,21,21,0,7501,2021-02-17 09:00:00.000,2021-09-16 10:11:33.897
10284,19,1954,광주,3,2,1,7500,2021-02-17 09:00:00.000,2021-09-16 10:11:33.897
10285,15,1157,대전,7,7,0,7499,2021-02-17 09:00:00.000,2021-09-16 10:11:33.897
10286,37,975,울산,9,9,0,7498,2021-02-17 09:00:00.000,2021-09-16 10:11:33.897
10287,1,212,세종,2,2,0,7497,2021-02-17 09:00:00.000,2021-09-16 10:11:33.897
10288,470,21799,경기,154,147,7,7496,2021-02-17 09:00:00.000,2021-09-16 10:11:33.897
10289,36,1781,강원,3,3,0,7495,2021-02-17 09:00:00.000,2021-09-16 10:11:33.897
10290,58,1655,충북,6,6,0,7494,2021-02-17 09:00:00.000,2021-09-16 10:11:33.897
10291,33,2314,충남,75,74,1,7493,2021-02-17 09:00:00.000,2021-09-16 10:11:33.897
10292,54,1099,전북,6,6,0,7492,2021-02-17 09:00:00.000,2021-09-16 10:11:33.897
10293,8,796,전남,15,15,0,7491,2021-02-17 09:00:00.000,2021-09-16 10:11:33.897
10294,70,3119,경북,15,14,1,7490,2021-02-17 09:00:00.000,2021-09-16 10:11:33.897
10295,10,2122,경남,8,7,1,7489,2021-02-17 09:00:00.000,2021-09-16 10:11:33.897
10296,1,548,제주,0,0,0,7488,2021-02-17 09:00:00.000,2021-09-16 10:11:33.897
10297,3,2890,검역,6,0,6,7487,2021-02-17 09:00:00.000,2021-09-16 10:11:33.897
10298,1534,84317,합계,457,429,28,7486,2021-02-16 09:00:00.000,2021-09-16 10:11:33.897
10299,359,26480,서울,161,155,6,7485,2021-02-16 09:00:00.000,2021-09-16 10:11:33.897
10300,101,3053,부산,19,17,2,7484,2021-02-16 09:00:00.000,2021-09-16 10:11:33.897
10301,211,8503,대구,12,11,1,7483,2021-02-16 09:00:00.000,2021-09-16 10:11:33.897
10302,51,4169,인천,21,19,2,7482,2021-02-16 09:00:00.000,2021-09-16 10:11:33.897
10303,19,1951,광주,2,2,0,7481,2021-02-16 09:00:00.000,2021-09-16 10:11:33.897
10304,15,1150,대전,4,4,0,7480,2021-02-16 09:00:00.000,2021-09-16 10:11:33.897
10305,37,966,울산,7,7,0,7479,2021-02-16 09:00:00.000,2021-09-16 10:11:33.897
10306,1,210,세종,0,0,0,7478,2021-02-16 09:00:00.000,2021-09-16 10:11:33.897
10307,468,21645,경기,134,129,5,7477,2021-02-16 09:00:00.000,2021-09-16 10:11:33.897
10308,36,1778,강원,5,4,1,7476,2021-02-16 09:00:00.000,2021-09-16 10:11:33.897
10309,58,1649,충북,7,7,0,7475,2021-02-16 09:00:00.000,2021-09-16 10:11:33.897
10310,33,2239,충남,58,58,0,7474,2021-02-16 09:00:00.000,2021-09-16 10:11:33.897
10311,53,1093,전북,5,5,0,7473,2021-02-16 09:00:00.000,2021-09-16 10:11:33.897
10312,8,781,전남,2,2,0,7472,2021-02-16 09:00:00.000,2021-09-16 10:11:33.897
10313,70,3104,경북,3,2,1,7471,2021-02-16 09:00:00.000,2021-09-16 10:11:33.897
10314,10,2114,경남,8,6,2,7470,2021-02-16 09:00:00.000,2021-09-16 10:11:33.897
10315,1,548,제주,1,1,0,7469,2021-02-16 09:00:00.000,2021-09-16 10:11:33.897
10316,3,2884,검역,8,0,8,7468,2021-02-16 09:00:00.000,2021-09-16 10:11:33.897
10317,1527,83860,합계,343,322,21,7467,2021-02-15 09:00:00.000,2021-09-16 10:11:33.897
10318,356,26319,서울,150,146,4,7466,2021-02-15 09:00:00.000,2021-09-16 10:11:33.897
10319,101,3034,부산,15,15,0,7465,2021-02-15 09:00:00.000,2021-09-16 10:11:33.897
10320,211,8491,대구,13,12,1,7464,2021-02-15 09:00:00.000,2021-09-16 10:11:33.897
10321,51,4148,인천,12,9,3,7463,2021-02-15 09:00:00.000,2021-09-16 10:11:33.897
10322,19,1949,광주,3,3,0,7462,2021-02-15 09:00:00.000,2021-09-16 10:11:33.897
10323,15,1146,대전,8,6,2,7461,2021-02-15 09:00:00.000,2021-09-16 10:11:33.897
10324,37,959,울산,4,3,1,7460,2021-02-15 09:00:00.000,2021-09-16 10:11:33.897
10325,1,210,세종,0,0,0,7459,2021-02-15 09:00:00.000,2021-09-16 10:11:33.897
10326,466,21511,경기,102,99,3,7458,2021-02-15 09:00:00.000,2021-09-16 10:11:33.897
10327,36,1773,강원,1,1,0,7457,2021-02-15 09:00:00.000,2021-09-16 10:11:33.897
10328,57,1642,충북,0,0,0,7456,2021-02-15 09:00:00.000,2021-09-16 10:11:33.897
10329,33,2181,충남,9,9,0,7455,2021-02-15 09:00:00.000,2021-09-16 10:11:33.897
10330,53,1088,전북,4,4,0,7454,2021-02-15 09:00:00.000,2021-09-16 10:11:33.897
10331,7,779,전남,5,4,1,7453,2021-02-15 09:00:00.000,2021-09-16 10:11:33.897
10332,70,3101,경북,8,8,0,7452,2021-02-15 09:00:00.000,2021-09-16 10:11:33.897
10333,10,2106,경남,3,3,0,7451,2021-02-15 09:00:00.000,2021-09-16 10:11:33.897
10334,1,547,제주,0,0,0,7450,2021-02-15 09:00:00.000,2021-09-16 10:11:33.897
10335,3,2876,검역,6,0,6,7449,2021-02-15 09:00:00.000,2021-09-16 10:11:33.897
10336,1522,83517,합계,326,304,22,7448,2021-02-14 09:00:00.000,2021-09-16 10:11:33.897
10337,355,26169,서울,152,147,5,7447,2021-02-14 09:00:00.000,2021-09-16 10:11:33.897
10338,100,3019,부산,15,12,3,7446,2021-02-14 09:00:00.000,2021-09-16 10:11:33.897
10339,211,8478,대구,3,3,0,7445,2021-02-14 09:00:00.000,2021-09-16 10:11:33.897
10340,51,4136,인천,19,19,0,7444,2021-02-14 09:00:00.000,2021-09-16 10:11:33.897
10341,19,1946,광주,2,2,0,7443,2021-02-14 09:00:00.000,2021-09-16 10:11:33.897
10342,15,1138,대전,2,2,0,7442,2021-02-14 09:00:00.000,2021-09-16 10:11:33.897
10343,37,955,울산,3,3,0,7441,2021-02-14 09:00:00.000,2021-09-16 10:11:33.897
10344,1,210,세종,2,2,0,7440,2021-02-14 09:00:00.000,2021-09-16 10:11:33.897
10345,463,21409,경기,80,77,3,7439,2021-02-14 09:00:00.000,2021-09-16 10:11:33.897
10346,36,1772,강원,5,5,0,7438,2021-02-14 09:00:00.000,2021-09-16 10:11:33.897
10347,57,1642,충북,5,5,0,7437,2021-02-14 09:00:00.000,2021-09-16 10:11:33.897
10348,33,2172,충남,12,11,1,7436,2021-02-14 09:00:00.000,2021-09-16 10:11:33.897
10349,53,1084,전북,6,5,1,7435,2021-02-14 09:00:00.000,2021-09-16 10:11:33.897
10350,7,774,전남,2,1,1,7434,2021-02-14 09:00:00.000,2021-09-16 10:11:33.897
10351,70,3093,경북,5,4,1,7433,2021-02-14 09:00:00.000,2021-09-16 10:11:33.897
10352,10,2103,경남,6,6,0,7432,2021-02-14 09:00:00.000,2021-09-16 10:11:33.897
10353,1,547,제주,0,0,0,7431,2021-02-14 09:00:00.000,2021-09-16 10:11:33.897
10354,3,2870,검역,7,0,7,7430,2021-02-14 09:00:00.000,2021-09-16 10:11:33.897
10355,1514,83191,합계,362,345,17,7429,2021-02-13 09:00:00.000,2021-09-16 10:11:33.897
10356,352,26017,서울,136,131,5,7428,2021-02-13 09:00:00.000,2021-09-16 10:11:33.897
10357,100,3004,부산,27,26,1,7427,2021-02-13 09:00:00.000,2021-09-16 10:11:33.897
10358,211,8475,대구,14,14,0,7426,2021-02-13 09:00:00.000,2021-09-16 10:11:33.897
10359,51,4117,인천,30,29,1,7425,2021-02-13 09:00:00.000,2021-09-16 10:11:33.897
10360,19,1944,광주,3,3,0,7424,2021-02-13 09:00:00.000,2021-09-16 10:11:33.897
10361,15,1136,대전,5,5,0,7423,2021-02-13 09:00:00.000,2021-09-16 10:11:33.897
10362,37,952,울산,2,2,0,7422,2021-02-13 09:00:00.000,2021-09-16 10:11:33.897
10363,1,208,세종,5,5,0,7421,2021-02-13 09:00:00.000,2021-09-16 10:11:33.897
10364,459,21329,경기,99,97,2,7420,2021-02-13 09:00:00.000,2021-09-16 10:11:33.897
10365,35,1767,강원,2,2,0,7419,2021-02-13 09:00:00.000,2021-09-16 10:11:33.897
10366,57,1637,충북,5,4,1,7418,2021-02-13 09:00:00.000,2021-09-16 10:11:33.897
10367,33,2160,충남,15,14,1,7417,2021-02-13 09:00:00.000,2021-09-16 10:11:33.897
10368,53,1078,전북,5,5,0,7416,2021-02-13 09:00:00.000,2021-09-16 10:11:33.897
10369,7,772,전남,0,0,0,7415,2021-02-13 09:00:00.000,2021-09-16 10:11:33.897
10370,70,3088,경북,5,4,1,7414,2021-02-13 09:00:00.000,2021-09-16 10:11:33.897
10371,10,2097,경남,4,4,0,7413,2021-02-13 09:00:00.000,2021-09-16 10:11:33.897
10372,1,547,제주,0,0,0,7412,2021-02-13 09:00:00.000,2021-09-16 10:11:33.897
10373,3,2863,검역,5,0,5,7411,2021-02-13 09:00:00.000,2021-09-16 10:11:33.897
10374,1507,82829,합계,403,384,19,7410,2021-02-12 09:00:00.000,2021-09-16 10:11:33.897
10375,351,25881,서울,158,155,3,7409,2021-02-12 09:00:00.000,2021-09-16 10:11:33.897
10376,98,2977,부산,27,25,2,7408,2021-02-12 09:00:00.000,2021-09-16 10:11:33.897
10377,211,8461,대구,12,11,1,7407,2021-02-12 09:00:00.000,2021-09-16 10:11:33.897
10378,51,4087,인천,43,41,2,7406,2021-02-12 09:00:00.000,2021-09-16 10:11:33.897
10379,19,1941,광주,6,6,0,7405,2021-02-12 09:00:00.000,2021-09-16 10:11:33.897
10380,15,1131,대전,1,1,0,7404,2021-02-12 09:00:00.000,2021-09-16 10:11:33.897
10381,37,950,울산,0,0,0,7403,2021-02-12 09:00:00.000,2021-09-16 10:11:33.897
10382,1,203,세종,2,2,0,7402,2021-02-12 09:00:00.000,2021-09-16 10:11:33.897
10383,456,21230,경기,105,103,2,7401,2021-02-12 09:00:00.000,2021-09-16 10:11:33.897
10384,34,1765,강원,6,6,0,7400,2021-02-12 09:00:00.000,2021-09-16 10:11:33.897
10385,57,1632,충북,6,6,0,7399,2021-02-12 09:00:00.000,2021-09-16 10:11:33.897
10386,33,2145,충남,13,10,3,7398,2021-02-12 09:00:00.000,2021-09-16 10:11:33.897
10387,53,1073,전북,2,2,0,7397,2021-02-12 09:00:00.000,2021-09-16 10:11:33.897
10388,7,772,전남,4,4,0,7396,2021-02-12 09:00:00.000,2021-09-16 10:11:33.897
10389,70,3083,경북,4,4,0,7395,2021-02-12 09:00:00.000,2021-09-16 10:11:33.897
10390,10,2093,경남,4,4,0,7394,2021-02-12 09:00:00.000,2021-09-16 10:11:33.897
10391,1,547,제주,4,4,0,7393,2021-02-12 09:00:00.000,2021-09-16 10:11:33.897
10392,3,2858,검역,6,0,6,7392,2021-02-12 09:00:00.000,2021-09-16 10:11:33.897
10393,1496,82426,합계,504,467,37,7391,2021-02-11 09:00:00.000,2021-09-16 10:11:33.897
10394,347,25723,서울,183,177,6,7390,2021-02-11 09:00:00.000,2021-09-16 10:11:33.897
10395,97,2950,부산,29,29,0,7389,2021-02-11 09:00:00.000,2021-09-16 10:11:33.897
10396,211,8449,대구,13,10,3,7388,2021-02-11 09:00:00.000,2021-09-16 10:11:33.897
10397,51,4044,인천,25,25,0,7387,2021-02-11 09:00:00.000,2021-09-16 10:11:33.897
10398,19,1935,광주,13,9,4,7386,2021-02-11 09:00:00.000,2021-09-16 10:11:33.897
10399,15,1130,대전,3,2,1,7385,2021-02-11 09:00:00.000,2021-09-16 10:11:33.897
10400,37,950,울산,2,2,0,7384,2021-02-11 09:00:00.000,2021-09-16 10:11:33.897
10401,1,201,세종,0,0,0,7383,2021-02-11 09:00:00.000,2021-09-16 10:11:33.897
10402,451,21125,경기,188,181,7,7382,2021-02-11 09:00:00.000,2021-09-16 10:11:33.897
10403,34,1759,강원,11,11,0,7381,2021-02-11 09:00:00.000,2021-09-16 10:11:33.897
10404,57,1626,충북,4,3,1,7380,2021-02-11 09:00:00.000,2021-09-16 10:11:33.897
10405,33,2132,충남,1,1,0,7379,2021-02-11 09:00:00.000,2021-09-16 10:11:33.897
10406,52,1071,전북,7,7,0,7378,2021-02-11 09:00:00.000,2021-09-16 10:11:33.897
10407,7,768,전남,0,0,0,7377,2021-02-11 09:00:00.000,2021-09-16 10:11:33.897
10408,70,3079,경북,1,1,0,7376,2021-02-11 09:00:00.000,2021-09-16 10:11:33.897
10409,10,2089,경남,5,5,0,7375,2021-02-11 09:00:00.000,2021-09-16 10:11:33.897
10410,1,543,제주,4,4,0,7374,2021-02-11 09:00:00.000,2021-09-16 10:11:33.897
10411,3,2852,검역,15,0,15,7373,2021-02-11 09:00:00.000,2021-09-16 10:11:33.897
10412,1486,81922,합계,444,414,30,7372,2021-02-10 09:00:00.000,2021-09-16 10:11:33.897
10413,343,25540,서울,175,169,6,7371,2021-02-10 09:00:00.000,2021-09-16 10:11:33.897
10414,96,2921,부산,19,18,1,7370,2021-02-10 09:00:00.000,2021-09-16 10:11:33.897
10415,211,8436,대구,16,14,2,7369,2021-02-10 09:00:00.000,2021-09-16 10:11:33.897
10416,51,4019,인천,20,18,2,7368,2021-02-10 09:00:00.000,2021-09-16 10:11:33.897
10417,19,1922,광주,14,14,0,7367,2021-02-10 09:00:00.000,2021-09-16 10:11:33.897
10418,15,1127,대전,0,0,0,7366,2021-02-10 09:00:00.000,2021-09-16 10:11:33.897
10419,37,948,울산,0,0,0,7365,2021-02-10 09:00:00.000,2021-09-16 10:11:33.897
10420,1,201,세종,1,1,0,7364,2021-02-10 09:00:00.000,2021-09-16 10:11:33.897
10421,448,20937,경기,169,157,12,7363,2021-02-10 09:00:00.000,2021-09-16 10:11:33.897
10422,34,1748,강원,5,5,0,7362,2021-02-10 09:00:00.000,2021-09-16 10:11:33.897
10423,57,1622,충북,2,2,0,7361,2021-02-10 09:00:00.000,2021-09-16 10:11:33.897
10424,33,2131,충남,2,2,0,7360,2021-02-10 09:00:00.000,2021-09-16 10:11:33.897
10425,51,1064,전북,2,2,0,7359,2021-02-10 09:00:00.000,2021-09-16 10:11:33.897
10426,7,768,전남,2,1,1,7358,2021-02-10 09:00:00.000,2021-09-16 10:11:33.897
10427,70,3078,경북,2,2,0,7357,2021-02-10 09:00:00.000,2021-09-16 10:11:33.897
10428,10,2084,경남,9,9,0,7356,2021-02-10 09:00:00.000,2021-09-16 10:11:33.897
10429,0,539,제주,0,0,0,7355,2021-02-10 09:00:00.000,2021-09-16 10:11:33.897
10430,3,2837,검역,6,0,6,7354,2021-02-10 09:00:00.000,2021-09-16 10:11:33.897
10431,1482,81478,합계,303,273,30,7353,2021-02-09 09:00:00.000,2021-09-16 10:11:33.897
10432,341,25365,서울,90,86,4,7352,2021-02-09 09:00:00.000,2021-09-16 10:11:33.897
10433,96,2902,부산,9,9,0,7351,2021-02-09 09:00:00.000,2021-09-16 10:11:33.897
10434,211,8420,대구,9,9,0,7350,2021-02-09 09:00:00.000,2021-09-16 10:11:33.897
10435,51,3999,인천,16,14,2,7349,2021-02-09 09:00:00.000,2021-09-16 10:11:33.897
10436,19,1908,광주,8,8,0,7348,2021-02-09 09:00:00.000,2021-09-16 10:11:33.897
10437,15,1127,대전,2,2,0,7347,2021-02-09 09:00:00.000,2021-09-16 10:11:33.897
10438,37,948,울산,3,3,0,7346,2021-02-09 09:00:00.000,2021-09-16 10:11:33.897
10439,1,200,세종,1,1,0,7345,2021-02-09 09:00:00.000,2021-09-16 10:11:33.897
10440,446,20768,경기,126,117,9,7344,2021-02-09 09:00:00.000,2021-09-16 10:11:33.897
10441,34,1743,강원,3,3,0,7343,2021-02-09 09:00:00.000,2021-09-16 10:11:33.897
10442,57,1620,충북,3,2,1,7342,2021-02-09 09:00:00.000,2021-09-16 10:11:33.897
10443,33,2129,충남,5,5,0,7341,2021-02-09 09:00:00.000,2021-09-16 10:11:33.897
10444,51,1062,전북,3,3,0,7340,2021-02-09 09:00:00.000,2021-09-16 10:11:33.897
10445,7,766,전남,0,0,0,7339,2021-02-09 09:00:00.000,2021-09-16 10:11:33.897
10446,70,3076,경북,5,4,1,7338,2021-02-09 09:00:00.000,2021-09-16 10:11:33.897
10447,10,2075,경남,7,5,2,7337,2021-02-09 09:00:00.000,2021-09-16 10:11:33.897
10448,0,539,제주,2,2,0,7336,2021-02-09 09:00:00.000,2021-09-16 10:11:33.897
10449,3,2831,검역,11,0,11,7335,2021-02-09 09:00:00.000,2021-09-16 10:11:33.897
10450,1474,81175,합계,288,264,24,7334,2021-02-08 09:00:00.000,2021-09-16 10:11:33.897
10451,339,25275,서울,112,111,1,7333,2021-02-08 09:00:00.000,2021-09-16 10:11:33.897
10452,96,2893,부산,9,7,2,7332,2021-02-08 09:00:00.000,2021-09-16 10:11:33.897
10453,211,8411,대구,21,20,1,7331,2021-02-08 09:00:00.000,2021-09-16 10:11:33.897
10454,51,3983,인천,18,17,1,7330,2021-02-08 09:00:00.000,2021-09-16 10:11:33.897
10455,19,1900,광주,7,7,0,7329,2021-02-08 09:00:00.000,2021-09-16 10:11:33.897
10456,14,1125,대전,4,4,0,7328,2021-02-08 09:00:00.000,2021-09-16 10:11:33.897
10457,37,945,울산,1,0,1,7327,2021-02-08 09:00:00.000,2021-09-16 10:11:33.897
10458,1,199,세종,1,1,0,7326,2021-02-08 09:00:00.000,2021-09-16 10:11:33.897
10459,442,20642,경기,83,79,4,7325,2021-02-08 09:00:00.000,2021-09-16 10:11:33.897
10460,33,1740,강원,4,4,0,7324,2021-02-08 09:00:00.000,2021-09-16 10:11:33.897
10461,57,1617,충북,0,0,0,7323,2021-02-08 09:00:00.000,2021-09-16 10:11:33.897
10462,33,2124,충남,10,5,5,7322,2021-02-08 09:00:00.000,2021-09-16 10:11:33.897
10463,51,1059,전북,0,0,0,7321,2021-02-08 09:00:00.000,2021-09-16 10:11:33.897
10464,7,766,전남,0,0,0,7320,2021-02-08 09:00:00.000,2021-09-16 10:11:33.897
10465,70,3071,경북,6,5,1,7319,2021-02-08 09:00:00.000,2021-09-16 10:11:33.897
10466,10,2068,경남,4,4,0,7318,2021-02-08 09:00:00.000,2021-09-16 10:11:33.897
10467,0,537,제주,0,0,0,7317,2021-02-08 09:00:00.000,2021-09-16 10:11:33.897
10468,3,2820,검역,8,0,8,7316,2021-02-08 09:00:00.000,2021-09-16 10:11:33.897
10469,1471,80887,합계,371,325,46,7315,2021-02-07 09:00:00.000,2021-09-16 10:11:33.897
10470,338,25163,서울,144,141,3,7314,2021-02-07 09:00:00.000,2021-09-16 10:11:33.897
10471,96,2884,부산,9,8,1,7313,2021-02-07 09:00:00.000,2021-09-16 10:11:33.897
10472,210,8390,대구,12,11,1,7312,2021-02-07 09:00:00.000,2021-09-16 10:11:33.897
10473,51,3965,인천,17,15,2,7311,2021-02-07 09:00:00.000,2021-09-16 10:11:33.897
10474,19,1893,광주,10,10,0,7310,2021-02-07 09:00:00.000,2021-09-16 10:11:33.897
10475,14,1121,대전,6,6,0,7309,2021-02-07 09:00:00.000,2021-09-16 10:11:33.897
10476,37,944,울산,1,0,1,7308,2021-02-07 09:00:00.000,2021-09-16 10:11:33.897
10477,1,198,세종,1,1,0,7307,2021-02-07 09:00:00.000,2021-09-16 10:11:33.897
10478,442,20559,경기,112,108,4,7306,2021-02-07 09:00:00.000,2021-09-16 10:11:33.897
10479,33,1736,강원,6,5,1,7305,2021-02-07 09:00:00.000,2021-09-16 10:11:33.897
10480,57,1617,충북,1,1,0,7304,2021-02-07 09:00:00.000,2021-09-16 10:11:33.897
10481,33,2114,충남,14,8,6,7303,2021-02-07 09:00:00.000,2021-09-16 10:11:33.897
10482,50,1059,전북,0,0,0,7302,2021-02-07 09:00:00.000,2021-09-16 10:11:33.897
10483,7,766,전남,4,4,0,7301,2021-02-07 09:00:00.000,2021-09-16 10:11:33.897
10484,70,3065,경북,1,1,0,7300,2021-02-07 09:00:00.000,2021-09-16 10:11:33.897
10485,10,2064,경남,4,4,0,7299,2021-02-07 09:00:00.000,2021-09-16 10:11:33.897
10486,0,537,제주,2,2,0,7298,2021-02-07 09:00:00.000,2021-09-16 10:11:33.897
10487,3,2812,검역,27,0,27,7297,2021-02-07 09:00:00.000,2021-09-16 10:11:33.897
10488,1464,80516,합계,390,362,28,7296,2021-02-06 09:00:00.000,2021-09-16 10:11:33.897
10489,333,25019,서울,143,142,1,7295,2021-02-06 09:00:00.000,2021-09-16 10:11:33.897
10490,96,2875,부산,14,14,0,7294,2021-02-06 09:00:00.000,2021-09-16 10:11:33.897
10491,210,8378,대구,18,17,1,7293,2021-02-06 09:00:00.000,2021-09-16 10:11:33.897
10492,51,3948,인천,25,24,1,7292,2021-02-06 09:00:00.000,2021-09-16 10:11:33.897
10493,19,1883,광주,12,12,0,7291,2021-02-06 09:00:00.000,2021-09-16 10:11:33.897
10494,14,1115,대전,8,8,0,7290,2021-02-06 09:00:00.000,2021-09-16 10:11:33.897
10495,37,943,울산,2,2,0,7289,2021-02-06 09:00:00.000,2021-09-16 10:11:33.897
10496,1,197,세종,0,0,0,7288,2021-02-06 09:00:00.000,2021-09-16 10:11:33.897
10497,440,20447,경기,111,105,6,7287,2021-02-06 09:00:00.000,2021-09-16 10:11:33.897
10498,33,1730,강원,1,1,0,7286,2021-02-06 09:00:00.000,2021-09-16 10:11:33.897
10499,57,1616,충북,2,2,0,7285,2021-02-06 09:00:00.000,2021-09-16 10:11:33.897
10500,33,2100,충남,13,13,0,7284,2021-02-06 09:00:00.000,2021-09-16 10:11:33.897
10501,50,1059,전북,4,1,3,7283,2021-02-06 09:00:00.000,2021-09-16 10:11:33.897
10502,7,762,전남,1,1,0,7282,2021-02-06 09:00:00.000,2021-09-16 10:11:33.897
10503,70,3064,경북,7,4,3,7281,2021-02-06 09:00:00.000,2021-09-16 10:11:33.897
10504,10,2060,경남,12,10,2,7280,2021-02-06 09:00:00.000,2021-09-16 10:11:33.897
10505,0,535,제주,6,6,0,7279,2021-02-06 09:00:00.000,2021-09-16 10:11:33.897
10506,3,2785,검역,11,0,11,7278,2021-02-06 09:00:00.000,2021-09-16 10:11:33.897
10507,1459,80126,합계,370,350,20,7277,2021-02-05 09:00:00.000,2021-09-16 10:11:33.897
10508,332,24876,서울,126,122,4,7276,2021-02-05 09:00:00.000,2021-09-16 10:11:33.897
10509,96,2861,부산,33,33,0,7275,2021-02-05 09:00:00.000,2021-09-16 10:11:33.897
10510,210,8360,대구,14,14,0,7274,2021-02-05 09:00:00.000,2021-09-16 10:11:33.897
10511,51,3923,인천,26,25,1,7273,2021-02-05 09:00:00.000,2021-09-16 10:11:33.897
10512,18,1871,광주,14,14,0,7272,2021-02-05 09:00:00.000,2021-09-16 10:11:33.897
10513,14,1107,대전,0,0,0,7271,2021-02-05 09:00:00.000,2021-09-16 10:11:33.897
10514,37,941,울산,0,0,0,7270,2021-02-05 09:00:00.000,2021-09-16 10:11:33.897
10515,1,197,세종,0,0,0,7269,2021-02-05 09:00:00.000,2021-09-16 10:11:33.897
10516,439,20336,경기,114,110,4,7268,2021-02-05 09:00:00.000,2021-09-16 10:11:33.897
10517,33,1729,강원,5,5,0,7267,2021-02-05 09:00:00.000,2021-09-16 10:11:33.897
10518,55,1614,충북,3,2,1,7266,2021-02-05 09:00:00.000,2021-09-16 10:11:33.897
10519,33,2087,충남,13,11,2,7265,2021-02-05 09:00:00.000,2021-09-16 10:11:33.897
10520,50,1055,전북,0,0,0,7264,2021-02-05 09:00:00.000,2021-09-16 10:11:33.897
10521,7,761,전남,0,0,0,7263,2021-02-05 09:00:00.000,2021-09-16 10:11:33.897
10522,70,3057,경북,7,6,1,7262,2021-02-05 09:00:00.000,2021-09-16 10:11:33.897
10523,10,2048,경남,6,6,0,7261,2021-02-05 09:00:00.000,2021-09-16 10:11:33.897
10524,0,529,제주,2,2,0,7260,2021-02-05 09:00:00.000,2021-09-16 10:11:33.897
10525,3,2774,검역,7,0,7,7259,2021-02-05 09:00:00.000,2021-09-16 10:11:33.897
10526,1448,79756,합계,451,429,22,7258,2021-02-04 09:00:00.000,2021-09-16 10:11:33.897
10527,329,24750,서울,172,166,6,7257,2021-02-04 09:00:00.000,2021-09-16 10:11:33.897
10528,95,2828,부산,26,26,0,7256,2021-02-04 09:00:00.000,2021-09-16 10:11:33.897
10529,210,8346,대구,8,7,1,7255,2021-02-04 09:00:00.000,2021-09-16 10:11:33.897
10530,51,3897,인천,44,43,1,7254,2021-02-04 09:00:00.000,2021-09-16 10:11:33.897
10531,18,1857,광주,12,12,0,7253,2021-02-04 09:00:00.000,2021-09-16 10:11:33.897
10532,14,1107,대전,2,2,0,7252,2021-02-04 09:00:00.000,2021-09-16 10:11:33.897
10533,37,941,울산,2,2,0,7251,2021-02-04 09:00:00.000,2021-09-16 10:11:33.897
10534,1,197,세종,0,0,0,7250,2021-02-04 09:00:00.000,2021-09-16 10:11:33.897
10535,434,20222,경기,134,128,6,7249,2021-02-04 09:00:00.000,2021-09-16 10:11:33.897
10536,33,1724,강원,8,8,0,7248,2021-02-04 09:00:00.000,2021-09-16 10:11:33.897
10537,55,1611,충북,4,4,0,7247,2021-02-04 09:00:00.000,2021-09-16 10:11:33.897
10538,33,2074,충남,13,13,0,7246,2021-02-04 09:00:00.000,2021-09-16 10:11:33.897
10539,50,1055,전북,1,1,0,7245,2021-02-04 09:00:00.000,2021-09-16 10:11:33.897
10540,7,761,전남,2,2,0,7244,2021-02-04 09:00:00.000,2021-09-16 10:11:33.897
10541,68,3050,경북,6,6,0,7243,2021-02-04 09:00:00.000,2021-09-16 10:11:33.897
10542,10,2042,경남,8,7,1,7242,2021-02-04 09:00:00.000,2021-09-16 10:11:33.897
10543,0,527,제주,3,2,1,7241,2021-02-04 09:00:00.000,2021-09-16 10:11:33.897
10544,3,2767,검역,6,0,6,7240,2021-02-04 09:00:00.000,2021-09-16 10:11:33.897
10545,1441,79305,합계,467,433,34,7239,2021-02-03 09:00:00.000,2021-09-16 10:11:33.897
10546,327,24578,서울,188,184,4,7238,2021-02-03 09:00:00.000,2021-09-16 10:11:33.897
10547,95,2802,부산,19,18,1,7237,2021-02-03 09:00:00.000,2021-09-16 10:11:33.897
10548,209,8338,대구,9,9,0,7236,2021-02-03 09:00:00.000,2021-09-16 10:11:33.897
10549,50,3853,인천,21,18,3,7235,2021-02-03 09:00:00.000,2021-09-16 10:11:33.897
10550,18,1845,광주,6,6,0,7234,2021-02-03 09:00:00.000,2021-09-16 10:11:33.897
10551,14,1105,대전,7,7,0,7233,2021-02-03 09:00:00.000,2021-09-16 10:11:33.897
10552,36,939,울산,0,0,0,7232,2021-02-03 09:00:00.000,2021-09-16 10:11:33.897
10553,1,197,세종,1,1,0,7231,2021-02-03 09:00:00.000,2021-09-16 10:11:33.897
10554,432,20088,경기,111,107,4,7230,2021-02-03 09:00:00.000,2021-09-16 10:11:33.897
10555,33,1716,강원,6,5,1,7229,2021-02-03 09:00:00.000,2021-09-16 10:11:33.897
10556,55,1607,충북,9,8,1,7228,2021-02-03 09:00:00.000,2021-09-16 10:11:33.897
10557,33,2061,충남,36,35,1,7227,2021-02-03 09:00:00.000,2021-09-16 10:11:33.897
10558,50,1054,전북,10,10,0,7226,2021-02-03 09:00:00.000,2021-09-16 10:11:33.897
10559,7,759,전남,6,6,0,7225,2021-02-03 09:00:00.000,2021-09-16 10:11:33.897
10560,68,3044,경북,12,10,2,7224,2021-02-03 09:00:00.000,2021-09-16 10:11:33.897
10561,10,2034,경남,8,8,0,7223,2021-02-03 09:00:00.000,2021-09-16 10:11:33.897
10562,0,524,제주,1,1,0,7222,2021-02-03 09:00:00.000,2021-09-16 10:11:33.897
10563,3,2761,검역,17,0,17,7221,2021-02-03 09:00:00.000,2021-09-16 10:11:33.897
10564,1435,78838,합계,336,295,41,7220,2021-02-02 09:00:00.000,2021-09-16 10:11:33.897
10565,326,24390,서울,128,121,7,7219,2021-02-02 09:00:00.000,2021-09-16 10:11:33.897
10566,94,2783,부산,12,10,2,7218,2021-02-02 09:00:00.000,2021-09-16 10:11:33.897
10567,209,8329,대구,12,10,2,7217,2021-02-02 09:00:00.000,2021-09-16 10:11:33.897
10568,50,3832,인천,8,8,0,7216,2021-02-02 09:00:00.000,2021-09-16 10:11:33.897
10569,18,1839,광주,24,23,1,7215,2021-02-02 09:00:00.000,2021-09-16 10:11:33.897
10570,13,1098,대전,0,0,0,7214,2021-02-02 09:00:00.000,2021-09-16 10:11:33.897
10571,36,939,울산,1,0,1,7213,2021-02-02 09:00:00.000,2021-09-16 10:11:33.897
10572,1,196,세종,0,0,0,7212,2021-02-02 09:00:00.000,2021-09-16 10:11:33.897
10573,429,19977,경기,82,70,12,7211,2021-02-02 09:00:00.000,2021-09-16 10:11:33.897
10574,33,1710,강원,7,7,0,7210,2021-02-02 09:00:00.000,2021-09-16 10:11:33.897
10575,55,1598,충북,18,18,0,7209,2021-02-02 09:00:00.000,2021-09-16 10:11:33.897
10576,33,2025,충남,5,5,0,7208,2021-02-02 09:00:00.000,2021-09-16 10:11:33.897
10577,50,1044,전북,2,2,0,7207,2021-02-02 09:00:00.000,2021-09-16 10:11:33.897
10578,7,753,전남,3,2,1,7206,2021-02-02 09:00:00.000,2021-09-16 10:11:33.897
10579,68,3032,경북,10,10,0,7205,2021-02-02 09:00:00.000,2021-09-16 10:11:33.897
10580,10,2026,경남,11,9,2,7204,2021-02-02 09:00:00.000,2021-09-16 10:11:33.897
10581,0,523,제주,1,0,1,7203,2021-02-02 09:00:00.000,2021-09-16 10:11:33.897
10582,3,2744,검역,12,0,12,7202,2021-02-02 09:00:00.000,2021-09-16 10:11:33.897
10583,1425,78502,합계,305,285,20,7201,2021-02-01 09:00:00.000,2021-09-16 10:11:33.897
10584,325,24262,서울,107,104,3,7200,2021-02-01 09:00:00.000,2021-09-16 10:11:33.897
10585,94,2771,부산,15,15,0,7199,2021-02-01 09:00:00.000,2021-09-16 10:11:33.897
10586,208,8317,대구,9,9,0,7198,2021-02-01 09:00:00.000,2021-09-16 10:11:33.897
10587,50,3824,인천,11,11,0,7197,2021-02-01 09:00:00.000,2021-09-16 10:11:33.897
10588,18,1815,광주,32,32,0,7196,2021-02-01 09:00:00.000,2021-09-16 10:11:33.897
10589,13,1098,대전,1,0,1,7195,2021-02-01 09:00:00.000,2021-09-16 10:11:33.897
10590,36,938,울산,1,0,1,7194,2021-02-01 09:00:00.000,2021-09-16 10:11:33.897
10591,1,196,세종,0,0,0,7193,2021-02-01 09:00:00.000,2021-09-16 10:11:33.897
10592,426,19895,경기,92,89,3,7192,2021-02-01 09:00:00.000,2021-09-16 10:11:33.897
10593,32,1703,강원,8,8,0,7191,2021-02-01 09:00:00.000,2021-09-16 10:11:33.897
10594,55,1580,충북,6,5,1,7190,2021-02-01 09:00:00.000,2021-09-16 10:11:33.897
10595,33,2020,충남,4,3,1,7189,2021-02-01 09:00:00.000,2021-09-16 10:11:33.897
10596,47,1042,전북,3,1,2,7188,2021-02-01 09:00:00.000,2021-09-16 10:11:33.897
10597,7,750,전남,1,0,1,7187,2021-02-01 09:00:00.000,2021-09-16 10:11:33.897
10598,68,3022,경북,5,4,1,7186,2021-02-01 09:00:00.000,2021-09-16 10:11:33.897
10599,9,2015,경남,4,4,0,7185,2021-02-01 09:00:00.000,2021-09-16 10:11:33.897
10600,0,522,제주,0,0,0,7184,2021-02-01 09:00:00.000,2021-09-16 10:11:33.897
10601,3,2732,검역,6,0,6,7183,2021-02-01 09:00:00.000,2021-09-16 10:11:33.897
10602,1420,78197,합계,354,323,31,7182,2021-01-31 09:00:00.000,2021-09-16 10:11:33.897
10603,324,24155,서울,100,97,3,7181,2021-01-31 09:00:00.000,2021-09-16 10:11:33.897
10604,93,2756,부산,20,20,0,7180,2021-01-31 09:00:00.000,2021-09-16 10:11:33.897
10605,207,8308,대구,10,9,1,7179,2021-01-31 09:00:00.000,2021-09-16 10:11:33.897
10606,50,3813,인천,21,19,2,7178,2021-01-31 09:00:00.000,2021-09-16 10:11:33.897
10607,18,1783,광주,17,16,1,7177,2021-01-31 09:00:00.000,2021-09-16 10:11:33.897
10608,13,1097,대전,0,0,0,7176,2021-01-31 09:00:00.000,2021-09-16 10:11:33.897
10609,36,937,울산,6,6,0,7175,2021-01-31 09:00:00.000,2021-09-16 10:11:33.897
10610,1,196,세종,2,2,0,7174,2021-01-31 09:00:00.000,2021-09-16 10:11:33.897
10611,425,19803,경기,113,107,6,7173,2021-01-31 09:00:00.000,2021-09-16 10:11:33.897
10612,32,1695,강원,6,6,0,7172,2021-01-31 09:00:00.000,2021-09-16 10:11:33.897
10613,55,1574,충북,1,1,0,7171,2021-01-31 09:00:00.000,2021-09-16 10:11:33.897
10614,33,2016,충남,5,4,1,7170,2021-01-31 09:00:00.000,2021-09-16 10:11:33.897
10615,46,1039,전북,2,2,0,7169,2021-01-31 09:00:00.000,2021-09-16 10:11:33.897
10616,7,749,전남,1,1,0,7168,2021-01-31 09:00:00.000,2021-09-16 10:11:33.897
10617,68,3017,경북,16,15,1,7167,2021-01-31 09:00:00.000,2021-09-16 10:11:33.897
10618,9,2011,경남,18,18,0,7166,2021-01-31 09:00:00.000,2021-09-16 10:11:33.897
10619,0,522,제주,1,0,1,7165,2021-01-31 09:00:00.000,2021-09-16 10:11:33.897
10620,3,2726,검역,15,0,15,7164,2021-01-31 09:00:00.000,2021-09-16 10:11:33.897
10621,1414,77843,합계,456,421,35,7163,2021-01-30 09:00:00.000,2021-09-16 10:11:33.897
10622,323,24055,서울,152,150,2,7162,2021-01-30 09:00:00.000,2021-09-16 10:11:33.897
10623,93,2736,부산,20,18,2,7161,2021-01-30 09:00:00.000,2021-09-16 10:11:33.897
10624,207,8298,대구,8,8,0,7160,2021-01-30 09:00:00.000,2021-09-16 10:11:33.897
10625,48,3792,인천,15,15,0,7159,2021-01-30 09:00:00.000,2021-09-16 10:11:33.897
10626,17,1766,광주,33,32,1,7158,2021-01-30 09:00:00.000,2021-09-16 10:11:33.897
10627,13,1097,대전,2,1,1,7157,2021-01-30 09:00:00.000,2021-09-16 10:11:33.897
10628,36,931,울산,2,1,1,7156,2021-01-30 09:00:00.000,2021-09-16 10:11:33.897
10629,1,194,세종,0,0,0,7155,2021-01-30 09:00:00.000,2021-09-16 10:11:33.897
10630,425,19690,경기,146,136,10,7154,2021-01-30 09:00:00.000,2021-09-16 10:11:33.897
10631,32,1689,강원,3,3,0,7153,2021-01-30 09:00:00.000,2021-09-16 10:11:33.897
10632,55,1573,충북,11,11,0,7152,2021-01-30 09:00:00.000,2021-09-16 10:11:33.897
10633,33,2011,충남,9,8,1,7151,2021-01-30 09:00:00.000,2021-09-16 10:11:33.897
10634,45,1037,전북,3,3,0,7150,2021-01-30 09:00:00.000,2021-09-16 10:11:33.897
10635,7,748,전남,1,1,0,7149,2021-01-30 09:00:00.000,2021-09-16 10:11:33.897
10636,67,3001,경북,22,21,1,7148,2021-01-30 09:00:00.000,2021-09-16 10:11:33.897
10637,9,1993,경남,12,11,1,7147,2021-01-30 09:00:00.000,2021-09-16 10:11:33.897
10638,0,521,제주,2,2,0,7146,2021-01-30 09:00:00.000,2021-09-16 10:11:33.897
10639,3,2711,검역,15,0,15,7145,2021-01-30 09:00:00.000,2021-09-16 10:11:33.897
10640,1399,77387,합계,469,445,24,7144,2021-01-29 09:00:00.000,2021-09-16 10:11:33.897
10641,317,23903,서울,112,109,3,7143,2021-01-29 09:00:00.000,2021-09-16 10:11:33.897
10642,92,2716,부산,34,34,0,7142,2021-01-29 09:00:00.000,2021-09-16 10:11:33.897
10643,207,8290,대구,10,10,0,7141,2021-01-29 09:00:00.000,2021-09-16 10:11:33.897
10644,48,3777,인천,19,18,1,7140,2021-01-29 09:00:00.000,2021-09-16 10:11:33.897
10645,17,1733,광주,54,54,0,7139,2021-01-29 09:00:00.000,2021-09-16 10:11:33.897
10646,13,1095,대전,1,1,0,7138,2021-01-29 09:00:00.000,2021-09-16 10:11:33.897
10647,36,929,울산,2,2,0,7137,2021-01-29 09:00:00.000,2021-09-16 10:11:33.897
10648,1,194,세종,0,0,0,7136,2021-01-29 09:00:00.000,2021-09-16 10:11:33.897
10649,422,19544,경기,135,129,6,7135,2021-01-29 09:00:00.000,2021-09-16 10:11:33.897
10650,30,1686,강원,8,7,1,7134,2021-01-29 09:00:00.000,2021-09-16 10:11:33.897
10651,54,1562,충북,9,9,0,7133,2021-01-29 09:00:00.000,2021-09-16 10:11:33.897
10652,33,2002,충남,6,6,0,7132,2021-01-29 09:00:00.000,2021-09-16 10:11:33.897
10653,44,1034,전북,6,4,2,7131,2021-01-29 09:00:00.000,2021-09-16 10:11:33.897
10654,7,747,전남,5,5,0,7130,2021-01-29 09:00:00.000,2021-09-16 10:11:33.897
10655,66,2979,경북,43,41,2,7129,2021-01-29 09:00:00.000,2021-09-16 10:11:33.897
10656,9,1981,경남,15,15,0,7128,2021-01-29 09:00:00.000,2021-09-16 10:11:33.897
10657,0,519,제주,1,1,0,7127,2021-01-29 09:00:00.000,2021-09-16 10:11:33.897
10658,3,2696,검역,9,0,9,7126,2021-01-29 09:00:00.000,2021-09-16 10:11:33.897
10659,1386,76918,합계,497,479,18,7125,2021-01-28 09:00:00.000,2021-09-16 10:11:33.897
10660,311,23791,서울,105,102,3,7124,2021-01-28 09:00:00.000,2021-09-16 10:11:33.897
10661,91,2682,부산,54,53,1,7123,2021-01-28 09:00:00.000,2021-09-16 10:11:33.897
10662,207,8280,대구,11,10,1,7122,2021-01-28 09:00:00.000,2021-09-16 10:11:33.897
10663,48,3758,인천,41,40,1,7121,2021-01-28 09:00:00.000,2021-09-16 10:11:33.897
10664,17,1679,광주,44,44,0,7120,2021-01-28 09:00:00.000,2021-09-16 10:11:33.897
10665,13,1094,대전,4,4,0,7119,2021-01-28 09:00:00.000,2021-09-16 10:11:33.897
10666,36,927,울산,6,5,1,7118,2021-01-28 09:00:00.000,2021-09-16 10:11:33.897
10667,1,194,세종,1,0,1,7117,2021-01-28 09:00:00.000,2021-09-16 10:11:33.897
10668,418,19409,경기,118,116,2,7116,2021-01-28 09:00:00.000,2021-09-16 10:11:33.897
10669,30,1678,강원,6,6,0,7115,2021-01-28 09:00:00.000,2021-09-16 10:11:33.897
10670,53,1553,충북,25,24,1,7114,2021-01-28 09:00:00.000,2021-09-16 10:11:33.897
10671,33,1996,충남,4,4,0,7113,2021-01-28 09:00:00.000,2021-09-16 10:11:33.897
10672,44,1028,전북,1,1,0,7112,2021-01-28 09:00:00.000,2021-09-16 10:11:33.897
10673,6,742,전남,8,8,0,7111,2021-01-28 09:00:00.000,2021-09-16 10:11:33.897
10674,66,2936,경북,43,43,0,7110,2021-01-28 09:00:00.000,2021-09-16 10:11:33.897
10675,9,1966,경남,19,19,0,7109,2021-01-28 09:00:00.000,2021-09-16 10:11:33.897
10676,0,518,제주,0,0,0,7108,2021-01-28 09:00:00.000,2021-09-16 10:11:33.897
10677,3,2687,검역,7,0,7,7107,2021-01-28 09:00:00.000,2021-09-16 10:11:33.897
10678,1378,76421,합계,559,516,43,7106,2021-01-27 09:00:00.000,2021-09-16 10:11:33.897
10679,307,23686,서울,129,120,9,7105,2021-01-27 09:00:00.000,2021-09-16 10:11:33.897
10680,89,2628,부산,32,31,1,7104,2021-01-27 09:00:00.000,2021-09-16 10:11:33.897
10681,207,8269,대구,6,6,0,7103,2021-01-27 09:00:00.000,2021-09-16 10:11:33.897
10682,47,3717,인천,20,17,3,7102,2021-01-27 09:00:00.000,2021-09-16 10:11:33.897
10683,17,1635,광주,112,112,0,7101,2021-01-27 09:00:00.000,2021-09-16 10:11:33.897
10684,13,1090,대전,1,1,0,7100,2021-01-27 09:00:00.000,2021-09-16 10:11:33.897
10685,36,921,울산,6,5,1,7099,2021-01-27 09:00:00.000,2021-09-16 10:11:33.897
10686,1,193,세종,4,4,0,7098,2021-01-27 09:00:00.000,2021-09-16 10:11:33.897
10687,418,19291,경기,150,137,13,7097,2021-01-27 09:00:00.000,2021-09-16 10:11:33.897
10688,30,1672,강원,18,18,0,7096,2021-01-27 09:00:00.000,2021-09-16 10:11:33.897
10689,53,1528,충북,8,8,0,7095,2021-01-27 09:00:00.000,2021-09-16 10:11:33.897
10690,33,1992,충남,4,4,0,7094,2021-01-27 09:00:00.000,2021-09-16 10:11:33.897
10691,44,1027,전북,13,11,2,7093,2021-01-27 09:00:00.000,2021-09-16 10:11:33.897
10692,6,734,전남,12,12,0,7092,2021-01-27 09:00:00.000,2021-09-16 10:11:33.897
10693,65,2893,경북,11,10,1,7091,2021-01-27 09:00:00.000,2021-09-16 10:11:33.897
10694,9,1947,경남,21,20,1,7090,2021-01-27 09:00:00.000,2021-09-16 10:11:33.897
10695,0,518,제주,0,0,0,7089,2021-01-27 09:00:00.000,2021-09-16 10:11:33.897
10696,3,2680,검역,12,0,12,7088,2021-01-27 09:00:00.000,2021-09-16 10:11:33.897
10697,1371,75862,합계,349,333,16,7087,2021-01-26 09:00:00.000,2021-09-16 10:11:33.897
10698,304,23557,서울,104,101,3,7086,2021-01-26 09:00:00.000,2021-09-16 10:11:33.897
10699,89,2596,부산,27,27,0,7085,2021-01-26 09:00:00.000,2021-09-16 10:11:33.897
10700,207,8263,대구,13,12,1,7084,2021-01-26 09:00:00.000,2021-09-16 10:11:33.897
10701,47,3697,인천,18,16,2,7083,2021-01-26 09:00:00.000,2021-09-16 10:11:33.897
10702,16,1523,광주,12,12,0,7082,2021-01-26 09:00:00.000,2021-09-16 10:11:33.897
10703,13,1089,대전,4,4,0,7081,2021-01-26 09:00:00.000,2021-09-16 10:11:33.897
10704,36,915,울산,0,0,0,7080,2021-01-26 09:00:00.000,2021-09-16 10:11:33.897
10705,1,189,세종,2,2,0,7079,2021-01-26 09:00:00.000,2021-09-16 10:11:33.897
10706,417,19141,경기,77,74,3,7078,2021-01-26 09:00:00.000,2021-09-16 10:11:33.897
10707,30,1654,강원,43,42,1,7077,2021-01-26 09:00:00.000,2021-09-16 10:11:33.897
10708,53,1520,충북,7,7,0,7076,2021-01-26 09:00:00.000,2021-09-16 10:11:33.897
10709,33,1988,충남,6,6,0,7075,2021-01-26 09:00:00.000,2021-09-16 10:11:33.897
10710,42,1014,전북,1,1,0,7074,2021-01-26 09:00:00.000,2021-09-16 10:11:33.897
10711,6,722,전남,9,9,0,7073,2021-01-26 09:00:00.000,2021-09-16 10:11:33.897
10712,65,2882,경북,8,8,0,7072,2021-01-26 09:00:00.000,2021-09-16 10:11:33.897
10713,9,1926,경남,12,12,0,7071,2021-01-26 09:00:00.000,2021-09-16 10:11:33.897
10714,0,518,제주,0,0,0,7070,2021-01-26 09:00:00.000,2021-09-16 10:11:33.897
10715,3,2668,검역,6,0,6,7069,2021-01-26 09:00:00.000,2021-09-16 10:11:33.897
10716,1360,75513,합계,437,405,32,7068,2021-01-25 09:00:00.000,2021-09-16 10:11:33.897
10717,301,23453,서울,101,91,10,7067,2021-01-25 09:00:00.000,2021-09-16 10:11:33.897
10718,88,2569,부산,20,19,1,7066,2021-01-25 09:00:00.000,2021-09-16 10:11:33.897
10719,207,8250,대구,15,14,1,7065,2021-01-25 09:00:00.000,2021-09-16 10:11:33.897
10720,46,3679,인천,14,13,1,7064,2021-01-25 09:00:00.000,2021-09-16 10:11:33.897
10721,16,1511,광주,16,15,1,7063,2021-01-25 09:00:00.000,2021-09-16 10:11:33.897
10722,13,1085,대전,125,125,0,7062,2021-01-25 09:00:00.000,2021-09-16 10:11:33.897
10723,36,915,울산,2,2,0,7061,2021-01-25 09:00:00.000,2021-09-16 10:11:33.897
10724,1,187,세종,2,2,0,7060,2021-01-25 09:00:00.000,2021-09-16 10:11:33.897
10725,414,19064,경기,77,72,5,7059,2021-01-25 09:00:00.000,2021-09-16 10:11:33.897
10726,30,1611,강원,4,3,1,7058,2021-01-25 09:00:00.000,2021-09-16 10:11:33.897
10727,53,1513,충북,8,8,0,7057,2021-01-25 09:00:00.000,2021-09-16 10:11:33.897
10728,33,1982,충남,13,13,0,7056,2021-01-25 09:00:00.000,2021-09-16 10:11:33.897
10729,42,1013,전북,0,0,0,7055,2021-01-25 09:00:00.000,2021-09-16 10:11:33.897
10730,6,713,전남,3,3,0,7054,2021-01-25 09:00:00.000,2021-09-16 10:11:33.897
10731,64,2874,경북,15,14,1,7053,2021-01-25 09:00:00.000,2021-09-16 10:11:33.897
10732,7,1914,경남,11,11,0,7052,2021-01-25 09:00:00.000,2021-09-16 10:11:33.897
10733,0,518,제주,0,0,0,7051,2021-01-25 09:00:00.000,2021-09-16 10:11:33.897
10734,3,2662,검역,11,0,11,7050,2021-01-25 09:00:00.000,2021-09-16 10:11:33.897
10735,1349,75076,합계,392,369,23,7049,2021-01-24 09:00:00.000,2021-09-16 10:11:33.897
10736,297,23352,서울,133,127,6,7048,2021-01-24 09:00:00.000,2021-09-16 10:11:33.897
10737,88,2549,부산,20,19,1,7047,2021-01-24 09:00:00.000,2021-09-16 10:11:33.897
10738,206,8235,대구,12,11,1,7046,2021-01-24 09:00:00.000,2021-09-16 10:11:33.897
10739,46,3665,인천,25,23,2,7045,2021-01-24 09:00:00.000,2021-09-16 10:11:33.897
10740,16,1495,광주,17,17,0,7044,2021-01-24 09:00:00.000,2021-09-16 10:11:33.897
10741,13,960,대전,0,0,0,7043,2021-01-24 09:00:00.000,2021-09-16 10:11:33.897
10742,36,913,울산,2,1,1,7042,2021-01-24 09:00:00.000,2021-09-16 10:11:33.897
10743,1,185,세종,11,11,0,7041,2021-01-24 09:00:00.000,2021-09-16 10:11:33.897
10744,410,18987,경기,99,99,0,7040,2021-01-24 09:00:00.000,2021-09-16 10:11:33.897
10745,30,1607,강원,11,11,0,7039,2021-01-24 09:00:00.000,2021-09-16 10:11:33.897
10746,52,1505,충북,12,12,0,7038,2021-01-24 09:00:00.000,2021-09-16 10:11:33.897
10747,32,1969,충남,9,9,0,7037,2021-01-24 09:00:00.000,2021-09-16 10:11:33.897
10748,42,1013,전북,4,3,1,7036,2021-01-24 09:00:00.000,2021-09-16 10:11:33.897
10749,6,710,전남,1,1,0,7035,2021-01-24 09:00:00.000,2021-09-16 10:11:33.897
10750,64,2859,경북,8,7,1,7034,2021-01-24 09:00:00.000,2021-09-16 10:11:33.897
10751,7,1903,경남,17,17,0,7033,2021-01-24 09:00:00.000,2021-09-16 10:11:33.897
10752,0,518,제주,2,1,1,7032,2021-01-24 09:00:00.000,2021-09-16 10:11:33.897
10753,3,2651,검역,9,0,9,7031,2021-01-24 09:00:00.000,2021-09-16 10:11:33.897
10754,1337,74684,합계,431,403,28,7030,2021-01-23 09:00:00.000,2021-09-16 10:11:33.897
10755,294,23219,서울,127,119,8,7029,2021-01-23 09:00:00.000,2021-09-16 10:11:33.897
10756,87,2529,부산,33,33,0,7028,2021-01-23 09:00:00.000,2021-09-16 10:11:33.897
10757,206,8223,대구,22,21,1,7027,2021-01-23 09:00:00.000,2021-09-16 10:11:33.897
10758,45,3640,인천,12,12,0,7026,2021-01-23 09:00:00.000,2021-09-16 10:11:33.897
10759,15,1478,광주,7,6,1,7025,2021-01-23 09:00:00.000,2021-09-16 10:11:33.897
10760,12,960,대전,1,1,0,7024,2021-01-23 09:00:00.000,2021-09-16 10:11:33.897
10761,36,911,울산,2,2,0,7023,2021-01-23 09:00:00.000,2021-09-16 10:11:33.897
10762,1,174,세종,1,1,0,7022,2021-01-23 09:00:00.000,2021-09-16 10:11:33.897
10763,407,18888,경기,117,113,4,7021,2021-01-23 09:00:00.000,2021-09-16 10:11:33.897
10764,29,1596,강원,6,5,1,7020,2021-01-23 09:00:00.000,2021-09-16 10:11:33.897
10765,51,1493,충북,4,4,0,7019,2021-01-23 09:00:00.000,2021-09-16 10:11:33.897
10766,32,1960,충남,17,17,0,7018,2021-01-23 09:00:00.000,2021-09-16 10:11:33.897
10767,42,1009,전북,7,7,0,7017,2021-01-23 09:00:00.000,2021-09-16 10:11:33.897
10768,6,709,전남,10,9,1,7016,2021-01-23 09:00:00.000,2021-09-16 10:11:33.897
10769,64,2851,경북,18,18,0,7015,2021-01-23 09:00:00.000,2021-09-16 10:11:33.897
10770,7,1886,경남,32,32,0,7014,2021-01-23 09:00:00.000,2021-09-16 10:11:33.897
10771,0,516,제주,3,3,0,7013,2021-01-23 09:00:00.000,2021-09-16 10:11:33.897
10772,3,2642,검역,12,0,12,7012,2021-01-23 09:00:00.000,2021-09-16 10:11:33.897
10773,1328,74253,합계,346,314,32,7011,2021-01-22 09:00:00.000,2021-09-16 10:11:33.897
10774,290,23092,서울,115,113,2,7010,2021-01-22 09:00:00.000,2021-09-16 10:11:33.897
10775,87,2496,부산,23,23,0,7009,2021-01-22 09:00:00.000,2021-09-16 10:11:33.897
10776,206,8201,대구,6,5,1,7008,2021-01-22 09:00:00.000,2021-09-16 10:11:33.897
10777,45,3628,인천,9,8,1,7007,2021-01-22 09:00:00.000,2021-09-16 10:11:33.897
10778,15,1471,광주,2,2,0,7006,2021-01-22 09:00:00.000,2021-09-16 10:11:33.897
10779,12,959,대전,1,1,0,7005,2021-01-22 09:00:00.000,2021-09-16 10:11:33.897
10780,36,909,울산,3,2,1,7004,2021-01-22 09:00:00.000,2021-09-16 10:11:33.897
10781,1,173,세종,0,0,0,7003,2021-01-22 09:00:00.000,2021-09-16 10:11:33.897
10782,405,18771,경기,116,102,14,7002,2021-01-22 09:00:00.000,2021-09-16 10:11:33.897
10783,29,1590,강원,9,8,1,7001,2021-01-22 09:00:00.000,2021-09-16 10:11:33.897
10784,50,1489,충북,1,1,0,7000,2021-01-22 09:00:00.000,2021-09-16 10:11:33.897
10785,31,1943,충남,7,7,0,6999,2021-01-22 09:00:00.000,2021-09-16 10:11:33.897
10786,41,1002,전북,0,0,0,6998,2021-01-22 09:00:00.000,2021-09-16 10:11:33.897
10787,6,699,전남,7,7,0,6997,2021-01-22 09:00:00.000,2021-09-16 10:11:33.897
10788,64,2833,경북,15,12,3,6996,2021-01-22 09:00:00.000,2021-09-16 10:11:33.897
10789,7,1854,경남,21,21,0,6995,2021-01-22 09:00:00.000,2021-09-16 10:11:33.897
10790,0,513,제주,2,2,0,6994,2021-01-22 09:00:00.000,2021-09-16 10:11:33.897
10791,3,2630,검역,9,0,9,6993,2021-01-22 09:00:00.000,2021-09-16 10:11:33.897
10792,1316,73907,합계,400,381,19,6992,2021-01-21 09:00:00.000,2021-09-16 10:11:33.897
10793,285,22977,서울,125,122,3,6991,2021-01-21 09:00:00.000,2021-09-16 10:11:33.897
10794,86,2473,부산,19,19,0,6990,2021-01-21 09:00:00.000,2021-09-16 10:11:33.897
10795,206,8195,대구,7,7,0,6989,2021-01-21 09:00:00.000,2021-09-16 10:11:33.897
10796,44,3619,인천,23,22,1,6988,2021-01-21 09:00:00.000,2021-09-16 10:11:33.897
10797,14,1469,광주,6,5,1,6987,2021-01-21 09:00:00.000,2021-09-16 10:11:33.897
10798,12,958,대전,0,0,0,6986,2021-01-21 09:00:00.000,2021-09-16 10:11:33.897
10799,36,906,울산,3,2,1,6985,2021-01-21 09:00:00.000,2021-09-16 10:11:33.897
10800,1,173,세종,1,1,0,6984,2021-01-21 09:00:00.000,2021-09-16 10:11:33.897
10801,403,18655,경기,138,133,5,6983,2021-01-21 09:00:00.000,2021-09-16 10:11:33.897
10802,29,1581,강원,8,6,2,6982,2021-01-21 09:00:00.000,2021-09-16 10:11:33.897
10803,48,1488,충북,7,7,0,6981,2021-01-21 09:00:00.000,2021-09-16 10:11:33.897
10804,31,1936,충남,10,10,0,6980,2021-01-21 09:00:00.000,2021-09-16 10:11:33.897
10805,41,1002,전북,5,5,0,6979,2021-01-21 09:00:00.000,2021-09-16 10:11:33.897
10806,6,692,전남,14,14,0,6978,2021-01-21 09:00:00.000,2021-09-16 10:11:33.897
10807,64,2818,경북,8,8,0,6977,2021-01-21 09:00:00.000,2021-09-16 10:11:33.897
10808,7,1833,경남,16,15,1,6976,2021-01-21 09:00:00.000,2021-09-16 10:11:33.897
10809,0,511,제주,5,5,0,6975,2021-01-21 09:00:00.000,2021-09-16 10:11:33.897
10810,3,2621,검역,5,0,5,6974,2021-01-21 09:00:00.000,2021-09-16 10:11:33.897
10811,1300,73507,합계,404,373,31,6973,2021-01-20 09:00:00.000,2021-09-16 10:11:33.897
10812,279,22852,서울,143,135,8,6972,2021-01-20 09:00:00.000,2021-09-16 10:11:33.897
10813,85,2454,부산,13,12,1,6971,2021-01-20 09:00:00.000,2021-09-16 10:11:33.897
10814,206,8188,대구,12,11,1,6970,2021-01-20 09:00:00.000,2021-09-16 10:11:33.897
10815,44,3596,인천,16,14,2,6969,2021-01-20 09:00:00.000,2021-09-16 10:11:33.897
10816,14,1463,광주,11,11,0,6968,2021-01-20 09:00:00.000,2021-09-16 10:11:33.897
10817,12,958,대전,1,1,0,6967,2021-01-20 09:00:00.000,2021-09-16 10:11:33.897
10818,36,903,울산,3,3,0,6966,2021-01-20 09:00:00.000,2021-09-16 10:11:33.897
10819,1,172,세종,0,0,0,6965,2021-01-20 09:00:00.000,2021-09-16 10:11:33.897
10820,399,18517,경기,139,126,13,6964,2021-01-20 09:00:00.000,2021-09-16 10:11:33.897
10821,28,1573,강원,11,9,2,6963,2021-01-20 09:00:00.000,2021-09-16 10:11:33.897
10822,47,1481,충북,3,2,1,6962,2021-01-20 09:00:00.000,2021-09-16 10:11:33.897
10823,30,1926,충남,8,7,1,6961,2021-01-20 09:00:00.000,2021-09-16 10:11:33.897
10824,40,997,전북,2,2,0,6960,2021-01-20 09:00:00.000,2021-09-16 10:11:33.897
10825,6,678,전남,9,9,0,6959,2021-01-20 09:00:00.000,2021-09-16 10:11:33.897
10826,64,2810,경북,7,7,0,6958,2021-01-20 09:00:00.000,2021-09-16 10:11:33.897
10827,7,1817,경남,19,18,1,6957,2021-01-20 09:00:00.000,2021-09-16 10:11:33.897
10828,0,506,제주,6,6,0,6956,2021-01-20 09:00:00.000,2021-09-16 10:11:33.897
10829,2,2616,검역,1,0,1,6955,2021-01-20 09:00:00.000,2021-09-16 10:11:33.897
10830,1283,73103,합계,386,351,35,6954,2021-01-19 09:00:00.000,2021-09-16 10:11:33.897
10831,277,22709,서울,101,95,6,6953,2021-01-19 09:00:00.000,2021-09-16 10:11:33.897
10832,85,2441,부산,17,17,0,6952,2021-01-19 09:00:00.000,2021-09-16 10:11:33.897
10833,206,8176,대구,16,15,1,6951,2021-01-19 09:00:00.000,2021-09-16 10:11:33.897
10834,44,3580,인천,19,18,1,6950,2021-01-19 09:00:00.000,2021-09-16 10:11:33.897
10835,13,1452,광주,8,7,1,6949,2021-01-19 09:00:00.000,2021-09-16 10:11:33.897
10836,12,957,대전,7,7,0,6948,2021-01-19 09:00:00.000,2021-09-16 10:11:33.897
10837,36,900,울산,8,5,3,6947,2021-01-19 09:00:00.000,2021-09-16 10:11:33.897
10838,1,172,세종,3,3,0,6946,2021-01-19 09:00:00.000,2021-09-16 10:11:33.897
10839,393,18378,경기,139,128,11,6945,2021-01-19 09:00:00.000,2021-09-16 10:11:33.897
10840,27,1562,강원,17,16,1,6944,2021-01-19 09:00:00.000,2021-09-16 10:11:33.897
10841,46,1478,충북,5,5,0,6943,2021-01-19 09:00:00.000,2021-09-16 10:11:33.897
10842,30,1918,충남,8,7,1,6942,2021-01-19 09:00:00.000,2021-09-16 10:11:33.897
10843,34,995,전북,3,2,1,6941,2021-01-19 09:00:00.000,2021-09-16 10:11:33.897
10844,6,669,전남,6,6,0,6940,2021-01-19 09:00:00.000,2021-09-16 10:11:33.897
10845,64,2803,경북,9,8,1,6939,2021-01-19 09:00:00.000,2021-09-16 10:11:33.897
10846,7,1798,경남,11,11,0,6938,2021-01-19 09:00:00.000,2021-09-16 10:11:33.897
10847,0,500,제주,1,1,0,6937,2021-01-19 09:00:00.000,2021-09-16 10:11:33.897
10848,2,2615,검역,8,0,8,6936,2021-01-19 09:00:00.000,2021-09-16 10:11:33.897
10849,1264,72717,합계,389,366,23,6935,2021-01-18 09:00:00.000,2021-09-16 10:11:33.897
10850,271,22608,서울,132,128,4,6934,2021-01-18 09:00:00.000,2021-09-16 10:11:33.897
10851,84,2424,부산,10,9,1,6933,2021-01-18 09:00:00.000,2021-09-16 10:11:33.897
10852,205,8160,대구,13,13,0,6932,2021-01-18 09:00:00.000,2021-09-16 10:11:33.897
10853,42,3561,인천,13,13,0,6931,2021-01-18 09:00:00.000,2021-09-16 10:11:33.897
10854,12,1444,광주,11,11,0,6930,2021-01-18 09:00:00.000,2021-09-16 10:11:33.897
10855,12,950,대전,2,2,0,6929,2021-01-18 09:00:00.000,2021-09-16 10:11:33.897
10856,36,892,울산,6,5,1,6928,2021-01-18 09:00:00.000,2021-09-16 10:11:33.897
10857,1,169,세종,2,2,0,6927,2021-01-18 09:00:00.000,2021-09-16 10:11:33.897
10858,389,18239,경기,105,103,2,6926,2021-01-18 09:00:00.000,2021-09-16 10:11:33.897
10859,25,1545,강원,16,14,2,6925,2021-01-18 09:00:00.000,2021-09-16 10:11:33.897
10860,44,1473,충북,9,8,1,6924,2021-01-18 09:00:00.000,2021-09-16 10:11:33.897
10861,30,1910,충남,11,11,0,6923,2021-01-18 09:00:00.000,2021-09-16 10:11:33.897
10862,34,992,전북,3,3,0,6922,2021-01-18 09:00:00.000,2021-09-16 10:11:33.897
10863,6,663,전남,4,4,0,6921,2021-01-18 09:00:00.000,2021-09-16 10:11:33.897
10864,64,2794,경북,18,18,0,6920,2021-01-18 09:00:00.000,2021-09-16 10:11:33.897
10865,7,1787,경남,22,20,2,6919,2021-01-18 09:00:00.000,2021-09-16 10:11:33.897
10866,0,499,제주,2,2,0,6918,2021-01-18 09:00:00.000,2021-09-16 10:11:33.897
10867,2,2607,검역,10,0,10,6917,2021-01-18 09:00:00.000,2021-09-16 10:11:33.897
10868,1249,72328,합계,520,500,20,6916,2021-01-17 09:00:00.000,2021-09-16 10:11:33.897
10869,265,22476,서울,145,142,3,6915,2021-01-17 09:00:00.000,2021-09-16 10:11:33.897
10870,84,2414,부산,34,32,2,6914,2021-01-17 09:00:00.000,2021-09-16 10:11:33.897
10871,205,8147,대구,15,15,0,6913,2021-01-17 09:00:00.000,2021-09-16 10:11:33.897
10872,42,3548,인천,35,35,0,6912,2021-01-17 09:00:00.000,2021-09-16 10:11:33.897
10873,12,1433,광주,15,14,1,6911,2021-01-17 09:00:00.000,2021-09-16 10:11:33.897
10874,12,948,대전,3,3,0,6910,2021-01-17 09:00:00.000,2021-09-16 10:11:33.897
10875,36,886,울산,18,15,3,6909,2021-01-17 09:00:00.000,2021-09-16 10:11:33.897
10876,1,167,세종,1,1,0,6908,2021-01-17 09:00:00.000,2021-09-16 10:11:33.897
10877,384,18134,경기,175,173,2,6907,2021-01-17 09:00:00.000,2021-09-16 10:11:33.897
10878,24,1529,강원,4,4,0,6906,2021-01-17 09:00:00.000,2021-09-16 10:11:33.897
10879,41,1464,충북,7,7,0,6905,2021-01-17 09:00:00.000,2021-09-16 10:11:33.897
10880,30,1899,충남,7,6,1,6904,2021-01-17 09:00:00.000,2021-09-16 10:11:33.897
10881,34,989,전북,5,5,0,6903,2021-01-17 09:00:00.000,2021-09-16 10:11:33.897
10882,6,659,전남,15,15,0,6902,2021-01-17 09:00:00.000,2021-09-16 10:11:33.897
10883,64,2776,경북,15,15,0,6901,2021-01-17 09:00:00.000,2021-09-16 10:11:33.897
10884,7,1765,경남,18,18,0,6900,2021-01-17 09:00:00.000,2021-09-16 10:11:33.897
10885,0,497,제주,0,0,0,6899,2021-01-17 09:00:00.000,2021-09-16 10:11:33.897
10886,2,2597,검역,8,0,8,6898,2021-01-17 09:00:00.000,2021-09-16 10:11:33.897
10887,1236,71808,합계,580,547,33,6897,2021-01-16 09:00:00.000,2021-09-16 10:11:33.897
10888,262,22331,서울,156,148,8,6896,2021-01-16 09:00:00.000,2021-09-16 10:11:33.897
10889,84,2380,부산,61,59,2,6895,2021-01-16 09:00:00.000,2021-09-16 10:11:33.897
10890,204,8132,대구,23,23,0,6894,2021-01-16 09:00:00.000,2021-09-16 10:11:33.897
10891,42,3513,인천,33,30,3,6893,2021-01-16 09:00:00.000,2021-09-16 10:11:33.897
10892,12,1418,광주,6,6,0,6892,2021-01-16 09:00:00.000,2021-09-16 10:11:33.897
10893,12,945,대전,5,5,0,6891,2021-01-16 09:00:00.000,2021-09-16 10:11:33.897
10894,36,868,울산,8,8,0,6890,2021-01-16 09:00:00.000,2021-09-16 10:11:33.897
10895,1,166,세종,1,1,0,6889,2021-01-16 09:00:00.000,2021-09-16 10:11:33.897
10896,380,17959,경기,168,163,5,6888,2021-01-16 09:00:00.000,2021-09-16 10:11:33.897
10897,24,1525,강원,23,22,1,6887,2021-01-16 09:00:00.000,2021-09-16 10:11:33.897
10898,38,1457,충북,6,6,0,6886,2021-01-16 09:00:00.000,2021-09-16 10:11:33.897
10899,29,1892,충남,8,8,0,6885,2021-01-16 09:00:00.000,2021-09-16 10:11:33.897
10900,33,984,전북,17,17,0,6884,2021-01-16 09:00:00.000,2021-09-16 10:11:33.897
10901,6,644,전남,13,13,0,6883,2021-01-16 09:00:00.000,2021-09-16 10:11:33.897
10902,64,2761,경북,20,19,1,6882,2021-01-16 09:00:00.000,2021-09-16 10:11:33.897
10903,7,1747,경남,20,15,5,6881,2021-01-16 09:00:00.000,2021-09-16 10:11:33.897
10904,0,497,제주,4,4,0,6880,2021-01-16 09:00:00.000,2021-09-16 10:11:33.897
10905,2,2589,검역,8,0,8,6879,2021-01-16 09:00:00.000,2021-09-16 10:11:33.897
10906,1217,71228,합계,512,483,5863,6878,2021-01-15 09:00:00.000,2021-09-16 10:11:33.897
10907,254,22175,서울,127,122,939,6877,2021-01-15 09:00:00.000,2021-09-16 10:11:33.897
10908,83,2319,부산,47,45,186,6876,2021-01-15 09:00:00.000,2021-09-16 10:11:33.897
10909,204,8109,대구,11,10,149,6875,2021-01-15 09:00:00.000,2021-09-16 10:11:33.897
10910,41,3480,인천,24,23,238,6874,2021-01-15 09:00:00.000,2021-09-16 10:11:33.897
10911,12,1412,광주,6,5,116,6873,2021-01-15 09:00:00.000,2021-09-16 10:11:33.897
10912,12,940,대전,3,3,58,6872,2021-01-15 09:00:00.000,2021-09-16 10:11:33.897
10913,36,860,울산,6,6,90,6871,2021-01-15 09:00:00.000,2021-09-16 10:11:33.897
10914,1,165,세종,4,4,27,6870,2021-01-15 09:00:00.000,2021-09-16 10:11:33.897
10915,376,17791,경기,186,180,1515,6869,2021-01-15 09:00:00.000,2021-09-16 10:11:33.897
10916,24,1502,강원,13,13,74,6868,2021-01-15 09:00:00.000,2021-09-16 10:11:33.897
10917,38,1451,충북,9,7,89,6867,2021-01-15 09:00:00.000,2021-09-16 10:11:33.897
10918,28,1884,충남,6,3,148,6866,2021-01-15 09:00:00.000,2021-09-16 10:11:33.897
10919,30,967,전북,6,6,112,6865,2021-01-15 09:00:00.000,2021-09-16 10:11:33.897
10920,6,631,전남,13,13,82,6864,2021-01-15 09:00:00.000,2021-09-16 10:11:33.897
10921,63,2741,경북,23,21,160,6863,2021-01-15 09:00:00.000,2021-09-16 10:11:33.897
10922,7,1727,경남,22,21,161,6862,2021-01-15 09:00:00.000,2021-09-16 10:11:33.897
10923,0,493,제주,1,1,34,6861,2021-01-15 09:00:00.000,2021-09-16 10:11:33.897
10924,2,2581,검역,5,0,1685,6860,2021-01-15 09:00:00.000,2021-09-16 10:11:33.897
10925,1195,70716,합계,524,496,28,6859,2021-01-14 09:00:00.000,2021-09-16 10:11:33.897
10926,252,22048,서울,134,131,3,6858,2021-01-14 09:00:00.000,2021-09-16 10:11:33.897
10927,81,2272,부산,40,40,0,6857,2021-01-14 09:00:00.000,2021-09-16 10:11:33.897
10928,203,8098,대구,11,11,0,6856,2021-01-14 09:00:00.000,2021-09-16 10:11:33.897
10929,40,3456,인천,25,24,1,6855,2021-01-14 09:00:00.000,2021-09-16 10:11:33.897
10930,10,1406,광주,31,30,1,6854,2021-01-14 09:00:00.000,2021-09-16 10:11:33.897
10931,11,937,대전,3,3,0,6853,2021-01-14 09:00:00.000,2021-09-16 10:11:33.897
10932,34,854,울산,10,9,1,6852,2021-01-14 09:00:00.000,2021-09-16 10:11:33.897
10933,1,161,세종,2,2,0,6851,2021-01-14 09:00:00.000,2021-09-16 10:11:33.897
10934,367,17605,경기,171,162,9,6850,2021-01-14 09:00:00.000,2021-09-16 10:11:33.897
10935,24,1489,강원,11,11,0,6849,2021-01-14 09:00:00.000,2021-09-16 10:11:33.897
10936,37,1442,충북,18,18,0,6848,2021-01-14 09:00:00.000,2021-09-16 10:11:33.897
10937,28,1878,충남,12,12,0,6847,2021-01-14 09:00:00.000,2021-09-16 10:11:33.897
10938,30,961,전북,3,3,0,6846,2021-01-14 09:00:00.000,2021-09-16 10:11:33.897
10939,6,618,전남,6,6,0,6845,2021-01-14 09:00:00.000,2021-09-16 10:11:33.897
10940,63,2718,경북,18,16,2,6844,2021-01-14 09:00:00.000,2021-09-16 10:11:33.897
10941,6,1705,경남,16,16,0,6843,2021-01-14 09:00:00.000,2021-09-16 10:11:33.897
10942,0,492,제주,2,2,0,6842,2021-01-14 09:00:00.000,2021-09-16 10:11:33.897
10943,2,2576,검역,11,0,11,6841,2021-01-14 09:00:00.000,2021-09-16 10:11:33.897
10944,1185,70192,합계,561,535,26,6840,2021-01-13 09:00:00.000,2021-09-16 10:11:33.897
10945,250,21914,서울,152,148,4,6839,2021-01-13 09:00:00.000,2021-09-16 10:11:33.897
10946,78,2232,부산,35,35,0,6838,2021-01-13 09:00:00.000,2021-09-16 10:11:33.897
10947,203,8087,대구,13,13,0,6837,2021-01-13 09:00:00.000,2021-09-16 10:11:33.897
10948,40,3431,인천,22,20,2,6836,2021-01-13 09:00:00.000,2021-09-16 10:11:33.897
10949,10,1375,광주,4,3,1,6835,2021-01-13 09:00:00.000,2021-09-16 10:11:33.897
10950,11,934,대전,9,9,0,6834,2021-01-13 09:00:00.000,2021-09-16 10:11:33.897
10951,34,844,울산,11,11,0,6833,2021-01-13 09:00:00.000,2021-09-16 10:11:33.897
10952,1,159,세종,0,0,0,6832,2021-01-13 09:00:00.000,2021-09-16 10:11:33.897
10953,364,17434,경기,201,189,12,6831,2021-01-13 09:00:00.000,2021-09-16 10:11:33.897
10954,23,1478,강원,21,20,1,6830,2021-01-13 09:00:00.000,2021-09-16 10:11:33.897
10955,37,1424,충북,11,11,0,6829,2021-01-13 09:00:00.000,2021-09-16 10:11:33.897
10956,28,1866,충남,5,4,1,6828,2021-01-13 09:00:00.000,2021-09-16 10:11:33.897
10957,30,958,전북,8,7,1,6827,2021-01-13 09:00:00.000,2021-09-16 10:11:33.897
10958,6,612,전남,0,0,0,6826,2021-01-13 09:00:00.000,2021-09-16 10:11:33.897
10959,62,2700,경북,23,22,1,6825,2021-01-13 09:00:00.000,2021-09-16 10:11:33.897
10960,6,1689,경남,42,42,0,6824,2021-01-13 09:00:00.000,2021-09-16 10:11:33.897
10961,0,490,제주,1,1,0,6823,2021-01-13 09:00:00.000,2021-09-16 10:11:33.897
10962,2,2565,검역,3,0,3,6822,2021-01-13 09:00:00.000,2021-09-16 10:11:33.897
10963,1165,69631,합계,537,510,27,6821,2021-01-12 09:00:00.000,2021-09-16 10:11:33.897
10964,248,21762,서울,167,165,2,6820,2021-01-12 09:00:00.000,2021-09-16 10:11:33.897
10965,77,2197,부산,21,21,0,6819,2021-01-12 09:00:00.000,2021-09-16 10:11:33.897
10966,203,8074,대구,18,17,1,6818,2021-01-12 09:00:00.000,2021-09-16 10:11:33.897
10967,38,3409,인천,21,20,1,6817,2021-01-12 09:00:00.000,2021-09-16 10:11:33.897
10968,10,1371,광주,7,7,0,6816,2021-01-12 09:00:00.000,2021-09-16 10:11:33.897
10969,10,925,대전,7,7,0,6815,2021-01-12 09:00:00.000,2021-09-16 10:11:33.897
10970,33,833,울산,7,7,0,6814,2021-01-12 09:00:00.000,2021-09-16 10:11:33.897
10971,1,159,세종,1,1,0,6813,2021-01-12 09:00:00.000,2021-09-16 10:11:33.897
10972,357,17233,경기,175,163,12,6812,2021-01-12 09:00:00.000,2021-09-16 10:11:33.897
10973,21,1457,강원,7,7,0,6811,2021-01-12 09:00:00.000,2021-09-16 10:11:33.897
10974,37,1413,충북,16,16,0,6810,2021-01-12 09:00:00.000,2021-09-16 10:11:33.897
10975,28,1861,충남,3,1,2,6809,2021-01-12 09:00:00.000,2021-09-16 10:11:33.897
10976,26,950,전북,12,11,1,6808,2021-01-12 09:00:00.000,2021-09-16 10:11:33.897
10977,6,612,전남,2,2,0,6807,2021-01-12 09:00:00.000,2021-09-16 10:11:33.897
10978,62,2677,경북,8,8,0,6806,2021-01-12 09:00:00.000,2021-09-16 10:11:33.897
10979,6,1647,경남,55,55,0,6805,2021-01-12 09:00:00.000,2021-09-16 10:11:33.897
10980,0,489,제주,2,2,0,6804,2021-01-12 09:00:00.000,2021-09-16 10:11:33.897
10981,2,2562,검역,8,0,8,6803,2021-01-12 09:00:00.000,2021-09-16 10:11:33.897
10982,1140,69094,합계,451,419,32,6802,2021-01-11 09:00:00.000,2021-09-16 10:11:33.897
10983,238,21595,서울,141,137,4,6801,2021-01-11 09:00:00.000,2021-09-16 10:11:33.897
10984,74,2176,부산,19,16,3,6800,2021-01-11 09:00:00.000,2021-09-16 10:11:33.897
10985,203,8056,대구,11,10,1,6799,2021-01-11 09:00:00.000,2021-09-16 10:11:33.897
10986,37,3388,인천,22,18,4,6798,2021-01-11 09:00:00.000,2021-09-16 10:11:33.897
10987,10,1364,광주,24,24,0,6797,2021-01-11 09:00:00.000,2021-09-16 10:11:33.897
10988,10,918,대전,1,1,0,6796,2021-01-11 09:00:00.000,2021-09-16 10:11:33.897
10989,32,826,울산,14,14,0,6795,2021-01-11 09:00:00.000,2021-09-16 10:11:33.897
10990,1,158,세종,0,0,0,6794,2021-01-11 09:00:00.000,2021-09-16 10:11:33.897
10991,350,17058,경기,147,142,5,6793,2021-01-11 09:00:00.000,2021-09-16 10:11:33.897
10992,20,1450,강원,11,10,1,6792,2021-01-11 09:00:00.000,2021-09-16 10:11:33.897
10993,36,1397,충북,10,9,1,6791,2021-01-11 09:00:00.000,2021-09-16 10:11:33.897
10994,27,1858,충남,11,10,1,6790,2021-01-11 09:00:00.000,2021-09-16 10:11:33.897
10995,26,938,전북,7,6,1,6789,2021-01-11 09:00:00.000,2021-09-16 10:11:33.897
10996,6,610,전남,3,3,0,6788,2021-01-11 09:00:00.000,2021-09-16 10:11:33.897
10997,62,2669,경북,4,4,0,6787,2021-01-11 09:00:00.000,2021-09-16 10:11:33.897
10998,6,1592,경남,13,13,0,6786,2021-01-11 09:00:00.000,2021-09-16 10:11:33.897
10999,0,487,제주,2,2,0,6785,2021-01-11 09:00:00.000,2021-09-16 10:11:33.897
11000,2,2554,검역,11,0,11,6784,2021-01-11 09:00:00.000,2021-09-16 10:11:33.897
11001,1125,68643,합계,657,623,34,6783,2021-01-10 09:00:00.000,2021-09-16 10:11:33.897
11002,230,21454,서울,187,179,8,6782,2021-01-10 09:00:00.000,2021-09-16 10:11:33.897
11003,74,2157,부산,34,32,2,6781,2021-01-10 09:00:00.000,2021-09-16 10:11:33.897
11004,203,8045,대구,27,27,0,6780,2021-01-10 09:00:00.000,2021-09-16 10:11:33.897
11005,36,3366,인천,33,32,1,6779,2021-01-10 09:00:00.000,2021-09-16 10:11:33.897
11006,10,1340,광주,21,18,3,6778,2021-01-10 09:00:00.000,2021-09-16 10:11:33.897
11007,10,917,대전,4,4,0,6777,2021-01-10 09:00:00.000,2021-09-16 10:11:33.897
11008,32,812,울산,34,34,0,6776,2021-01-10 09:00:00.000,2021-09-16 10:11:33.897
11009,1,158,세종,0,0,0,6775,2021-01-10 09:00:00.000,2021-09-16 10:11:33.897
11010,345,16911,경기,192,188,4,6774,2021-01-10 09:00:00.000,2021-09-16 10:11:33.897
11011,20,1439,강원,20,20,0,6773,2021-01-10 09:00:00.000,2021-09-16 10:11:33.897
11012,36,1387,충북,9,8,1,6772,2021-01-10 09:00:00.000,2021-09-16 10:11:33.897
11013,27,1847,충남,30,30,0,6771,2021-01-10 09:00:00.000,2021-09-16 10:11:33.897
11014,26,931,전북,6,6,0,6770,2021-01-10 09:00:00.000,2021-09-16 10:11:33.897
11015,6,607,전남,4,3,1,6769,2021-01-10 09:00:00.000,2021-09-16 10:11:33.897
11016,62,2665,경북,19,19,0,6768,2021-01-10 09:00:00.000,2021-09-16 10:11:33.897
11017,5,1579,경남,19,19,0,6767,2021-01-10 09:00:00.000,2021-09-16 10:11:33.897
11018,0,485,제주,4,4,0,6766,2021-01-10 09:00:00.000,2021-09-16 10:11:33.897
11019,2,2543,검역,14,0,14,6765,2021-01-10 09:00:00.000,2021-09-16 10:11:33.897
11020,1100,67986,합계,641,596,45,6764,2021-01-09 09:00:00.000,2021-09-16 10:11:33.897
11021,223,21267,서울,188,180,8,6763,2021-01-09 09:00:00.000,2021-09-16 10:11:33.897
11022,71,2123,부산,17,17,0,6762,2021-01-09 09:00:00.000,2021-09-16 10:11:33.897
11023,203,8018,대구,13,12,1,6761,2021-01-09 09:00:00.000,2021-09-16 10:11:33.897
11024,36,3333,인천,49,46,3,6760,2021-01-09 09:00:00.000,2021-09-16 10:11:33.897
11025,9,1319,광주,6,6,0,6759,2021-01-09 09:00:00.000,2021-09-16 10:11:33.897
11026,10,913,대전,5,5,0,6758,2021-01-09 09:00:00.000,2021-09-16 10:11:33.897
11027,32,778,울산,8,8,0,6757,2021-01-09 09:00:00.000,2021-09-16 10:11:33.897
11028,1,158,세종,0,0,0,6756,2021-01-09 09:00:00.000,2021-09-16 10:11:33.897
11029,335,16719,경기,211,195,16,6755,2021-01-09 09:00:00.000,2021-09-16 10:11:33.897
11030,18,1419,강원,6,5,1,6754,2021-01-09 09:00:00.000,2021-09-16 10:11:33.897
11031,36,1378,충북,30,30,0,6753,2021-01-09 09:00:00.000,2021-09-16 10:11:33.897
11032,27,1817,충남,27,26,1,6752,2021-01-09 09:00:00.000,2021-09-16 10:11:33.897
11033,24,925,전북,14,13,1,6751,2021-01-09 09:00:00.000,2021-09-16 10:11:33.897
11034,6,603,전남,5,5,0,6750,2021-01-09 09:00:00.000,2021-09-16 10:11:33.897
11035,62,2646,경북,21,20,1,6749,2021-01-09 09:00:00.000,2021-09-16 10:11:33.897
11036,5,1560,경남,26,23,3,6748,2021-01-09 09:00:00.000,2021-09-16 10:11:33.897
11037,0,481,제주,5,5,0,6747,2021-01-09 09:00:00.000,2021-09-16 10:11:33.897
11038,2,2529,검역,10,0,10,6746,2021-01-09 09:00:00.000,2021-09-16 10:11:33.897
11039,1081,67345,합계,674,632,42,6745,2021-01-08 09:00:00.000,2021-09-16 10:11:33.897
11040,223,21079,서울,191,186,5,6744,2021-01-08 09:00:00.000,2021-09-16 10:11:33.897
11041,68,2106,부산,24,22,2,6743,2021-01-08 09:00:00.000,2021-09-16 10:11:33.897
11042,203,8005,대구,18,17,1,6742,2021-01-08 09:00:00.000,2021-09-16 10:11:33.897
11043,34,3284,인천,30,30,0,6741,2021-01-08 09:00:00.000,2021-09-16 10:11:33.897
11044,9,1313,광주,21,21,0,6740,2021-01-08 09:00:00.000,2021-09-16 10:11:33.897
11045,8,908,대전,8,8,0,6739,2021-01-08 09:00:00.000,2021-09-16 10:11:33.897
11046,32,770,울산,10,10,0,6738,2021-01-08 09:00:00.000,2021-09-16 10:11:33.897
11047,1,158,세종,0,0,0,6737,2021-01-08 09:00:00.000,2021-09-16 10:11:33.897
11048,326,16508,경기,258,236,22,6736,2021-01-08 09:00:00.000,2021-09-16 10:11:33.897
11049,18,1413,강원,11,11,0,6735,2021-01-08 09:00:00.000,2021-09-16 10:11:33.897
11050,35,1348,충북,10,10,0,6734,2021-01-08 09:00:00.000,2021-09-16 10:11:33.897
11051,27,1790,충남,21,21,0,6733,2021-01-08 09:00:00.000,2021-09-16 10:11:33.897
11052,22,911,전북,8,7,1,6732,2021-01-08 09:00:00.000,2021-09-16 10:11:33.897
11053,6,598,전남,0,0,0,6731,2021-01-08 09:00:00.000,2021-09-16 10:11:33.897
11054,62,2625,경북,30,28,2,6730,2021-01-08 09:00:00.000,2021-09-16 10:11:33.897
11055,5,1534,경남,22,19,3,6729,2021-01-08 09:00:00.000,2021-09-16 10:11:33.897
11056,0,476,제주,6,6,0,6728,2021-01-08 09:00:00.000,2021-09-16 10:11:33.897
11057,2,2519,검역,6,0,6,6727,2021-01-08 09:00:00.000,2021-09-16 10:11:33.897
11058,1046,66671,합계,869,832,37,6726,2021-01-07 09:00:00.000,2021-09-16 10:11:33.897
11059,213,20888,서울,297,291,6,6725,2021-01-07 09:00:00.000,2021-09-16 10:11:33.897
11060,64,2082,부산,23,23,0,6724,2021-01-07 09:00:00.000,2021-09-16 10:11:33.897
11061,203,7987,대구,10,10,0,6723,2021-01-07 09:00:00.000,2021-09-16 10:11:33.897
11062,34,3254,인천,41,37,4,6722,2021-01-07 09:00:00.000,2021-09-16 10:11:33.897
11063,8,1292,광주,28,28,0,6721,2021-01-07 09:00:00.000,2021-09-16 10:11:33.897
11064,7,900,대전,9,9,0,6720,2021-01-07 09:00:00.000,2021-09-16 10:11:33.897
11065,32,760,울산,9,9,0,6719,2021-01-07 09:00:00.000,2021-09-16 10:11:33.897
11066,1,158,세종,3,3,0,6718,2021-01-07 09:00:00.000,2021-09-16 10:11:33.897
11067,312,16250,경기,303,294,9,6717,2021-01-07 09:00:00.000,2021-09-16 10:11:33.897
11068,17,1402,강원,30,30,0,6716,2021-01-07 09:00:00.000,2021-09-16 10:11:33.897
11069,34,1338,충북,14,14,0,6715,2021-01-07 09:00:00.000,2021-09-16 10:11:33.897
11070,25,1769,충남,20,19,1,6714,2021-01-07 09:00:00.000,2021-09-16 10:11:33.897
11071,21,903,전북,2,2,0,6713,2021-01-07 09:00:00.000,2021-09-16 10:11:33.897
11072,6,598,전남,1,0,1,6712,2021-01-07 09:00:00.000,2021-09-16 10:11:33.897
11073,62,2595,경북,36,34,2,6711,2021-01-07 09:00:00.000,2021-09-16 10:11:33.897
11074,5,1512,경남,20,20,0,6710,2021-01-07 09:00:00.000,2021-09-16 10:11:33.897
11075,0,470,제주,9,9,0,6709,2021-01-07 09:00:00.000,2021-09-16 10:11:33.897
11076,2,2513,검역,14,0,14,6708,2021-01-07 09:00:00.000,2021-09-16 10:11:33.897
11077,1027,65802,합계,838,807,31,6707,2021-01-06 09:00:00.000,2021-09-16 10:11:33.897
11078,207,20591,서울,263,262,1,6706,2021-01-06 09:00:00.000,2021-09-16 10:11:33.897
11079,63,2059,부산,38,38,0,6705,2021-01-06 09:00:00.000,2021-09-16 10:11:33.897
11080,203,7977,대구,21,20,1,6704,2021-01-06 09:00:00.000,2021-09-16 10:11:33.897
11081,33,3213,인천,38,35,3,6703,2021-01-06 09:00:00.000,2021-09-16 10:11:33.897
11082,7,1264,광주,30,30,0,6702,2021-01-06 09:00:00.000,2021-09-16 10:11:33.897
11083,7,891,대전,9,8,1,6701,2021-01-06 09:00:00.000,2021-09-16 10:11:33.897
11084,31,751,울산,2,2,0,6700,2021-01-06 09:00:00.000,2021-09-16 10:11:33.897
11085,1,155,세종,1,1,0,6699,2021-01-06 09:00:00.000,2021-09-16 10:11:33.897
11086,304,15947,경기,284,269,15,6698,2021-01-06 09:00:00.000,2021-09-16 10:11:33.897
11087,17,1372,강원,16,16,0,6697,2021-01-06 09:00:00.000,2021-09-16 10:11:33.897
11088,33,1324,충북,21,21,0,6696,2021-01-06 09:00:00.000,2021-09-16 10:11:33.897
11089,25,1749,충남,24,23,1,6695,2021-01-06 09:00:00.000,2021-09-16 10:11:33.897
11090,21,901,전북,22,22,0,6694,2021-01-06 09:00:00.000,2021-09-16 10:11:33.897
11091,6,597,전남,1,1,0,6693,2021-01-06 09:00:00.000,2021-09-16 10:11:33.897
11092,62,2559,경북,28,28,0,6692,2021-01-06 09:00:00.000,2021-09-16 10:11:33.897
11093,5,1492,경남,29,26,3,6691,2021-01-06 09:00:00.000,2021-09-16 10:11:33.897
11094,0,461,제주,5,5,0,6690,2021-01-06 09:00:00.000,2021-09-16 10:11:33.897
11095,2,2499,검역,6,0,6,6689,2021-01-06 09:00:00.000,2021-09-16 10:11:33.897
11096,1007,64964,합계,714,672,42,6688,2021-01-05 09:00:00.000,2021-09-16 10:11:33.897
11097,204,20328,서울,199,193,6,6687,2021-01-05 09:00:00.000,2021-09-16 10:11:33.897
11098,60,2021,부산,15,14,1,6686,2021-01-05 09:00:00.000,2021-09-16 10:11:33.897
11099,203,7956,대구,32,31,1,6685,2021-01-05 09:00:00.000,2021-09-16 10:11:33.897
11100,32,3175,인천,49,48,1,6684,2021-01-05 09:00:00.000,2021-09-16 10:11:33.897
11101,7,1234,광주,23,23,0,6683,2021-01-05 09:00:00.000,2021-09-16 10:11:33.897
11102,7,882,대전,8,7,1,6682,2021-01-05 09:00:00.000,2021-09-16 10:11:33.897
11103,31,749,울산,4,4,0,6681,2021-01-05 09:00:00.000,2021-09-16 10:11:33.897
11104,1,154,세종,0,0,0,6680,2021-01-05 09:00:00.000,2021-09-16 10:11:33.897
11105,295,15663,경기,230,214,16,6679,2021-01-05 09:00:00.000,2021-09-16 10:11:33.897
11106,17,1356,강원,27,27,0,6678,2021-01-05 09:00:00.000,2021-09-16 10:11:33.897
11107,32,1303,충북,32,32,0,6677,2021-01-05 09:00:00.000,2021-09-16 10:11:33.897
11108,25,1725,충남,18,18,0,6676,2021-01-05 09:00:00.000,2021-09-16 10:11:33.897
11109,18,879,전북,5,4,1,6675,2021-01-05 09:00:00.000,2021-09-16 10:11:33.897
11110,6,596,전남,4,4,0,6674,2021-01-05 09:00:00.000,2021-09-16 10:11:33.897
11111,62,2531,경북,24,24,0,6673,2021-01-05 09:00:00.000,2021-09-16 10:11:33.897
11112,5,1463,경남,21,21,0,6672,2021-01-05 09:00:00.000,2021-09-16 10:11:33.897
11113,0,456,제주,8,8,0,6671,2021-01-05 09:00:00.000,2021-09-16 10:11:33.897
11114,2,2493,검역,15,0,15,6670,2021-01-05 09:00:00.000,2021-09-16 10:11:33.897
11115,981,64264,합계,1020,985,35,6669,2021-01-04 9:00:00.000,null
11116,193,20138,서울,329,324,5,6668,2021-01-04 9:00:00.000,null
11117,58,2007,부산,37,34,3,6667,2021-01-04 9:00:00.000,null
11118,203,7924,대구,29,29,0,6666,2021-01-04 9:00:00.000,null
11119,30,3126,인천,103,101,2,6665,2021-01-04 9:00:00.000,null
11120,7,1211,광주,74,74,0,6664,2021-01-04 9:00:00.000,null
11121,7,874,대전,6,6,0,6663,2021-01-04 9:00:00.000,null
11122,30,745,울산,5,5,0,6662,2021-01-04 9:00:00.000,null
11123,1,154,세종,0,0,0,6661,2021-01-04 9:00:00.000,null
11124,292,15434,경기,268,260,8,6660,2021-01-04 9:00:00.000,null
11125,17,1329,강원,28,28,0,6659,2021-01-04 9:00:00.000,null
11126,28,1271,충북,23,23,0,6658,2021-01-04 9:00:00.000,null
11127,25,1707,충남,23,22,1,6657,2021-01-04 9:00:00.000,null
11128,16,874,전북,13,9,4,6656,2021-01-04 9:00:00.000,null
11129,5,592,전남,3,3,0,6655,2021-01-04 9:00:00.000,null
11130,62,2507,경북,25,25,0,6654,2021-01-04 9:00:00.000,null
11131,5,1442,경남,33,33,0,6653,2021-01-04 9:00:00.000,null
11132,0,448,제주,10,9,1,6652,2021-01-04 9:00:00.000,null
11133,2,2481,검역,11,0,11,6651,2021-01-04 9:00:00.000,null
11134,962,63230,합계,657,641,16,6650,2021-01-03 09:00:00.000,2021-09-16 10:11:33.897
11135,189,19800,서울,198,196,2,6649,2021-01-03 09:00:00.000,2021-09-16 10:11:33.897
11136,57,1969,부산,19,19,0,6648,2021-01-03 09:00:00.000,2021-09-16 10:11:33.897
11137,202,7895,대구,22,21,1,6647,2021-01-03 09:00:00.000,2021-09-16 10:11:33.897
11138,30,3023,인천,48,48,0,6646,2021-01-03 09:00:00.000,2021-09-16 10:11:33.897
11139,7,1137,광주,26,26,0,6645,2021-01-03 09:00:00.000,2021-09-16 10:11:33.897
11140,7,868,대전,8,8,0,6644,2021-01-03 09:00:00.000,2021-09-16 10:11:33.897
11141,29,740,울산,7,7,0,6643,2021-01-03 09:00:00.000,2021-09-16 10:11:33.897
11142,1,154,세종,1,1,0,6642,2021-01-03 09:00:00.000,2021-09-16 10:11:33.897
11143,286,15165,경기,204,200,4,6641,2021-01-03 09:00:00.000,2021-09-16 10:11:33.897
11144,15,1301,강원,33,33,0,6640,2021-01-03 09:00:00.000,2021-09-16 10:11:33.897
11145,28,1248,충북,27,26,1,6639,2021-01-03 09:00:00.000,2021-09-16 10:11:33.897
11146,24,1684,충남,9,9,0,6638,2021-01-03 09:00:00.000,2021-09-16 10:11:33.897
11147,13,861,전북,5,5,0,6637,2021-01-03 09:00:00.000,2021-09-16 10:11:33.897
11148,5,589,전남,12,12,0,6636,2021-01-03 09:00:00.000,2021-09-16 10:11:33.897
11149,62,2482,경북,14,14,0,6635,2021-01-03 09:00:00.000,2021-09-16 10:11:33.897
11150,5,1409,경남,12,12,0,6634,2021-01-03 09:00:00.000,2021-09-16 10:11:33.897
11151,0,438,제주,4,4,0,6633,2021-01-03 09:00:00.000,2021-09-16 10:11:33.897
11152,2,2467,검역,8,0,8,6632,2021-01-03 09:00:00.000,2021-09-16 10:11:33.897
11153,942,62573,합계,820,784,36,6631,2021-01-02 09:00:00.000,2021-09-16 10:11:33.897
11154,186,19602,서울,250,245,5,6630,2021-01-02 09:00:00.000,2021-09-16 10:11:33.897
11155,53,1950,부산,26,26,0,6629,2021-01-02 09:00:00.000,2021-09-16 10:11:33.897
11156,202,7873,대구,29,29,0,6628,2021-01-02 09:00:00.000,2021-09-16 10:11:33.897
11157,29,2975,인천,71,70,1,6627,2021-01-02 09:00:00.000,2021-09-16 10:11:33.897
11158,6,1111,광주,13,13,0,6626,2021-01-02 09:00:00.000,2021-09-16 10:11:33.897
11159,7,860,대전,4,4,0,6625,2021-01-02 09:00:00.000,2021-09-16 10:11:33.897
11160,27,733,울산,17,17,0,6624,2021-01-02 09:00:00.000,2021-09-16 10:11:33.897
11161,1,153,세종,3,3,0,6623,2021-01-02 09:00:00.000,2021-09-16 10:11:33.897
11162,281,14961,경기,227,221,6,6622,2021-01-02 09:00:00.000,2021-09-16 10:11:33.897
11163,13,1268,강원,31,31,0,6621,2021-01-02 09:00:00.000,2021-09-16 10:11:33.897
11164,28,1221,충북,36,34,2,6620,2021-01-02 09:00:00.000,2021-09-16 10:11:33.897
11165,24,1675,충남,7,6,1,6619,2021-01-02 09:00:00.000,2021-09-16 10:11:33.897
11166,11,856,전북,11,11,0,6618,2021-01-02 09:00:00.000,2021-09-16 10:11:33.897
11167,5,577,전남,11,9,2,6617,2021-01-02 09:00:00.000,2021-09-16 10:11:33.897
11168,62,2468,경북,20,18,2,6616,2021-01-02 09:00:00.000,2021-09-16 10:11:33.897
11169,5,1397,경남,37,35,2,6615,2021-01-02 09:00:00.000,2021-09-16 10:11:33.897
11170,0,434,제주,13,12,1,6614,2021-01-02 09:00:00.000,2021-09-16 10:11:33.897
11171,2,2459,검역,14,0,14,6613,2021-01-02 09:00:00.000,2021-09-16 10:11:33.897
11172,917,61753,합계,1027,1002,25,6612,2021-01-01 09:00:00.000,2021-09-16 10:11:33.897
11173,182,19352,서울,357,356,1,6611,2021-01-01 09:00:00.000,2021-09-16 10:11:33.897
11174,50,1924,부산,57,55,2,6610,2021-01-01 09:00:00.000,2021-09-16 10:11:33.897
11175,201,7844,대구,43,43,0,6609,2021-01-01 09:00:00.000,2021-09-16 10:11:33.897
11176,29,2904,인천,65,63,2,6608,2021-01-01 09:00:00.000,2021-09-16 10:11:33.897
11177,6,1098,광주,17,16,1,6607,2021-01-01 09:00:00.000,2021-09-16 10:11:33.897
11178,7,856,대전,11,11,0,6606,2021-01-01 09:00:00.000,2021-09-16 10:11:33.897
11179,26,716,울산,43,43,0,6605,2021-01-01 09:00:00.000,2021-09-16 10:11:33.897
11180,1,150,세종,1,1,0,6604,2021-01-01 09:00:00.000,2021-09-16 10:11:33.897
11181,271,14734,경기,284,271,13,6603,2021-01-01 09:00:00.000,2021-09-16 10:11:33.897
11182,13,1237,강원,30,29,1,6602,2021-01-01 09:00:00.000,2021-09-16 10:11:33.897
11183,24,1185,충북,22,22,0,6601,2021-01-01 09:00:00.000,2021-09-16 10:11:33.897
11184,23,1668,충남,15,15,0,6600,2021-01-01 09:00:00.000,2021-09-16 10:11:33.897
11185,11,845,전북,8,8,0,6599,2021-01-01 09:00:00.000,2021-09-16 10:11:33.897
11186,5,566,전남,6,6,0,6598,2021-01-01 09:00:00.000,2021-09-16 10:11:33.897
11187,62,2448,경북,24,24,0,6597,2021-01-01 09:00:00.000,2021-09-16 10:11:33.897
11188,4,1360,경남,35,34,1,6596,2021-01-01 09:00:00.000,2021-09-16 10:11:33.897
11189,0,421,제주,5,5,0,6595,2021-01-01 09:00:00.000,2021-09-16 10:11:33.897
11190,2,2445,검역,4,0,4,6594,2021-01-01 09:00:00.000,2021-09-16 10:11:33.897
11191,900,60726,합계,967,940,27,6593,2020-12-31 09:00:00.000,2021-09-16 10:11:33.897
11192,177,18995,서울,366,365,1,6592,2020-12-31 09:00:00.000,2021-09-16 10:11:33.897
11193,50,1867,부산,74,72,2,6591,2020-12-31 09:00:00.000,2021-09-16 10:11:33.897
11194,201,7801,대구,33,32,1,6590,2020-12-31 09:00:00.000,2021-09-16 10:11:33.897
11195,27,2839,인천,59,59,0,6589,2020-12-31 09:00:00.000,2021-09-16 10:11:33.897
11196,6,1081,광주,8,8,0,6588,2020-12-31 09:00:00.000,2021-09-16 10:11:33.897
11197,7,845,대전,7,6,1,6587,2020-12-31 09:00:00.000,2021-09-16 10:11:33.897
11198,26,673,울산,35,35,0,6586,2020-12-31 09:00:00.000,2021-09-16 10:11:33.897
11199,1,149,세종,0,0,0,6585,2020-12-31 09:00:00.000,2021-09-16 10:11:33.897
11200,263,14450,경기,225,219,6,6584,2020-12-31 09:00:00.000,2021-09-16 10:11:33.897
11201,13,1207,강원,36,36,0,6583,2020-12-31 09:00:00.000,2021-09-16 10:11:33.897
11202,23,1163,충북,22,22,0,6582,2020-12-31 09:00:00.000,2021-09-16 10:11:33.897
11203,23,1653,충남,18,17,1,6581,2020-12-31 09:00:00.000,2021-09-16 10:11:33.897
11204,11,837,전북,12,11,1,6580,2020-12-31 09:00:00.000,2021-09-16 10:11:33.897
11205,5,560,전남,5,5,0,6579,2020-12-31 09:00:00.000,2021-09-16 10:11:33.897
11206,61,2424,경북,23,22,1,6578,2020-12-31 09:00:00.000,2021-09-16 10:11:33.897
11207,4,1325,경남,22,22,0,6577,2020-12-31 09:00:00.000,2021-09-16 10:11:33.897
11208,0,416,제주,9,9,0,6576,2020-12-31 09:00:00.000,2021-09-16 10:11:33.897
11209,2,2441,검역,13,0,13,6575,2020-12-31 09:00:00.000,2021-09-16 10:11:33.897
11210,879,59759,합계,1050,1025,25,6574,2020-12-30 09:00:00.000,2021-09-16 10:11:33.897
11211,172,18629,서울,387,383,4,6573,2020-12-30 09:00:00.000,2021-09-16 10:11:33.897
11212,46,1793,부산,39,38,1,6572,2020-12-30 09:00:00.000,2021-09-16 10:11:33.897
11213,201,7768,대구,51,49,2,6571,2020-12-30 09:00:00.000,2021-09-16 10:11:33.897
11214,26,2780,인천,48,48,0,6570,2020-12-30 09:00:00.000,2021-09-16 10:11:33.897
11215,6,1073,광주,9,9,0,6569,2020-12-30 09:00:00.000,2021-09-16 10:11:33.897
11216,7,838,대전,19,19,0,6568,2020-12-30 09:00:00.000,2021-09-16 10:11:33.897
11217,26,638,울산,16,15,1,6567,2020-12-30 09:00:00.000,2021-09-16 10:11:33.897
11218,1,149,세종,2,2,0,6566,2020-12-30 09:00:00.000,2021-09-16 10:11:33.897
11219,253,14225,경기,277,274,3,6565,2020-12-30 09:00:00.000,2021-09-16 10:11:33.897
11220,13,1171,강원,17,17,0,6564,2020-12-30 09:00:00.000,2021-09-16 10:11:33.897
11221,23,1141,충북,45,45,0,6563,2020-12-30 09:00:00.000,2021-09-16 10:11:33.897
11222,22,1635,충남,27,27,0,6562,2020-12-30 09:00:00.000,2021-09-16 10:11:33.897
11223,11,825,전북,32,32,0,6561,2020-12-30 09:00:00.000,2021-09-16 10:11:33.897
11224,5,555,전남,1,0,1,6560,2020-12-30 09:00:00.000,2021-09-16 10:11:33.897
11225,61,2401,경북,23,21,2,6559,2020-12-30 09:00:00.000,2021-09-16 10:11:33.897
11226,4,1303,경남,36,36,0,6558,2020-12-30 09:00:00.000,2021-09-16 10:11:33.897
11227,0,407,제주,10,10,0,6557,2020-12-30 09:00:00.000,2021-09-16 10:11:33.897
11228,2,2428,검역,11,0,11,6556,2020-12-30 09:00:00.000,2021-09-16 10:11:33.897
11229,859,58709,합계,1044,1028,16,6555,2020-12-29 09:00:00.000,2021-09-16 10:11:33.897
11230,167,18242,서울,521,518,3,6554,2020-12-29 09:00:00.000,2021-09-16 10:11:33.897
11231,45,1754,부산,17,17,0,6553,2020-12-29 09:00:00.000,2021-09-16 10:11:33.897
11232,201,7717,대구,29,29,0,6552,2020-12-29 09:00:00.000,2021-09-16 10:11:33.897
11233,25,2732,인천,32,32,0,6551,2020-12-29 09:00:00.000,2021-09-16 10:11:33.897
11234,6,1064,광주,15,15,0,6550,2020-12-29 09:00:00.000,2021-09-16 10:11:33.897
11235,7,819,대전,30,30,0,6549,2020-12-29 09:00:00.000,2021-09-16 10:11:33.897
11236,26,622,울산,4,3,1,6548,2020-12-29 09:00:00.000,2021-09-16 10:11:33.897
11237,1,147,세종,4,4,0,6547,2020-12-29 09:00:00.000,2021-09-16 10:11:33.897
11238,242,13948,경기,256,250,6,6546,2020-12-29 09:00:00.000,2021-09-16 10:11:33.897
11239,13,1154,강원,21,21,0,6545,2020-12-29 09:00:00.000,2021-09-16 10:11:33.897
11240,21,1096,충북,22,22,0,6544,2020-12-29 09:00:00.000,2021-09-16 10:11:33.897
11241,22,1608,충남,27,27,0,6543,2020-12-29 09:00:00.000,2021-09-16 10:11:33.897
11242,11,793,전북,8,7,1,6542,2020-12-29 09:00:00.000,2021-09-16 10:11:33.897
11243,5,554,전남,4,4,0,6541,2020-12-29 09:00:00.000,2021-09-16 10:11:33.897
11244,61,2378,경북,28,28,0,6540,2020-12-29 09:00:00.000,2021-09-16 10:11:33.897
11245,4,1267,경남,16,16,0,6539,2020-12-29 09:00:00.000,2021-09-16 10:11:33.897
11246,0,397,제주,5,5,0,6538,2020-12-29 09:00:00.000,2021-09-16 10:11:33.897
11247,2,2417,검역,5,0,5,6537,2020-12-29 09:00:00.000,2021-09-16 10:11:33.897
11248,819,57665,합계,806,786,20,6536,2020-12-28 09:00:00.000,2021-09-16 10:11:33.897
11249,159,17721,서울,299,296,3,6535,2020-12-28 09:00:00.000,2021-09-16 10:11:33.897
11250,40,1737,부산,34,34,0,6534,2020-12-28 09:00:00.000,2021-09-16 10:11:33.897
11251,201,7688,대구,24,24,0,6533,2020-12-28 09:00:00.000,2021-09-16 10:11:33.897
11252,24,2700,인천,46,45,1,6532,2020-12-28 09:00:00.000,2021-09-16 10:11:33.897
11253,6,1049,광주,12,12,0,6531,2020-12-28 09:00:00.000,2021-09-16 10:11:33.897
11254,7,789,대전,3,3,0,6530,2020-12-28 09:00:00.000,2021-09-16 10:11:33.897
11255,26,618,울산,2,1,1,6529,2020-12-28 09:00:00.000,2021-09-16 10:11:33.897
11256,0,143,세종,2,2,0,6528,2020-12-28 09:00:00.000,2021-09-16 10:11:33.897
11257,221,13692,경기,193,188,5,6527,2020-12-28 09:00:00.000,2021-09-16 10:11:33.897
11258,13,1133,강원,27,27,0,6526,2020-12-28 09:00:00.000,2021-09-16 10:11:33.897
11259,20,1074,충북,31,30,1,6525,2020-12-28 09:00:00.000,2021-09-16 10:11:33.897
11260,22,1581,충남,35,35,0,6524,2020-12-28 09:00:00.000,2021-09-16 10:11:33.897
11261,8,785,전북,1,1,0,6523,2020-12-28 09:00:00.000,2021-09-16 10:11:33.897
11262,5,550,전남,7,7,0,6522,2020-12-28 09:00:00.000,2021-09-16 10:11:33.897
11263,61,2350,경북,46,45,1,6521,2020-12-28 09:00:00.000,2021-09-16 10:11:33.897
11264,4,1251,경남,25,25,0,6520,2020-12-28 09:00:00.000,2021-09-16 10:11:33.897
11265,0,392,제주,11,11,0,6519,2020-12-28 09:00:00.000,2021-09-16 10:11:33.897
11266,2,2412,검역,8,0,8,6518,2020-12-28 09:00:00.000,2021-09-16 10:11:33.897
11267,808,56859,합계,970,946,24,6517,2020-12-27 09:00:00.000,2021-09-16 10:11:33.897
11268,157,17422,서울,362,359,3,6516,2020-12-27 09:00:00.000,2021-09-16 10:11:33.897
11269,38,1703,부산,40,40,0,6515,2020-12-27 09:00:00.000,2021-09-16 10:11:33.897
11270,201,7664,대구,21,21,0,6514,2020-12-27 09:00:00.000,2021-09-16 10:11:33.897
11271,24,2654,인천,61,60,1,6513,2020-12-27 09:00:00.000,2021-09-16 10:11:33.897
11272,5,1037,광주,17,17,0,6512,2020-12-27 09:00:00.000,2021-09-16 10:11:33.897
11273,6,786,대전,8,8,0,6511,2020-12-27 09:00:00.000,2021-09-16 10:11:33.897
11274,25,616,울산,1,1,0,6510,2020-12-27 09:00:00.000,2021-09-16 10:11:33.897
11275,0,141,세종,6,6,0,6509,2020-12-27 09:00:00.000,2021-09-16 10:11:33.897
11276,217,13499,경기,241,237,4,6508,2020-12-27 09:00:00.000,2021-09-16 10:11:33.897
11277,13,1106,강원,23,23,0,6507,2020-12-27 09:00:00.000,2021-09-16 10:11:33.897
11278,20,1043,충북,24,24,0,6506,2020-12-27 09:00:00.000,2021-09-16 10:11:33.897
11279,22,1546,충남,58,55,3,6505,2020-12-27 09:00:00.000,2021-09-16 10:11:33.897
11280,8,784,전북,8,7,1,6504,2020-12-27 09:00:00.000,2021-09-16 10:11:33.897
11281,5,543,전남,5,5,0,6503,2020-12-27 09:00:00.000,2021-09-16 10:11:33.897
11282,61,2304,경북,34,32,2,6502,2020-12-27 09:00:00.000,2021-09-16 10:11:33.897
11283,4,1226,경남,44,44,0,6501,2020-12-27 09:00:00.000,2021-09-16 10:11:33.897
11284,0,381,제주,7,7,0,6500,2020-12-27 09:00:00.000,2021-09-16 10:11:33.897
11285,2,2404,검역,10,0,10,6499,2020-12-27 09:00:00.000,2021-09-16 10:11:33.897
11286,793,55889,합계,1131,1103,28,6498,2020-12-26 09:00:00.000,2021-09-16 10:11:33.897
11287,155,17060,서울,465,456,9,6497,2020-12-26 09:00:00.000,2021-09-16 10:11:33.897
11288,34,1663,부산,27,26,1,6496,2020-12-26 09:00:00.000,2021-09-16 10:11:33.897
11289,201,7643,대구,13,13,0,6495,2020-12-26 09:00:00.000,2021-09-16 10:11:33.897
11290,23,2593,인천,55,55,0,6494,2020-12-26 09:00:00.000,2021-09-16 10:11:33.897
11291,5,1020,광주,28,27,1,6493,2020-12-26 09:00:00.000,2021-09-16 10:11:33.897
11292,6,778,대전,11,11,0,6492,2020-12-26 09:00:00.000,2021-09-16 10:11:33.897
11293,24,615,울산,8,8,0,6491,2020-12-26 09:00:00.000,2021-09-16 10:11:33.897
11294,0,135,세종,1,1,0,6490,2020-12-26 09:00:00.000,2021-09-16 10:11:33.897
11295,212,13258,경기,255,250,5,6489,2020-12-26 09:00:00.000,2021-09-16 10:11:33.897
11296,13,1083,강원,36,35,1,6488,2020-12-26 09:00:00.000,2021-09-16 10:11:33.897
11297,19,1019,충북,38,38,0,6487,2020-12-26 09:00:00.000,2021-09-16 10:11:33.897
11298,22,1488,충남,61,61,0,6486,2020-12-26 09:00:00.000,2021-09-16 10:11:33.897
11299,8,776,전북,37,37,0,6485,2020-12-26 09:00:00.000,2021-09-16 10:11:33.897
11300,5,538,전남,6,6,0,6484,2020-12-26 09:00:00.000,2021-09-16 10:11:33.897
11301,61,2270,경북,34,33,1,6483,2020-12-26 09:00:00.000,2021-09-16 10:11:33.897
11302,4,1182,경남,22,22,0,6482,2020-12-26 09:00:00.000,2021-09-16 10:11:33.897
11303,0,374,제주,24,24,0,6481,2020-12-26 09:00:00.000,2021-09-16 10:11:33.897
11304,1,2394,검역,10,0,10,6480,2020-12-26 09:00:00.000,2021-09-16 10:11:33.897
11305,773,54758,합계,1240,1215,25,6479,2020-12-25 09:00:00.000,2021-09-16 10:11:33.897
11306,148,16595,서울,552,550,2,6478,2020-12-25 09:00:00.000,2021-09-16 10:11:33.897
11307,31,1636,부산,22,21,1,6477,2020-12-25 09:00:00.000,2021-09-16 10:11:33.897
11308,201,7630,대구,23,21,2,6476,2020-12-25 09:00:00.000,2021-09-16 10:11:33.897
11309,21,2538,인천,55,55,0,6475,2020-12-25 09:00:00.000,2021-09-16 10:11:33.897
11310,4,992,광주,36,35,1,6474,2020-12-25 09:00:00.000,2021-09-16 10:11:33.897
11311,6,767,대전,13,13,0,6473,2020-12-25 09:00:00.000,2021-09-16 10:11:33.897
11312,24,607,울산,12,12,0,6472,2020-12-25 09:00:00.000,2021-09-16 10:11:33.897
11313,0,134,세종,1,1,0,6471,2020-12-25 09:00:00.000,2021-09-16 10:11:33.897
11314,207,13003,경기,263,256,7,6470,2020-12-25 09:00:00.000,2021-09-16 10:11:33.897
11315,13,1047,강원,14,13,1,6469,2020-12-25 09:00:00.000,2021-09-16 10:11:33.897
11316,18,981,충북,42,42,0,6468,2020-12-25 09:00:00.000,2021-09-16 10:11:33.897
11317,22,1427,충남,80,79,1,6467,2020-12-25 09:00:00.000,2021-09-16 10:11:33.897
11318,8,739,전북,14,12,2,6466,2020-12-25 09:00:00.000,2021-09-16 10:11:33.897
11319,5,532,전남,5,4,1,6465,2020-12-25 09:00:00.000,2021-09-16 10:11:33.897
11320,61,2236,경북,67,67,0,6464,2020-12-25 09:00:00.000,2021-09-16 10:11:33.897
11321,3,1160,경남,15,14,1,6463,2020-12-25 09:00:00.000,2021-09-16 10:11:33.897
11322,0,350,제주,20,20,0,6462,2020-12-25 09:00:00.000,2021-09-16 10:11:33.897
11323,1,2384,검역,6,0,6,6461,2020-12-25 09:00:00.000,2021-09-16 10:11:33.897
11324,756,53518,합계,985,955,30,6460,2020-12-24 09:00:00.000,2021-09-16 10:11:33.897
11325,147,16043,서울,319,314,5,6459,2020-12-24 09:00:00.000,2021-09-16 10:11:33.897
11326,29,1614,부산,44,43,1,6458,2020-12-24 09:00:00.000,2021-09-16 10:11:33.897
11327,200,7607,대구,26,26,0,6457,2020-12-24 09:00:00.000,2021-09-16 10:11:33.897
11328,21,2483,인천,53,53,0,6456,2020-12-24 09:00:00.000,2021-09-16 10:11:33.897
11329,4,956,광주,15,14,1,6455,2020-12-24 09:00:00.000,2021-09-16 10:11:33.897
11330,6,754,대전,11,11,0,6454,2020-12-24 09:00:00.000,2021-09-16 10:11:33.897
11331,22,595,울산,9,9,0,6453,2020-12-24 09:00:00.000,2021-09-16 10:11:33.897
11332,0,133,세종,2,1,1,6452,2020-12-24 09:00:00.000,2021-09-16 10:11:33.897
11333,201,12740,경기,285,277,8,6451,2020-12-24 09:00:00.000,2021-09-16 10:11:33.897
11334,13,1033,강원,21,21,0,6450,2020-12-24 09:00:00.000,2021-09-16 10:11:33.897
11335,15,939,충북,47,46,1,6449,2020-12-24 09:00:00.000,2021-09-16 10:11:33.897
11336,21,1347,충남,31,29,2,6448,2020-12-24 09:00:00.000,2021-09-16 10:11:33.897
11337,7,725,전북,12,12,0,6447,2020-12-24 09:00:00.000,2021-09-16 10:11:33.897
11338,5,527,전남,2,2,0,6446,2020-12-24 09:00:00.000,2021-09-16 10:11:33.897
11339,61,2169,경북,50,50,0,6445,2020-12-24 09:00:00.000,2021-09-16 10:11:33.897
11340,3,1145,경남,21,21,0,6444,2020-12-24 09:00:00.000,2021-09-16 10:11:33.897
11341,0,330,제주,26,26,0,6443,2020-12-24 09:00:00.000,2021-09-16 10:11:33.897
11342,1,2378,검역,11,0,11,6442,2020-12-24 09:00:00.000,2021-09-16 10:11:33.897
11343,739,52533,합계,1090,1058,32,6441,2020-12-23 09:00:00.000,2021-09-16 10:11:33.897
11344,145,15724,서울,375,372,3,6440,2020-12-23 09:00:00.000,2021-09-16 10:11:33.897
11345,28,1570,부산,32,32,0,6439,2020-12-23 09:00:00.000,2021-09-16 10:11:33.897
11346,200,7581,대구,24,24,0,6438,2020-12-23 09:00:00.000,2021-09-16 10:11:33.897
11347,20,2430,인천,49,46,3,6437,2020-12-23 09:00:00.000,2021-09-16 10:11:33.897
11348,4,941,광주,36,35,1,6436,2020-12-23 09:00:00.000,2021-09-16 10:11:33.897
11349,6,743,대전,35,34,1,6435,2020-12-23 09:00:00.000,2021-09-16 10:11:33.897
11350,20,586,울산,18,16,2,6434,2020-12-23 09:00:00.000,2021-09-16 10:11:33.897
11351,0,131,세종,1,1,0,6433,2020-12-23 09:00:00.000,2021-09-16 10:11:33.897
11352,191,12455,경기,309,298,11,6432,2020-12-23 09:00:00.000,2021-09-16 10:11:33.897
11353,13,1012,강원,13,13,0,6431,2020-12-23 09:00:00.000,2021-09-16 10:11:33.897
11354,15,892,충북,58,58,0,6430,2020-12-23 09:00:00.000,2021-09-16 10:11:33.897
11355,20,1316,충남,11,11,0,6429,2020-12-23 09:00:00.000,2021-09-16 10:11:33.897
11356,7,713,전북,21,20,1,6428,2020-12-23 09:00:00.000,2021-09-16 10:11:33.897
11357,5,525,전남,12,12,0,6427,2020-12-23 09:00:00.000,2021-09-16 10:11:33.897
11358,61,2119,경북,25,25,0,6426,2020-12-23 09:00:00.000,2021-09-16 10:11:33.897
11359,3,1124,경남,29,28,1,6425,2020-12-23 09:00:00.000,2021-09-16 10:11:33.897
11360,0,304,제주,33,33,0,6424,2020-12-23 09:00:00.000,2021-09-16 10:11:33.897
11361,1,2367,검역,9,0,9,6423,2020-12-23 09:00:00.000,2021-09-16 10:11:33.897
11362,722,51443,합계,866,821,45,6422,2020-12-22 09:00:00.000,2021-09-16 10:11:33.897
11363,144,15349,서울,316,308,8,6421,2020-12-22 09:00:00.000,2021-09-16 10:11:33.897
11364,28,1538,부산,26,26,0,6420,2020-12-22 09:00:00.000,2021-09-16 10:11:33.897
11365,200,7557,대구,39,39,0,6419,2020-12-22 09:00:00.000,2021-09-16 10:11:33.897
11366,19,2381,인천,45,44,1,6418,2020-12-22 09:00:00.000,2021-09-16 10:11:33.897
11367,3,905,광주,26,26,0,6417,2020-12-22 09:00:00.000,2021-09-16 10:11:33.897
11368,6,708,대전,9,9,0,6416,2020-12-22 09:00:00.000,2021-09-16 10:11:33.897
11369,17,568,울산,6,6,0,6415,2020-12-22 09:00:00.000,2021-09-16 10:11:33.897
11370,0,130,세종,1,1,0,6414,2020-12-22 09:00:00.000,2021-09-16 10:11:33.897
11371,181,12146,경기,204,191,13,6413,2020-12-22 09:00:00.000,2021-09-16 10:11:33.897
11372,13,999,강원,23,23,0,6412,2020-12-22 09:00:00.000,2021-09-16 10:11:33.897
11373,15,834,충북,31,30,1,6411,2020-12-22 09:00:00.000,2021-09-16 10:11:33.897
11374,19,1305,충남,17,15,2,6410,2020-12-22 09:00:00.000,2021-09-16 10:11:33.897
11375,7,692,전북,4,4,0,6409,2020-12-22 09:00:00.000,2021-09-16 10:11:33.897
11376,5,513,전남,5,4,1,6408,2020-12-22 09:00:00.000,2021-09-16 10:11:33.897
11377,61,2094,경북,59,58,1,6407,2020-12-22 09:00:00.000,2021-09-16 10:11:33.897
11378,3,1095,경남,18,18,0,6406,2020-12-22 09:00:00.000,2021-09-16 10:11:33.897
11379,0,271,제주,19,19,0,6405,2020-12-22 09:00:00.000,2021-09-16 10:11:33.897
11380,1,2358,검역,18,0,18,6404,2020-12-22 09:00:00.000,2021-09-16 10:11:33.897
11381,698,50577,합계,924,891,33,6403,2020-12-21 09:00:00.000,2021-09-16 10:11:33.897
11382,136,15033,서울,327,326,1,6402,2020-12-21 09:00:00.000,2021-09-16 10:11:33.897
11383,28,1512,부산,20,19,1,6401,2020-12-21 09:00:00.000,2021-09-16 10:11:33.897
11384,200,7518,대구,21,21,0,6400,2020-12-21 09:00:00.000,2021-09-16 10:11:33.897
11385,15,2336,인천,88,85,3,6399,2020-12-21 09:00:00.000,2021-09-16 10:11:33.897
11386,3,879,광주,13,11,2,6398,2020-12-21 09:00:00.000,2021-09-16 10:11:33.897
11387,6,699,대전,3,3,0,6397,2020-12-21 09:00:00.000,2021-09-16 10:11:33.897
11388,16,562,울산,17,17,0,6396,2020-12-21 09:00:00.000,2021-09-16 10:11:33.897
11389,0,129,세종,0,0,0,6395,2020-12-21 09:00:00.000,2021-09-16 10:11:33.897
11390,173,11942,경기,244,237,7,6394,2020-12-21 09:00:00.000,2021-09-16 10:11:33.897
11391,13,976,강원,25,22,3,6393,2020-12-21 09:00:00.000,2021-09-16 10:11:33.897
11392,13,803,충북,33,29,4,6392,2020-12-21 09:00:00.000,2021-09-16 10:11:33.897
11393,18,1288,충남,16,16,0,6391,2020-12-21 09:00:00.000,2021-09-16 10:11:33.897
11394,7,688,전북,13,11,2,6390,2020-12-21 09:00:00.000,2021-09-16 10:11:33.897
11395,5,508,전남,9,8,1,6389,2020-12-21 09:00:00.000,2021-09-16 10:11:33.897
11396,61,2035,경북,48,48,0,6388,2020-12-21 09:00:00.000,2021-09-16 10:11:33.897
11397,3,1077,경남,15,15,0,6387,2020-12-21 09:00:00.000,2021-09-16 10:11:33.897
11398,0,252,제주,23,23,0,6386,2020-12-21 09:00:00.000,2021-09-16 10:11:33.897
11399,1,2340,검역,9,0,9,6385,2020-12-21 09:00:00.000,2021-09-16 10:11:33.897
11400,674,49653,합계,1096,1071,25,6384,2020-12-20 09:00:00.000,2021-09-16 10:11:33.897
11401,130,14706,서울,472,469,3,6383,2020-12-20 09:00:00.000,2021-09-16 10:11:33.897
11402,27,1492,부산,33,33,0,6382,2020-12-20 09:00:00.000,2021-09-16 10:11:33.897
11403,200,7497,대구,25,25,0,6381,2020-12-20 09:00:00.000,2021-09-16 10:11:33.897
11404,15,2248,인천,62,62,0,6380,2020-12-20 09:00:00.000,2021-09-16 10:11:33.897
11405,3,866,광주,14,13,1,6379,2020-12-20 09:00:00.000,2021-09-16 10:11:33.897
11406,6,696,대전,3,3,0,6378,2020-12-20 09:00:00.000,2021-09-16 10:11:33.897
11407,14,545,울산,6,5,1,6377,2020-12-20 09:00:00.000,2021-09-16 10:11:33.897
11408,0,129,세종,1,0,1,6376,2020-12-20 09:00:00.000,2021-09-16 10:11:33.897
11409,164,11698,경기,249,244,5,6375,2020-12-20 09:00:00.000,2021-09-16 10:11:33.897
11410,13,951,강원,55,55,0,6374,2020-12-20 09:00:00.000,2021-09-16 10:11:33.897
11411,11,770,충북,14,14,0,6373,2020-12-20 09:00:00.000,2021-09-16 10:11:33.897
11412,17,1272,충남,20,19,1,6372,2020-12-20 09:00:00.000,2021-09-16 10:11:33.897
11413,6,675,전북,29,29,0,6371,2020-12-20 09:00:00.000,2021-09-16 10:11:33.897
11414,5,499,전남,4,4,0,6370,2020-12-20 09:00:00.000,2021-09-16 10:11:33.897
11415,60,1987,경북,25,23,2,6369,2020-12-20 09:00:00.000,2021-09-16 10:11:33.897
11416,2,1062,경남,51,49,2,6368,2020-12-20 09:00:00.000,2021-09-16 10:11:33.897
11417,0,229,제주,24,24,0,6367,2020-12-20 09:00:00.000,2021-09-16 10:11:33.897
11418,1,2331,검역,9,0,9,6366,2020-12-20 09:00:00.000,2021-09-16 10:11:33.897
11419,659,48557,합계,1045,1024,21,6365,2020-12-19 09:00:00.000,2021-09-16 10:11:33.897
11420,128,14234,서울,380,378,2,6364,2020-12-19 09:00:00.000,2021-09-16 10:11:33.897
11421,27,1459,부산,39,39,0,6363,2020-12-19 09:00:00.000,2021-09-16 10:11:33.897
11422,200,7472,대구,20,20,0,6362,2020-12-19 09:00:00.000,2021-09-16 10:11:33.897
11423,14,2186,인천,46,46,0,6361,2020-12-19 09:00:00.000,2021-09-16 10:11:33.897
11424,3,852,광주,9,9,0,6360,2020-12-19 09:00:00.000,2021-09-16 10:11:33.897
11425,6,693,대전,5,5,0,6359,2020-12-19 09:00:00.000,2021-09-16 10:11:33.897
11426,14,539,울산,9,7,2,6358,2020-12-19 09:00:00.000,2021-09-16 10:11:33.897
11427,0,128,세종,0,0,0,6357,2020-12-19 09:00:00.000,2021-09-16 10:11:33.897
11428,155,11449,경기,274,263,11,6356,2020-12-19 09:00:00.000,2021-09-16 10:11:33.897
11429,13,896,강원,27,27,0,6355,2020-12-19 09:00:00.000,2021-09-16 10:11:33.897
11430,9,756,충북,103,103,0,6354,2020-12-19 09:00:00.000,2021-09-16 10:11:33.897
11431,17,1252,충남,24,24,0,6353,2020-12-19 09:00:00.000,2021-09-16 10:11:33.897
11432,5,646,전북,15,13,2,6352,2020-12-19 09:00:00.000,2021-09-16 10:11:33.897
11433,5,495,전남,5,5,0,6351,2020-12-19 09:00:00.000,2021-09-16 10:11:33.897
11434,60,1962,경북,29,29,0,6350,2020-12-19 09:00:00.000,2021-09-16 10:11:33.897
11435,2,1011,경남,32,32,0,6349,2020-12-19 09:00:00.000,2021-09-16 10:11:33.897
11436,0,205,제주,24,24,0,6348,2020-12-19 09:00:00.000,2021-09-16 10:11:33.897
11437,1,2322,검역,4,0,4,6347,2020-12-19 09:00:00.000,2021-09-16 10:11:33.897
11438,645,47512,합계,1064,1038,26,6346,2020-12-18 09:00:00.000,2021-09-16 10:11:33.897
11439,126,13854,서울,398,393,5,6345,2020-12-18 09:00:00.000,2021-09-16 10:11:33.897
11440,26,1420,부산,39,39,0,6344,2020-12-18 09:00:00.000,2021-09-16 10:11:33.897
11441,200,7452,대구,20,20,0,6343,2020-12-18 09:00:00.000,2021-09-16 10:11:33.897
11442,14,2140,인천,65,64,1,6342,2020-12-18 09:00:00.000,2021-09-16 10:11:33.897
11443,3,843,광주,4,3,1,6341,2020-12-18 09:00:00.000,2021-09-16 10:11:33.897
11444,6,688,대전,5,5,0,6340,2020-12-18 09:00:00.000,2021-09-16 10:11:33.897
11445,11,530,울산,31,30,1,6339,2020-12-18 09:00:00.000,2021-09-16 10:11:33.897
11446,0,128,세종,0,0,0,6338,2020-12-18 09:00:00.000,2021-09-16 10:11:33.897
11447,153,11175,경기,303,302,1,6337,2020-12-18 09:00:00.000,2021-09-16 10:11:33.897
11448,13,869,강원,18,18,0,6336,2020-12-18 09:00:00.000,2021-09-16 10:11:33.897
11449,7,653,충북,31,30,1,6335,2020-12-18 09:00:00.000,2021-09-16 10:11:33.897
11450,16,1228,충남,18,16,2,6334,2020-12-18 09:00:00.000,2021-09-16 10:11:33.897
11451,4,631,전북,16,12,4,6333,2020-12-18 09:00:00.000,2021-09-16 10:11:33.897
11452,4,490,전남,5,5,0,6332,2020-12-18 09:00:00.000,2021-09-16 10:11:33.897
11453,59,1933,경북,31,31,0,6331,2020-12-18 09:00:00.000,2021-09-16 10:11:33.897
11454,2,979,경남,44,43,1,6330,2020-12-18 09:00:00.000,2021-09-16 10:11:33.897
11455,0,181,제주,27,27,0,6329,2020-12-18 09:00:00.000,2021-09-16 10:11:33.897
11456,1,2318,검역,9,0,9,6328,2020-12-18 09:00:00.000,2021-09-16 10:11:33.897
11457,634,46448,합계,1014,994,20,6327,2020-12-17 09:00:00.000,2021-09-16 10:11:33.897
11458,125,13456,서울,423,420,3,6326,2020-12-17 09:00:00.000,2021-09-16 10:11:33.897
11459,22,1381,부산,44,44,0,6325,2020-12-17 09:00:00.000,2021-09-16 10:11:33.897
11460,200,7432,대구,21,20,1,6324,2020-12-17 09:00:00.000,2021-09-16 10:11:33.897
11461,14,2075,인천,80,80,0,6323,2020-12-17 09:00:00.000,2021-09-16 10:11:33.897
11462,3,839,광주,10,10,0,6322,2020-12-17 09:00:00.000,2021-09-16 10:11:33.897
11463,6,683,대전,11,11,0,6321,2020-12-17 09:00:00.000,2021-09-16 10:11:33.897
11464,8,499,울산,10,10,0,6320,2020-12-17 09:00:00.000,2021-09-16 10:11:33.897
11465,0,128,세종,0,0,0,6319,2020-12-17 09:00:00.000,2021-09-16 10:11:33.897
11466,151,10872,경기,291,285,6,6318,2020-12-17 09:00:00.000,2021-09-16 10:11:33.897
11467,13,851,강원,9,9,0,6317,2020-12-17 09:00:00.000,2021-09-16 10:11:33.897
11468,7,622,충북,19,19,0,6316,2020-12-17 09:00:00.000,2021-09-16 10:11:33.897
11469,15,1210,충남,19,17,2,6315,2020-12-17 09:00:00.000,2021-09-16 10:11:33.897
11470,4,615,전북,19,18,1,6314,2020-12-17 09:00:00.000,2021-09-16 10:11:33.897
11471,4,485,전남,0,0,0,6313,2020-12-17 09:00:00.000,2021-09-16 10:11:33.897
11472,59,1902,경북,9,9,0,6312,2020-12-17 09:00:00.000,2021-09-16 10:11:33.897
11473,2,935,경남,30,30,0,6311,2020-12-17 09:00:00.000,2021-09-16 10:11:33.897
11474,0,154,제주,12,12,0,6310,2020-12-17 09:00:00.000,2021-09-16 10:11:33.897
11475,1,2309,검역,7,0,7,6309,2020-12-17 09:00:00.000,2021-09-16 10:11:33.897
11476,612,45434,합계,1078,1054,24,6308,2020-12-16 09:00:00.000,2021-09-16 10:11:33.897
11477,120,13033,서울,378,372,6,6307,2020-12-16 09:00:00.000,2021-09-16 10:11:33.897
11478,21,1337,부산,41,41,0,6306,2020-12-16 09:00:00.000,2021-09-16 10:11:33.897
11479,200,7411,대구,27,27,0,6305,2020-12-16 09:00:00.000,2021-09-16 10:11:33.897
11480,14,1995,인천,67,64,3,6304,2020-12-16 09:00:00.000,2021-09-16 10:11:33.897
11481,3,829,광주,2,2,0,6303,2020-12-16 09:00:00.000,2021-09-16 10:11:33.897
11482,6,672,대전,15,15,0,6302,2020-12-16 09:00:00.000,2021-09-16 10:11:33.897
11483,6,489,울산,6,6,0,6301,2020-12-16 09:00:00.000,2021-09-16 10:11:33.897
11484,0,128,세종,0,0,0,6300,2020-12-16 09:00:00.000,2021-09-16 10:11:33.897
11485,144,10581,경기,329,321,8,6299,2020-12-16 09:00:00.000,2021-09-16 10:11:33.897
11486,12,842,강원,8,8,0,6298,2020-12-16 09:00:00.000,2021-09-16 10:11:33.897
11487,4,603,충북,23,22,1,6297,2020-12-16 09:00:00.000,2021-09-16 10:11:33.897
11488,13,1191,충남,35,35,0,6296,2020-12-16 09:00:00.000,2021-09-16 10:11:33.897
11489,3,596,전북,75,75,0,6295,2020-12-16 09:00:00.000,2021-09-16 10:11:33.897
11490,4,485,전남,4,4,0,6294,2020-12-16 09:00:00.000,2021-09-16 10:11:33.897
11491,59,1893,경북,28,28,0,6293,2020-12-16 09:00:00.000,2021-09-16 10:11:33.897
11492,2,905,경남,19,19,0,6292,2020-12-16 09:00:00.000,2021-09-16 10:11:33.897
11493,0,142,제주,15,15,0,6291,2020-12-16 09:00:00.000,2021-09-16 10:11:33.897
11494,1,2302,검역,6,0,6,6290,2020-12-16 09:00:00.000,2021-09-16 10:11:33.897
11495,600,44356,합계,880,848,32,6289,2020-12-15 09:00:00.000,2021-09-16 10:11:33.897
11496,115,12655,서울,251,246,5,6288,2020-12-15 09:00:00.000,2021-09-16 10:11:33.897
11497,21,1296,부산,41,40,1,6287,2020-12-15 09:00:00.000,2021-09-16 10:11:33.897
11498,200,7384,대구,19,18,1,6286,2020-12-15 09:00:00.000,2021-09-16 10:11:33.897
11499,14,1928,인천,55,55,0,6285,2020-12-15 09:00:00.000,2021-09-16 10:11:33.897
11500,3,827,광주,5,5,0,6284,2020-12-15 09:00:00.000,2021-09-16 10:11:33.897
11501,6,657,대전,32,32,0,6283,2020-12-15 09:00:00.000,2021-09-16 10:11:33.897
11502,6,483,울산,49,49,0,6282,2020-12-15 09:00:00.000,2021-09-16 10:11:33.897
11503,0,128,세종,1,1,0,6281,2020-12-15 09:00:00.000,2021-09-16 10:11:33.897
11504,138,10252,경기,288,274,14,6280,2020-12-15 09:00:00.000,2021-09-16 10:11:33.897
11505,12,834,강원,13,13,0,6279,2020-12-15 09:00:00.000,2021-09-16 10:11:33.897
11506,4,580,충북,25,24,1,6278,2020-12-15 09:00:00.000,2021-09-16 10:11:33.897
11507,13,1156,충남,37,37,0,6277,2020-12-15 09:00:00.000,2021-09-16 10:11:33.897
11508,2,521,전북,15,13,2,6276,2020-12-15 09:00:00.000,2021-09-16 10:11:33.897
11509,4,481,전남,1,1,0,6275,2020-12-15 09:00:00.000,2021-09-16 10:11:33.897
11510,59,1865,경북,15,15,0,6274,2020-12-15 09:00:00.000,2021-09-16 10:11:33.897
11511,2,886,경남,16,16,0,6273,2020-12-15 09:00:00.000,2021-09-16 10:11:33.897
11512,0,127,제주,9,9,0,6272,2020-12-15 09:00:00.000,2021-09-16 10:11:33.897
11513,1,2296,검역,8,0,8,6271,2020-12-15 09:00:00.000,2021-09-16 10:11:33.897
11514,587,43476,합계,718,682,36,6270,2020-12-14 09:00:00.000,2021-09-16 10:11:33.897
11515,112,12404,서울,219,217,2,6269,2020-12-14 09:00:00.000,2021-09-16 10:11:33.897
11516,20,1255,부산,21,19,2,6268,2020-12-14 09:00:00.000,2021-09-16 10:11:33.897
11517,200,7365,대구,16,16,0,6267,2020-12-14 09:00:00.000,2021-09-16 10:11:33.897
11518,13,1873,인천,36,36,0,6266,2020-12-14 09:00:00.000,2021-09-16 10:11:33.897
11519,3,822,광주,22,22,0,6265,2020-12-14 09:00:00.000,2021-09-16 10:11:33.897
11520,6,625,대전,2,1,1,6264,2020-12-14 09:00:00.000,2021-09-16 10:11:33.897
11521,4,434,울산,5,4,1,6263,2020-12-14 09:00:00.000,2021-09-16 10:11:33.897
11522,0,127,세종,3,3,0,6262,2020-12-14 09:00:00.000,2021-09-16 10:11:33.897
11523,135,9964,경기,226,220,6,6261,2020-12-14 09:00:00.000,2021-09-16 10:11:33.897
11524,12,821,강원,14,14,0,6260,2020-12-14 09:00:00.000,2021-09-16 10:11:33.897
11525,3,555,충북,21,21,0,6259,2020-12-14 09:00:00.000,2021-09-16 10:11:33.897
11526,11,1119,충남,55,51,4,6258,2020-12-14 09:00:00.000,2021-09-16 10:11:33.897
11527,2,506,전북,8,8,0,6257,2020-12-14 09:00:00.000,2021-09-16 10:11:33.897
11528,4,480,전남,1,1,0,6256,2020-12-14 09:00:00.000,2021-09-16 10:11:33.897
11529,59,1850,경북,16,15,1,6255,2020-12-14 09:00:00.000,2021-09-16 10:11:33.897
11530,2,870,경남,28,26,2,6254,2020-12-14 09:00:00.000,2021-09-16 10:11:33.897
11531,0,118,제주,8,8,0,6253,2020-12-14 09:00:00.000,2021-09-16 10:11:33.897
11532,1,2288,검역,17,0,17,6252,2020-12-14 09:00:00.000,2021-09-16 10:11:33.897
11533,580,42758,합계,1030,1000,30,6251,2020-12-13 09:00:00.000,2021-09-16 10:11:33.897
11534,109,12185,서울,399,396,3,6250,2020-12-13 09:00:00.000,2021-09-16 10:11:33.897
11535,19,1234,부산,57,56,1,6249,2020-12-13 09:00:00.000,2021-09-16 10:11:33.897
11536,200,7349,대구,28,28,0,6248,2020-12-13 09:00:00.000,2021-09-16 10:11:33.897
11537,12,1837,인천,62,61,1,6247,2020-12-13 09:00:00.000,2021-09-16 10:11:33.897
11538,3,800,광주,15,14,1,6246,2020-12-13 09:00:00.000,2021-09-16 10:11:33.897
11539,6,623,대전,13,12,1,6245,2020-12-13 09:00:00.000,2021-09-16 10:11:33.897
11540,4,429,울산,8,8,0,6244,2020-12-13 09:00:00.000,2021-09-16 10:11:33.897
11541,0,124,세종,0,0,0,6243,2020-12-13 09:00:00.000,2021-09-16 10:11:33.897
11542,135,9738,경기,331,328,3,6242,2020-12-13 09:00:00.000,2021-09-16 10:11:33.897
11543,12,807,강원,18,17,1,6241,2020-12-13 09:00:00.000,2021-09-16 10:11:33.897
11544,3,534,충북,15,15,0,6240,2020-12-13 09:00:00.000,2021-09-16 10:11:33.897
11545,10,1064,충남,10,9,1,6239,2020-12-13 09:00:00.000,2021-09-16 10:11:33.897
11546,2,498,전북,9,8,1,6238,2020-12-13 09:00:00.000,2021-09-16 10:11:33.897
11547,4,479,전남,6,5,1,6237,2020-12-13 09:00:00.000,2021-09-16 10:11:33.897
11548,58,1834,경북,18,18,0,6236,2020-12-13 09:00:00.000,2021-09-16 10:11:33.897
11549,2,842,경남,24,22,2,6235,2020-12-13 09:00:00.000,2021-09-16 10:11:33.897
11550,0,110,제주,3,3,0,6234,2020-12-13 09:00:00.000,2021-09-16 10:11:33.897
11551,1,2271,검역,14,0,14,6233,2020-12-13 09:00:00.000,2021-09-16 10:11:33.897
11552,578,41728,합계,950,928,22,6232,2020-12-12 09:00:00.000,2021-09-16 10:11:33.897
11553,109,11786,서울,362,359,3,6231,2020-12-12 09:00:00.000,2021-09-16 10:11:33.897
11554,19,1177,부산,59,58,1,6230,2020-12-12 09:00:00.000,2021-09-16 10:11:33.897
11555,200,7321,대구,35,35,0,6229,2020-12-12 09:00:00.000,2021-09-16 10:11:33.897
11556,12,1775,인천,42,42,0,6228,2020-12-12 09:00:00.000,2021-09-16 10:11:33.897
11557,3,785,광주,9,9,0,6227,2020-12-12 09:00:00.000,2021-09-16 10:11:33.897
11558,6,610,대전,18,18,0,6226,2020-12-12 09:00:00.000,2021-09-16 10:11:33.897
11559,4,421,울산,23,23,0,6225,2020-12-12 09:00:00.000,2021-09-16 10:11:33.897
11560,0,124,세종,1,1,0,6224,2020-12-12 09:00:00.000,2021-09-16 10:11:33.897
11561,134,9407,경기,272,268,4,6223,2020-12-12 09:00:00.000,2021-09-16 10:11:33.897
11562,11,789,강원,36,36,0,6222,2020-12-12 09:00:00.000,2021-09-16 10:11:33.897
11563,3,519,충북,21,21,0,6221,2020-12-12 09:00:00.000,2021-09-16 10:11:33.897
11564,10,1054,충남,10,9,1,6220,2020-12-12 09:00:00.000,2021-09-16 10:11:33.897
11565,2,489,전북,6,5,1,6219,2020-12-12 09:00:00.000,2021-09-16 10:11:33.897
11566,4,473,전남,8,8,0,6218,2020-12-12 09:00:00.000,2021-09-16 10:11:33.897
11567,58,1816,경북,19,19,0,6217,2020-12-12 09:00:00.000,2021-09-16 10:11:33.897
11568,2,818,경남,17,17,0,6216,2020-12-12 09:00:00.000,2021-09-16 10:11:33.897
11569,0,107,제주,0,0,0,6215,2020-12-12 09:00:00.000,2021-09-16 10:11:33.897
11570,1,2257,검역,12,0,12,6214,2020-12-12 09:00:00.000,2021-09-16 10:11:33.897
11571,572,40778,합계,689,673,16,6213,2020-12-11 09:00:00.000,2021-09-16 10:11:33.897
11572,106,11424,서울,252,250,2,6212,2020-12-11 09:00:00.000,2021-09-16 10:11:33.897
11573,18,1118,부산,26,26,0,6211,2020-12-11 09:00:00.000,2021-09-16 10:11:33.897
11574,200,7286,대구,6,6,0,6210,2020-12-11 09:00:00.000,2021-09-16 10:11:33.897
11575,12,1733,인천,37,37,0,6209,2020-12-11 09:00:00.000,2021-09-16 10:11:33.897
11576,3,776,광주,3,3,0,6208,2020-12-11 09:00:00.000,2021-09-16 10:11:33.897
11577,6,592,대전,10,8,2,6207,2020-12-11 09:00:00.000,2021-09-16 10:11:33.897
11578,4,398,울산,47,47,0,6206,2020-12-11 09:00:00.000,2021-09-16 10:11:33.897
11579,0,123,세종,0,0,0,6205,2020-12-11 09:00:00.000,2021-09-16 10:11:33.897
11580,133,9135,경기,229,225,4,6204,2020-12-11 09:00:00.000,2021-09-16 10:11:33.897
11581,11,753,강원,11,11,0,6203,2020-12-11 09:00:00.000,2021-09-16 10:11:33.897
11582,3,498,충북,20,20,0,6202,2020-12-11 09:00:00.000,2021-09-16 10:11:33.897
11583,10,1044,충남,10,9,1,6201,2020-12-11 09:00:00.000,2021-09-16 10:11:33.897
11584,2,483,전북,7,7,0,6200,2020-12-11 09:00:00.000,2021-09-16 10:11:33.897
11585,4,465,전남,4,4,0,6199,2020-12-11 09:00:00.000,2021-09-16 10:11:33.897
11586,57,1797,경북,3,3,0,6198,2020-12-11 09:00:00.000,2021-09-16 10:11:33.897
11587,2,801,경남,12,12,0,6197,2020-12-11 09:00:00.000,2021-09-16 10:11:33.897
11588,0,107,제주,5,5,0,6196,2020-12-11 09:00:00.000,2021-09-16 10:11:33.897
11589,1,2245,검역,7,0,7,6195,2020-12-11 09:00:00.000,2021-09-16 10:11:33.897
11590,564,40089,합계,680,643,37,6194,2020-12-10 09:00:00.000,2021-09-16 10:11:33.897
11591,105,11172,서울,250,250,0,6193,2020-12-10 09:00:00.000,2021-09-16 10:11:33.897
11592,18,1092,부산,31,31,0,6192,2020-12-10 09:00:00.000,2021-09-16 10:11:33.897
11593,200,7280,대구,3,3,0,6191,2020-12-10 09:00:00.000,2021-09-16 10:11:33.897
11594,12,1696,인천,37,37,0,6190,2020-12-10 09:00:00.000,2021-09-16 10:11:33.897
11595,3,773,광주,5,3,2,6189,2020-12-10 09:00:00.000,2021-09-16 10:11:33.897
11596,6,582,대전,9,9,0,6188,2020-12-10 09:00:00.000,2021-09-16 10:11:33.897
11597,2,351,울산,16,16,0,6187,2020-12-10 09:00:00.000,2021-09-16 10:11:33.897
11598,0,123,세종,1,1,0,6186,2020-12-10 09:00:00.000,2021-09-16 10:11:33.897
11599,130,8906,경기,215,201,14,6185,2020-12-10 09:00:00.000,2021-09-16 10:11:33.897
11600,10,742,강원,15,15,0,6184,2020-12-10 09:00:00.000,2021-09-16 10:11:33.897
11601,3,478,충북,12,12,0,6183,2020-12-10 09:00:00.000,2021-09-16 10:11:33.897
11602,10,1034,충남,20,20,0,6182,2020-12-10 09:00:00.000,2021-09-16 10:11:33.897
11603,2,476,전북,8,8,0,6181,2020-12-10 09:00:00.000,2021-09-16 10:11:33.897
11604,4,461,전남,5,5,0,6180,2020-12-10 09:00:00.000,2021-09-16 10:11:33.897
11605,57,1794,경북,8,7,1,6179,2020-12-10 09:00:00.000,2021-09-16 10:11:33.897
11606,1,789,경남,16,16,0,6178,2020-12-10 09:00:00.000,2021-09-16 10:11:33.897
11607,0,102,제주,13,9,4,6177,2020-12-10 09:00:00.000,2021-09-16 10:11:33.897
11608,1,2238,검역,16,0,16,6176,2020-12-10 09:00:00.000,2021-09-16 10:11:33.897
11609,556,39409,합계,670,646,24,6175,2020-12-09 09:00:00.000,2021-09-16 10:11:33.897
11610,105,10922,서울,262,256,6,6174,2020-12-09 09:00:00.000,2021-09-16 10:11:33.897
11611,16,1061,부산,19,19,0,6173,2020-12-09 09:00:00.000,2021-09-16 10:11:33.897
11612,200,7277,대구,2,2,0,6172,2020-12-09 09:00:00.000,2021-09-16 10:11:33.897
11613,11,1659,인천,46,44,2,6171,2020-12-09 09:00:00.000,2021-09-16 10:11:33.897
11614,3,768,광주,9,9,0,6170,2020-12-09 09:00:00.000,2021-09-16 10:11:33.897
11615,6,573,대전,10,10,0,6169,2020-12-09 09:00:00.000,2021-09-16 10:11:33.897
11616,2,335,울산,14,14,0,6168,2020-12-09 09:00:00.000,2021-09-16 10:11:33.897
11617,0,122,세종,1,1,0,6167,2020-12-09 09:00:00.000,2021-09-16 10:11:33.897
11618,127,8691,경기,219,215,4,6166,2020-12-09 09:00:00.000,2021-09-16 10:11:33.897
11619,10,727,강원,5,4,1,6165,2020-12-09 09:00:00.000,2021-09-16 10:11:33.897
11620,3,466,충북,23,22,1,6164,2020-12-09 09:00:00.000,2021-09-16 10:11:33.897
11621,10,1014,충남,4,4,0,6163,2020-12-09 09:00:00.000,2021-09-16 10:11:33.897
11622,2,468,전북,12,12,0,6162,2020-12-09 09:00:00.000,2021-09-16 10:11:33.897
11623,2,456,전남,2,2,0,6161,2020-12-09 09:00:00.000,2021-09-16 10:11:33.897
11624,57,1786,경북,4,3,1,6160,2020-12-09 09:00:00.000,2021-09-16 10:11:33.897
11625,1,773,경남,29,29,0,6159,2020-12-09 09:00:00.000,2021-09-16 10:11:33.897
11626,0,89,제주,0,0,0,6158,2020-12-09 09:00:00.000,2021-09-16 10:11:33.897
11627,1,2222,검역,9,0,9,6157,2020-12-09 09:00:00.000,2021-09-16 10:11:33.897
11628,552,38739,합계,587,561,26,6156,2020-12-08 09:00:00.000,2021-09-16 10:11:33.897
11629,104,10660,서울,211,211,0,6155,2020-12-08 09:00:00.000,2021-09-16 10:11:33.897
11630,16,1042,부산,26,24,2,6154,2020-12-08 09:00:00.000,2021-09-16 10:11:33.897
11631,200,7275,대구,4,3,1,6153,2020-12-08 09:00:00.000,2021-09-16 10:11:33.897
11632,11,1613,인천,25,25,0,6152,2020-12-08 09:00:00.000,2021-09-16 10:11:33.897
11633,3,759,광주,11,10,1,6151,2020-12-08 09:00:00.000,2021-09-16 10:11:33.897
11634,6,563,대전,11,10,1,6150,2020-12-08 09:00:00.000,2021-09-16 10:11:33.897
11635,2,321,울산,61,61,0,6149,2020-12-08 09:00:00.000,2021-09-16 10:11:33.897
11636,0,121,세종,1,0,1,6148,2020-12-08 09:00:00.000,2021-09-16 10:11:33.897
11637,126,8472,경기,157,146,11,6147,2020-12-08 09:00:00.000,2021-09-16 10:11:33.897
11638,9,722,강원,8,8,0,6146,2020-12-08 09:00:00.000,2021-09-16 10:11:33.897
11639,3,443,충북,10,9,1,6145,2020-12-08 09:00:00.000,2021-09-16 10:11:33.897
11640,10,1010,충남,15,15,0,6144,2020-12-08 09:00:00.000,2021-09-16 10:11:33.897
11641,2,456,전북,13,13,0,6143,2020-12-08 09:00:00.000,2021-09-16 10:11:33.897
11642,2,454,전남,7,7,0,6142,2020-12-08 09:00:00.000,2021-09-16 10:11:33.897
11643,57,1782,경북,5,5,0,6141,2020-12-08 09:00:00.000,2021-09-16 10:11:33.897
11644,1,744,경남,13,12,1,6140,2020-12-08 09:00:00.000,2021-09-16 10:11:33.897
11645,0,89,제주,2,2,0,6139,2020-12-08 09:00:00.000,2021-09-16 10:11:33.897
11646,0,2213,검역,7,0,7,6138,2020-12-08 09:00:00.000,2021-09-16 10:11:33.897
11647,549,38152,합계,615,580,35,6137,2020-12-07 09:00:00.000,2021-09-16 10:11:33.897
11648,102,10449,서울,244,231,13,6136,2020-12-07 09:00:00.000,2021-09-16 10:11:33.897
11649,16,1016,부산,35,33,2,6135,2020-12-07 09:00:00.000,2021-09-16 10:11:33.897
11650,200,7271,대구,5,5,0,6134,2020-12-07 09:00:00.000,2021-09-16 10:11:33.897
11651,11,1588,인천,40,37,3,6133,2020-12-07 09:00:00.000,2021-09-16 10:11:33.897
11652,3,748,광주,5,3,2,6132,2020-12-07 09:00:00.000,2021-09-16 10:11:33.897
11653,6,552,대전,2,2,0,6131,2020-12-07 09:00:00.000,2021-09-16 10:11:33.897
11654,2,260,울산,38,38,0,6130,2020-12-07 09:00:00.000,2021-09-16 10:11:33.897
11655,0,120,세종,0,0,0,6129,2020-12-07 09:00:00.000,2021-09-16 10:11:33.897
11656,125,8315,경기,156,154,2,6128,2020-12-07 09:00:00.000,2021-09-16 10:11:33.897
11657,9,714,강원,9,9,0,6127,2020-12-07 09:00:00.000,2021-09-16 10:11:33.897
11658,3,433,충북,11,11,0,6126,2020-12-07 09:00:00.000,2021-09-16 10:11:33.897
11659,10,995,충남,10,10,0,6125,2020-12-07 09:00:00.000,2021-09-16 10:11:33.897
11660,2,443,전북,22,21,1,6124,2020-12-07 09:00:00.000,2021-09-16 10:11:33.897
11661,2,447,전남,3,2,1,6123,2020-12-07 09:00:00.000,2021-09-16 10:11:33.897
11662,57,1777,경북,9,9,0,6122,2020-12-07 09:00:00.000,2021-09-16 10:11:33.897
11663,1,731,경남,16,15,1,6121,2020-12-07 09:00:00.000,2021-09-16 10:11:33.897
11664,0,87,제주,0,0,0,6120,2020-12-07 09:00:00.000,2021-09-16 10:11:33.897
11665,0,2206,검역,10,0,10,6119,2020-12-07 09:00:00.000,2021-09-16 10:11:33.897
11666,545,37537,합계,631,599,32,6118,2020-12-06 09:00:00.000,2021-09-16 10:11:33.897
11667,101,10205,서울,254,253,1,6117,2020-12-06 09:00:00.000,2021-09-16 10:11:33.897
11668,16,981,부산,34,34,0,6116,2020-12-06 09:00:00.000,2021-09-16 10:11:33.897
11669,200,7266,대구,3,3,0,6115,2020-12-06 09:00:00.000,2021-09-16 10:11:33.897
11670,11,1548,인천,42,41,1,6114,2020-12-06 09:00:00.000,2021-09-16 10:11:33.897
11671,3,743,광주,5,3,2,6113,2020-12-06 09:00:00.000,2021-09-16 10:11:33.897
11672,6,550,대전,3,3,0,6112,2020-12-06 09:00:00.000,2021-09-16 10:11:33.897
11673,2,222,울산,3,3,0,6111,2020-12-06 09:00:00.000,2021-09-16 10:11:33.897
11674,0,120,세종,3,2,1,6110,2020-12-06 09:00:00.000,2021-09-16 10:11:33.897
11675,123,8159,경기,184,176,8,6109,2020-12-06 09:00:00.000,2021-09-16 10:11:33.897
11676,8,705,강원,12,11,1,6108,2020-12-06 09:00:00.000,2021-09-16 10:11:33.897
11677,3,422,충북,14,13,1,6107,2020-12-06 09:00:00.000,2021-09-16 10:11:33.897
11678,10,985,충남,15,14,1,6106,2020-12-06 09:00:00.000,2021-09-16 10:11:33.897
11679,2,421,전북,12,11,1,6105,2020-12-06 09:00:00.000,2021-09-16 10:11:33.897
11680,2,444,전남,8,8,0,6104,2020-12-06 09:00:00.000,2021-09-16 10:11:33.897
11681,57,1768,경북,11,9,2,6103,2020-12-06 09:00:00.000,2021-09-16 10:11:33.897
11682,1,715,경남,16,15,1,6102,2020-12-06 09:00:00.000,2021-09-16 10:11:33.897
11683,0,87,제주,0,0,0,6101,2020-12-06 09:00:00.000,2021-09-16 10:11:33.897
11684,0,2196,검역,12,0,12,6100,2020-12-06 09:00:00.000,2021-09-16 10:11:33.897
11685,540,36906,합계,577,559,18,6099,2020-12-05 09:00:00.000,2021-09-16 10:11:33.897
11686,100,9951,서울,235,231,4,6098,2020-12-05 09:00:00.000,2021-09-16 10:11:33.897
11687,16,947,부산,29,29,0,6097,2020-12-05 09:00:00.000,2021-09-16 10:11:33.897
11688,200,7263,대구,7,7,0,6096,2020-12-05 09:00:00.000,2021-09-16 10:11:33.897
11689,11,1506,인천,19,19,0,6095,2020-12-05 09:00:00.000,2021-09-16 10:11:33.897
11690,3,738,광주,6,6,0,6094,2020-12-05 09:00:00.000,2021-09-16 10:11:33.897
11691,6,547,대전,10,10,0,6093,2020-12-05 09:00:00.000,2021-09-16 10:11:33.897
11692,2,219,울산,1,1,0,6092,2020-12-05 09:00:00.000,2021-09-16 10:11:33.897
11693,0,117,세종,4,4,0,6091,2020-12-05 09:00:00.000,2021-09-16 10:11:33.897
11694,121,7975,경기,157,150,7,6090,2020-12-05 09:00:00.000,2021-09-16 10:11:33.897
11695,6,693,강원,9,9,0,6089,2020-12-05 09:00:00.000,2021-09-16 10:11:33.897
11696,3,408,충북,18,18,0,6088,2020-12-05 09:00:00.000,2021-09-16 10:11:33.897
11697,10,970,충남,10,10,0,6087,2020-12-05 09:00:00.000,2021-09-16 10:11:33.897
11698,2,409,전북,17,17,0,6086,2020-12-05 09:00:00.000,2021-09-16 10:11:33.897
11699,2,436,전남,4,4,0,6085,2020-12-05 09:00:00.000,2021-09-16 10:11:33.897
11700,57,1757,경북,17,16,1,6084,2020-12-05 09:00:00.000,2021-09-16 10:11:33.897
11701,1,699,경남,27,27,0,6083,2020-12-05 09:00:00.000,2021-09-16 10:11:33.897
11702,0,87,제주,1,1,0,6082,2020-12-05 09:00:00.000,2021-09-16 10:11:33.897
11703,0,2184,검역,6,0,6,6081,2020-12-05 09:00:00.000,2021-09-16 10:11:33.897
11704,536,36329,합계,628,600,28,6080,2020-12-04 09:00:00.000,2021-09-16 10:11:33.897
11705,97,9716,서울,295,291,4,6079,2020-12-04 09:00:00.000,2021-09-16 10:11:33.897
11706,16,918,부산,31,31,0,6078,2020-12-04 09:00:00.000,2021-09-16 10:11:33.897
11707,200,7256,대구,6,6,0,6077,2020-12-04 09:00:00.000,2021-09-16 10:11:33.897
11708,11,1487,인천,17,17,0,6076,2020-12-04 09:00:00.000,2021-09-16 10:11:33.897
11709,3,732,광주,1,1,0,6075,2020-12-04 09:00:00.000,2021-09-16 10:11:33.897
11710,6,537,대전,21,21,0,6074,2020-12-04 09:00:00.000,2021-09-16 10:11:33.897
11711,2,218,울산,5,5,0,6073,2020-12-04 09:00:00.000,2021-09-16 10:11:33.897
11712,0,113,세종,0,0,0,6072,2020-12-04 09:00:00.000,2021-09-16 10:11:33.897
11713,120,7818,경기,160,155,5,6071,2020-12-04 09:00:00.000,2021-09-16 10:11:33.897
11714,6,684,강원,3,3,0,6070,2020-12-04 09:00:00.000,2021-09-16 10:11:33.897
11715,3,390,충북,5,5,0,6069,2020-12-04 09:00:00.000,2021-09-16 10:11:33.897
11716,10,960,충남,23,22,1,6068,2020-12-04 09:00:00.000,2021-09-16 10:11:33.897
11717,2,392,전북,14,13,1,6067,2020-12-04 09:00:00.000,2021-09-16 10:11:33.897
11718,2,432,전남,3,3,0,6066,2020-12-04 09:00:00.000,2021-09-16 10:11:33.897
11719,57,1740,경북,9,9,0,6065,2020-12-04 09:00:00.000,2021-09-16 10:11:33.897
11720,1,672,경남,16,16,0,6064,2020-12-04 09:00:00.000,2021-09-16 10:11:33.897
11721,0,86,제주,2,2,0,6063,2020-12-04 09:00:00.000,2021-09-16 10:11:33.897
11722,0,2178,검역,17,0,17,6062,2020-12-04 09:00:00.000,2021-09-16 10:11:33.897
11723,529,35701,합계,540,516,24,6061,2020-12-03 09:00:00.000,2021-09-16 10:11:33.897
11724,95,9421,서울,262,260,2,6060,2020-12-03 09:00:00.000,2021-09-16 10:11:33.897
11725,16,887,부산,15,15,0,6059,2020-12-03 09:00:00.000,2021-09-16 10:11:33.897
11726,200,7250,대구,3,3,0,6058,2020-12-03 09:00:00.000,2021-09-16 10:11:33.897
11727,11,1470,인천,22,22,0,6057,2020-12-03 09:00:00.000,2021-09-16 10:11:33.897
11728,3,731,광주,3,3,0,6056,2020-12-03 09:00:00.000,2021-09-16 10:11:33.897
11729,6,516,대전,7,7,0,6055,2020-12-03 09:00:00.000,2021-09-16 10:11:33.897
11730,2,213,울산,2,2,0,6054,2020-12-03 09:00:00.000,2021-09-16 10:11:33.897
11731,0,113,세종,4,4,0,6053,2020-12-03 09:00:00.000,2021-09-16 10:11:33.897
11732,116,7658,경기,141,137,4,6052,2020-12-03 09:00:00.000,2021-09-16 10:11:33.897
11733,6,681,강원,8,8,0,6051,2020-12-03 09:00:00.000,2021-09-16 10:11:33.897
11734,3,385,충북,10,9,1,6050,2020-12-03 09:00:00.000,2021-09-16 10:11:33.897
11735,9,937,충남,14,13,1,6049,2020-12-03 09:00:00.000,2021-09-16 10:11:33.897
11736,2,378,전북,9,7,2,6048,2020-12-03 09:00:00.000,2021-09-16 10:11:33.897
11737,2,429,전남,2,2,0,6047,2020-12-03 09:00:00.000,2021-09-16 10:11:33.897
11738,57,1731,경북,11,10,1,6046,2020-12-03 09:00:00.000,2021-09-16 10:11:33.897
11739,1,656,경남,13,13,0,6045,2020-12-03 09:00:00.000,2021-09-16 10:11:33.897
11740,0,84,제주,1,1,0,6044,2020-12-03 09:00:00.000,2021-09-16 10:11:33.897
11741,0,2161,검역,13,0,13,6043,2020-12-03 09:00:00.000,2021-09-16 10:11:33.897
11742,526,35161,합계,511,492,19,6042,2020-12-02 09:00:00.000,2021-09-16 10:11:33.897
11743,93,9159,서울,193,192,1,6041,2020-12-02 09:00:00.000,2021-09-16 10:11:33.897
11744,16,872,부산,32,31,1,6040,2020-12-02 09:00:00.000,2021-09-16 10:11:33.897
11745,199,7247,대구,4,4,0,6039,2020-12-02 09:00:00.000,2021-09-16 10:11:33.897
11746,11,1448,인천,23,21,2,6038,2020-12-02 09:00:00.000,2021-09-16 10:11:33.897
11747,3,728,광주,10,10,0,6037,2020-12-02 09:00:00.000,2021-09-16 10:11:33.897
11748,6,509,대전,5,5,0,6036,2020-12-02 09:00:00.000,2021-09-16 10:11:33.897
11749,2,211,울산,10,6,4,6035,2020-12-02 09:00:00.000,2021-09-16 10:11:33.897
11750,0,109,세종,7,7,0,6034,2020-12-02 09:00:00.000,2021-09-16 10:11:33.897
11751,116,7517,경기,144,142,2,6033,2020-12-02 09:00:00.000,2021-09-16 10:11:33.897
11752,6,673,강원,12,12,0,6032,2020-12-02 09:00:00.000,2021-09-16 10:11:33.897
11753,3,375,충북,16,16,0,6031,2020-12-02 09:00:00.000,2021-09-16 10:11:33.897
11754,9,923,충남,8,6,2,6030,2020-12-02 09:00:00.000,2021-09-16 10:11:33.897
11755,2,369,전북,26,26,0,6029,2020-12-02 09:00:00.000,2021-09-16 10:11:33.897
11756,2,427,전남,1,1,0,6028,2020-12-02 09:00:00.000,2021-09-16 10:11:33.897
11757,57,1720,경북,5,4,1,6027,2020-12-02 09:00:00.000,2021-09-16 10:11:33.897
11758,1,643,경남,7,7,0,6026,2020-12-02 09:00:00.000,2021-09-16 10:11:33.897
11759,0,83,제주,2,2,0,6025,2020-12-02 09:00:00.000,2021-09-16 10:11:33.897
11760,0,2148,검역,6,0,6,6024,2020-12-02 09:00:00.000,2021-09-16 10:11:33.897
11761,526,34650,합계,451,420,31,6023,2020-12-01 09:00:00.000,2021-09-16 10:11:33.897
11762,93,8966,서울,155,153,2,6022,2020-12-01 09:00:00.000,2021-09-16 10:11:33.897
11763,16,840,부산,31,31,0,6021,2020-12-01 09:00:00.000,2021-09-16 10:11:33.897
11764,199,7243,대구,11,11,0,6020,2020-12-01 09:00:00.000,2021-09-16 10:11:33.897
11765,11,1425,인천,16,16,0,6019,2020-12-01 09:00:00.000,2021-09-16 10:11:33.897
11766,3,718,광주,22,22,0,6018,2020-12-01 09:00:00.000,2021-09-16 10:11:33.897
11767,6,504,대전,10,10,0,6017,2020-12-01 09:00:00.000,2021-09-16 10:11:33.897
11768,2,201,울산,3,2,1,6016,2020-12-01 09:00:00.000,2021-09-16 10:11:33.897
11769,0,102,세종,2,2,0,6015,2020-12-01 09:00:00.000,2021-09-16 10:11:33.897
11770,116,7373,경기,96,86,10,6014,2020-12-01 09:00:00.000,2021-09-16 10:11:33.897
11771,6,661,강원,9,9,0,6013,2020-12-01 09:00:00.000,2021-09-16 10:11:33.897
11772,3,359,충북,32,31,1,6012,2020-12-01 09:00:00.000,2021-09-16 10:11:33.897
11773,9,915,충남,16,16,0,6011,2020-12-01 09:00:00.000,2021-09-16 10:11:33.897
11774,2,343,전북,9,9,0,6010,2020-12-01 09:00:00.000,2021-09-16 10:11:33.897
11775,2,426,전남,2,2,0,6009,2020-12-01 09:00:00.000,2021-09-16 10:11:33.897
11776,57,1715,경북,11,10,1,6008,2020-12-01 09:00:00.000,2021-09-16 10:11:33.897
11777,1,636,경남,11,10,1,6007,2020-12-01 09:00:00.000,2021-09-16 10:11:33.897
11778,0,81,제주,1,0,1,6006,2020-12-01 09:00:00.000,2021-09-16 10:11:33.897
11779,0,2142,검역,14,0,14,6005,2020-12-01 09:00:00.000,2021-09-16 10:11:33.897
11780,526,34199,합계,438,414,24,6004,2020-11-30 09:00:00.000,2021-09-16 10:11:33.897
11781,93,8811,서울,159,158,1,6003,2020-11-30 09:00:00.000,2021-09-16 10:11:33.897
11782,16,809,부산,52,52,0,6002,2020-11-30 09:00:00.000,2021-09-16 10:11:33.897
11783,199,7232,대구,4,4,0,6001,2020-11-30 09:00:00.000,2021-09-16 10:11:33.897
11784,11,1409,인천,34,34,0,6000,2020-11-30 09:00:00.000,2021-09-16 10:11:33.897
11785,3,696,광주,13,12,1,5999,2020-11-30 09:00:00.000,2021-09-16 10:11:33.897
11786,6,494,대전,5,5,0,5998,2020-11-30 09:00:00.000,2021-09-16 10:11:33.897
11787,2,198,울산,3,3,0,5997,2020-11-30 09:00:00.000,2021-09-16 10:11:33.897
11788,0,100,세종,1,1,0,5996,2020-11-30 09:00:00.000,2021-09-16 10:11:33.897
11789,116,7277,경기,77,69,8,5995,2020-11-30 09:00:00.000,2021-09-16 10:11:33.897
11790,6,652,강원,8,8,0,5994,2020-11-30 09:00:00.000,2021-09-16 10:11:33.897
11791,3,327,충북,22,22,0,5993,2020-11-30 09:00:00.000,2021-09-16 10:11:33.897
11792,9,899,충남,5,4,1,5992,2020-11-30 09:00:00.000,2021-09-16 10:11:33.897
11793,2,334,전북,16,16,0,5991,2020-11-30 09:00:00.000,2021-09-16 10:11:33.897
11794,2,424,전남,4,3,1,5990,2020-11-30 09:00:00.000,2021-09-16 10:11:33.897
11795,57,1704,경북,4,4,0,5989,2020-11-30 09:00:00.000,2021-09-16 10:11:33.897
11796,1,625,경남,20,19,1,5988,2020-11-30 09:00:00.000,2021-09-16 10:11:33.897
11797,0,80,제주,1,0,1,5987,2020-11-30 09:00:00.000,2021-09-16 10:11:33.897
11798,0,2128,검역,10,0,10,5986,2020-11-30 09:00:00.000,2021-09-16 10:11:33.897
11799,523,33761,합계,450,413,37,5985,2020-11-29 09:00:00.000,2021-09-16 10:11:33.897
11800,92,8652,서울,158,154,4,5984,2020-11-29 09:00:00.000,2021-09-16 10:11:33.897
11801,15,757,부산,22,21,1,5983,2020-11-29 09:00:00.000,2021-09-16 10:11:33.897
11802,199,7228,대구,3,1,2,5982,2020-11-29 09:00:00.000,2021-09-16 10:11:33.897
11803,11,1375,인천,21,21,0,5981,2020-11-29 09:00:00.000,2021-09-16 10:11:33.897
11804,3,683,광주,8,6,2,5980,2020-11-29 09:00:00.000,2021-09-16 10:11:33.897
11805,6,489,대전,6,6,0,5979,2020-11-29 09:00:00.000,2021-09-16 10:11:33.897
11806,2,195,울산,0,0,0,5978,2020-11-29 09:00:00.000,2021-09-16 10:11:33.897
11807,0,99,세종,3,3,0,5977,2020-11-29 09:00:00.000,2021-09-16 10:11:33.897
11808,116,7200,경기,94,88,6,5976,2020-11-29 09:00:00.000,2021-09-16 10:11:33.897
11809,6,644,강원,19,19,0,5975,2020-11-29 09:00:00.000,2021-09-16 10:11:33.897
11810,3,305,충북,22,19,3,5974,2020-11-29 09:00:00.000,2021-09-16 10:11:33.897
11811,8,894,충남,13,12,1,5973,2020-11-29 09:00:00.000,2021-09-16 10:11:33.897
11812,2,318,전북,17,17,0,5972,2020-11-29 09:00:00.000,2021-09-16 10:11:33.897
11813,2,420,전남,20,20,0,5971,2020-11-29 09:00:00.000,2021-09-16 10:11:33.897
11814,57,1700,경북,11,11,0,5970,2020-11-29 09:00:00.000,2021-09-16 10:11:33.897
11815,1,605,경남,15,15,0,5969,2020-11-29 09:00:00.000,2021-09-16 10:11:33.897
11816,0,79,제주,1,0,1,5968,2020-11-29 09:00:00.000,2021-09-16 10:11:33.897
11817,0,2118,검역,17,0,17,5967,2020-11-29 09:00:00.000,2021-09-16 10:11:33.897
11818,522,33311,합계,503,486,17,5966,2020-11-28 09:00:00.000,2021-09-16 10:11:33.897
11819,91,8494,서울,178,176,2,5965,2020-11-28 09:00:00.000,2021-09-16 10:11:33.897
11820,15,735,부산,28,27,1,5964,2020-11-28 09:00:00.000,2021-09-16 10:11:33.897
11821,199,7225,대구,1,1,0,5963,2020-11-28 09:00:00.000,2021-09-16 10:11:33.897
11822,11,1354,인천,25,25,0,5962,2020-11-28 09:00:00.000,2021-09-16 10:11:33.897
11823,3,675,광주,16,14,2,5961,2020-11-28 09:00:00.000,2021-09-16 10:11:33.897
11824,6,483,대전,13,13,0,5960,2020-11-28 09:00:00.000,2021-09-16 10:11:33.897
11825,2,195,울산,3,3,0,5959,2020-11-28 09:00:00.000,2021-09-16 10:11:33.897
11826,0,96,세종,0,0,0,5958,2020-11-28 09:00:00.000,2021-09-16 10:11:33.897
11827,116,7106,경기,125,122,3,5957,2020-11-28 09:00:00.000,2021-09-16 10:11:33.897
11828,6,625,강원,33,33,0,5956,2020-11-28 09:00:00.000,2021-09-16 10:11:33.897
11829,3,283,충북,24,23,1,5955,2020-11-28 09:00:00.000,2021-09-16 10:11:33.897
11830,8,881,충남,17,14,3,5954,2020-11-28 09:00:00.000,2021-09-16 10:11:33.897
11831,2,301,전북,9,9,0,5953,2020-11-28 09:00:00.000,2021-09-16 10:11:33.897
11832,2,400,전남,7,7,0,5952,2020-11-28 09:00:00.000,2021-09-16 10:11:33.897
11833,57,1689,경북,5,4,1,5951,2020-11-28 09:00:00.000,2021-09-16 10:11:33.897
11834,1,590,경남,14,13,1,5950,2020-11-28 09:00:00.000,2021-09-16 10:11:33.897
11835,0,78,제주,2,2,0,5949,2020-11-28 09:00:00.000,2021-09-16 10:11:33.897
11836,0,2101,검역,3,0,3,5948,2020-11-28 09:00:00.000,2021-09-16 10:11:33.897
11837,516,32808,합계,555,525,30,5947,2020-11-27 09:00:00.000,2021-09-16 10:11:33.897
11838,88,8316,서울,204,204,0,5946,2020-11-27 09:00:00.000,2021-09-16 10:11:33.897
11839,15,707,부산,24,24,0,5945,2020-11-27 09:00:00.000,2021-09-16 10:11:33.897
11840,199,7224,대구,0,0,0,5944,2020-11-27 09:00:00.000,2021-09-16 10:11:33.897
11841,11,1329,인천,25,21,4,5943,2020-11-27 09:00:00.000,2021-09-16 10:11:33.897
11842,3,659,광주,13,13,0,5942,2020-11-27 09:00:00.000,2021-09-16 10:11:33.897
11843,6,470,대전,5,5,0,5941,2020-11-27 09:00:00.000,2021-09-16 10:11:33.897
11844,2,192,울산,7,7,0,5940,2020-11-27 09:00:00.000,2021-09-16 10:11:33.897
11845,0,96,세종,3,3,0,5939,2020-11-27 09:00:00.000,2021-09-16 10:11:33.897
11846,113,6981,경기,117,112,5,5938,2020-11-27 09:00:00.000,2021-09-16 10:11:33.897
11847,6,592,강원,9,8,1,5937,2020-11-27 09:00:00.000,2021-09-16 10:11:33.897
11848,3,259,충북,20,19,1,5936,2020-11-27 09:00:00.000,2021-09-16 10:11:33.897
11849,8,864,충남,31,31,0,5935,2020-11-27 09:00:00.000,2021-09-16 10:11:33.897
11850,2,292,전북,24,24,0,5934,2020-11-27 09:00:00.000,2021-09-16 10:11:33.897
11851,2,393,전남,11,10,1,5933,2020-11-27 09:00:00.000,2021-09-16 10:11:33.897
11852,57,1684,경북,3,3,0,5932,2020-11-27 09:00:00.000,2021-09-16 10:11:33.897
11853,1,576,경남,39,38,1,5931,2020-11-27 09:00:00.000,2021-09-16 10:11:33.897
11854,0,76,제주,3,3,0,5930,2020-11-27 09:00:00.000,2021-09-16 10:11:33.897
11855,0,2098,검역,17,0,17,5929,2020-11-27 09:00:00.000,2021-09-16 10:11:33.897
11856,515,32253,합계,581,552,29,5928,2020-11-26 09:00:00.000,2021-09-16 10:11:33.897
11857,88,8112,서울,212,207,5,5927,2020-11-26 09:00:00.000,2021-09-16 10:11:33.897
11858,15,683,부산,22,19,3,5926,2020-11-26 09:00:00.000,2021-09-16 10:11:33.897
11859,199,7224,대구,1,1,0,5925,2020-11-26 09:00:00.000,2021-09-16 10:11:33.897
11860,11,1304,인천,18,17,1,5924,2020-11-26 09:00:00.000,2021-09-16 10:11:33.897
11861,3,646,광주,14,14,0,5923,2020-11-26 09:00:00.000,2021-09-16 10:11:33.897
11862,6,465,대전,1,1,0,5922,2020-11-26 09:00:00.000,2021-09-16 10:11:33.897
11863,2,185,울산,7,6,1,5921,2020-11-26 09:00:00.000,2021-09-16 10:11:33.897
11864,0,93,세종,4,4,0,5920,2020-11-26 09:00:00.000,2021-09-16 10:11:33.897
11865,112,6864,경기,183,177,6,5919,2020-11-26 09:00:00.000,2021-09-16 10:11:33.897
11866,6,583,강원,8,8,0,5918,2020-11-26 09:00:00.000,2021-09-16 10:11:33.897
11867,3,239,충북,8,8,0,5917,2020-11-26 09:00:00.000,2021-09-16 10:11:33.897
11868,8,833,충남,16,16,0,5916,2020-11-26 09:00:00.000,2021-09-16 10:11:33.897
11869,2,268,전북,16,16,0,5915,2020-11-26 09:00:00.000,2021-09-16 10:11:33.897
11870,2,382,전남,9,9,0,5914,2020-11-26 09:00:00.000,2021-09-16 10:11:33.897
11871,57,1681,경북,2,2,0,5913,2020-11-26 09:00:00.000,2021-09-16 10:11:33.897
11872,1,537,경남,45,45,0,5912,2020-11-26 09:00:00.000,2021-09-16 10:11:33.897
11873,0,73,제주,3,2,1,5911,2020-11-26 09:00:00.000,2021-09-16 10:11:33.897
11874,0,2081,검역,12,0,12,5910,2020-11-26 09:00:00.000,2021-09-16 10:11:33.897
11875,513,31672,합계,382,363,19,5909,2020-11-25 09:00:00.000,2021-09-16 10:11:33.897
11876,87,7900,서울,142,139,3,5908,2020-11-25 09:00:00.000,2021-09-16 10:11:33.897
11877,15,661,부산,18,18,0,5907,2020-11-25 09:00:00.000,2021-09-16 10:11:33.897
11878,199,7223,대구,5,5,0,5906,2020-11-25 09:00:00.000,2021-09-16 10:11:33.897
11879,11,1286,인천,40,39,1,5905,2020-11-25 09:00:00.000,2021-09-16 10:11:33.897
11880,3,632,광주,14,14,0,5904,2020-11-25 09:00:00.000,2021-09-16 10:11:33.897
11881,6,464,대전,4,4,0,5903,2020-11-25 09:00:00.000,2021-09-16 10:11:33.897
11882,2,178,울산,3,3,0,5902,2020-11-25 09:00:00.000,2021-09-16 10:11:33.897
11883,0,89,세종,0,0,0,5901,2020-11-25 09:00:00.000,2021-09-16 10:11:33.897
11884,111,6681,경기,82,77,5,5900,2020-11-25 09:00:00.000,2021-09-16 10:11:33.897
11885,6,575,강원,13,12,1,5899,2020-11-25 09:00:00.000,2021-09-16 10:11:33.897
11886,3,231,충북,3,3,0,5898,2020-11-25 09:00:00.000,2021-09-16 10:11:33.897
11887,8,817,충남,18,18,0,5897,2020-11-25 09:00:00.000,2021-09-16 10:11:33.897
11888,2,252,전북,8,8,0,5896,2020-11-25 09:00:00.000,2021-09-16 10:11:33.897
11889,2,373,전남,8,8,0,5895,2020-11-25 09:00:00.000,2021-09-16 10:11:33.897
11890,57,1679,경북,3,2,1,5894,2020-11-25 09:00:00.000,2021-09-16 10:11:33.897
11891,1,492,경남,11,10,1,5893,2020-11-25 09:00:00.000,2021-09-16 10:11:33.897
11892,0,70,제주,3,3,0,5892,2020-11-25 09:00:00.000,2021-09-16 10:11:33.897
11893,0,2069,검역,7,0,7,5891,2020-11-25 09:00:00.000,2021-09-16 10:11:33.897
11894,510,31290,합계,349,318,31,5890,2020-11-24 09:00:00.000,2021-09-16 10:11:33.897
11895,87,7758,서울,133,130,3,5889,2020-11-24 09:00:00.000,2021-09-16 10:11:33.897
11896,15,643,부산,6,6,0,5888,2020-11-24 09:00:00.000,2021-09-16 10:11:33.897
11897,198,7218,대구,3,2,1,5887,2020-11-24 09:00:00.000,2021-09-16 10:11:33.897
11898,11,1246,인천,17,16,1,5886,2020-11-24 09:00:00.000,2021-09-16 10:11:33.897
11899,3,618,광주,3,3,0,5885,2020-11-24 09:00:00.000,2021-09-16 10:11:33.897
11900,6,460,대전,0,0,0,5884,2020-11-24 09:00:00.000,2021-09-16 10:11:33.897
11901,2,175,울산,2,1,1,5883,2020-11-24 09:00:00.000,2021-09-16 10:11:33.897
11902,0,89,세종,2,2,0,5882,2020-11-24 09:00:00.000,2021-09-16 10:11:33.897
11903,110,6599,경기,81,69,12,5881,2020-11-24 09:00:00.000,2021-09-16 10:11:33.897
11904,6,562,강원,46,45,1,5880,2020-11-24 09:00:00.000,2021-09-16 10:11:33.897
11905,3,228,충북,3,3,0,5879,2020-11-24 09:00:00.000,2021-09-16 10:11:33.897
11906,8,799,충남,8,7,1,5878,2020-11-24 09:00:00.000,2021-09-16 10:11:33.897
11907,1,244,전북,15,14,1,5877,2020-11-24 09:00:00.000,2021-09-16 10:11:33.897
11908,2,365,전남,7,7,0,5876,2020-11-24 09:00:00.000,2021-09-16 10:11:33.897
11909,57,1676,경북,9,9,0,5875,2020-11-24 09:00:00.000,2021-09-16 10:11:33.897
11910,1,481,경남,3,3,0,5874,2020-11-24 09:00:00.000,2021-09-16 10:11:33.897
11911,0,67,제주,1,1,0,5873,2020-11-24 09:00:00.000,2021-09-16 10:11:33.897
11912,0,2062,검역,10,0,10,5872,2020-11-24 09:00:00.000,2021-09-16 10:11:33.897
11913,509,30941,합계,271,255,16,5871,2020-11-23 09:00:00.000,2021-09-16 10:11:33.897
11914,86,7625,서울,112,109,3,5870,2020-11-23 09:00:00.000,2021-09-16 10:11:33.897
11915,15,637,부산,5,4,1,5869,2020-11-23 09:00:00.000,2021-09-16 10:11:33.897
11916,198,7215,대구,2,1,1,5868,2020-11-23 09:00:00.000,2021-09-16 10:11:33.897
11917,11,1229,인천,23,23,0,5867,2020-11-23 09:00:00.000,2021-09-16 10:11:33.897
11918,3,615,광주,1,1,0,5866,2020-11-23 09:00:00.000,2021-09-16 10:11:33.897
11919,6,460,대전,3,2,1,5865,2020-11-23 09:00:00.000,2021-09-16 10:11:33.897
11920,2,173,울산,1,1,0,5864,2020-11-23 09:00:00.000,2021-09-16 10:11:33.897
11921,0,87,세종,1,0,1,5863,2020-11-23 09:00:00.000,2021-09-16 10:11:33.897
11922,110,6518,경기,76,74,2,5862,2020-11-23 09:00:00.000,2021-09-16 10:11:33.897
11923,6,516,강원,12,11,1,5861,2020-11-23 09:00:00.000,2021-09-16 10:11:33.897
11924,3,225,충북,0,0,0,5860,2020-11-23 09:00:00.000,2021-09-16 10:11:33.897
11925,8,791,충남,9,8,1,5859,2020-11-23 09:00:00.000,2021-09-16 10:11:33.897
11926,1,229,전북,9,9,0,5858,2020-11-23 09:00:00.000,2021-09-16 10:11:33.897
11927,2,358,전남,5,5,0,5857,2020-11-23 09:00:00.000,2021-09-16 10:11:33.897
11928,57,1667,경북,4,4,0,5856,2020-11-23 09:00:00.000,2021-09-16 10:11:33.897
11929,1,478,경남,2,2,0,5855,2020-11-23 09:00:00.000,2021-09-16 10:11:33.897
11930,0,66,제주,1,1,0,5854,2020-11-23 09:00:00.000,2021-09-16 10:11:33.897
11931,0,2052,검역,5,0,5,5853,2020-11-23 09:00:00.000,2021-09-16 10:11:33.897
11932,505,30670,합계,330,302,28,5852,2020-11-22 09:00:00.000,2021-09-16 10:11:33.897
11933,85,7513,서울,121,119,2,5851,2020-11-22 09:00:00.000,2021-09-16 10:11:33.897
11934,15,632,부산,1,1,0,5850,2020-11-22 09:00:00.000,2021-09-16 10:11:33.897
11935,197,7213,대구,1,0,1,5849,2020-11-22 09:00:00.000,2021-09-16 10:11:33.897
11936,11,1206,인천,27,26,1,5848,2020-11-22 09:00:00.000,2021-09-16 10:11:33.897
11937,3,614,광주,8,8,0,5847,2020-11-22 09:00:00.000,2021-09-16 10:11:33.897
11938,6,457,대전,0,0,0,5846,2020-11-22 09:00:00.000,2021-09-16 10:11:33.897
11939,2,172,울산,1,1,0,5845,2020-11-22 09:00:00.000,2021-09-16 10:11:33.897
11940,0,86,세종,0,0,0,5844,2020-11-22 09:00:00.000,2021-09-16 10:11:33.897
11941,110,6442,경기,75,74,1,5843,2020-11-22 09:00:00.000,2021-09-16 10:11:33.897
11942,5,504,강원,13,12,1,5842,2020-11-22 09:00:00.000,2021-09-16 10:11:33.897
11943,3,225,충북,0,0,0,5841,2020-11-22 09:00:00.000,2021-09-16 10:11:33.897
11944,8,782,충남,13,11,2,5840,2020-11-22 09:00:00.000,2021-09-16 10:11:33.897
11945,1,220,전북,12,12,0,5839,2020-11-22 09:00:00.000,2021-09-16 10:11:33.897
11946,2,353,전남,13,13,0,5838,2020-11-22 09:00:00.000,2021-09-16 10:11:33.897
11947,57,1663,경북,6,6,0,5837,2020-11-22 09:00:00.000,2021-09-16 10:11:33.897
11948,0,476,경남,19,19,0,5836,2020-11-22 09:00:00.000,2021-09-16 10:11:33.897
11949,0,65,제주,0,0,0,5835,2020-11-22 09:00:00.000,2021-09-16 10:11:33.897
11950,0,2047,검역,20,0,20,5834,2020-11-22 09:00:00.000,2021-09-16 10:11:33.897
11951,503,30340,합계,386,361,25,5833,2020-11-21 09:00:00.000,2021-09-16 10:11:33.897
11952,85,7392,서울,156,154,2,5832,2020-11-21 09:00:00.000,2021-09-16 10:11:33.897
11953,15,631,부산,7,7,0,5831,2020-11-21 09:00:00.000,2021-09-16 10:11:33.897
11954,197,7212,대구,1,0,1,5830,2020-11-21 09:00:00.000,2021-09-16 10:11:33.897
11955,11,1179,인천,22,22,0,5829,2020-11-21 09:00:00.000,2021-09-16 10:11:33.897
11956,3,606,광주,7,6,1,5828,2020-11-21 09:00:00.000,2021-09-16 10:11:33.897
11957,6,457,대전,1,1,0,5827,2020-11-21 09:00:00.000,2021-09-16 10:11:33.897
11958,2,171,울산,1,1,0,5826,2020-11-21 09:00:00.000,2021-09-16 10:11:33.897
11959,0,86,세종,0,0,0,5825,2020-11-21 09:00:00.000,2021-09-16 10:11:33.897
11960,108,6367,경기,93,86,7,5824,2020-11-21 09:00:00.000,2021-09-16 10:11:33.897
11961,5,491,강원,15,14,1,5823,2020-11-21 09:00:00.000,2021-09-16 10:11:33.897
11962,3,225,충북,1,1,0,5822,2020-11-21 09:00:00.000,2021-09-16 10:11:33.897
11963,8,769,충남,21,19,2,5821,2020-11-21 09:00:00.000,2021-09-16 10:11:33.897
11964,1,208,전북,14,13,1,5820,2020-11-21 09:00:00.000,2021-09-16 10:11:33.897
11965,2,340,전남,19,18,1,5819,2020-11-21 09:00:00.000,2021-09-16 10:11:33.897
11966,57,1657,경북,8,8,0,5818,2020-11-21 09:00:00.000,2021-09-16 10:11:33.897
11967,0,457,경남,11,11,0,5817,2020-11-21 09:00:00.000,2021-09-16 10:11:33.897
11968,0,65,제주,0,0,0,5816,2020-11-21 09:00:00.000,2021-09-16 10:11:33.897
11969,0,2027,검역,9,0,9,5815,2020-11-21 09:00:00.000,2021-09-16 10:11:33.897
11970,501,29954,합계,348,320,28,5814,2020-11-20 09:00:00.000,2021-09-16 10:11:33.897
11971,84,7236,서울,132,127,5,5813,2020-11-20 09:00:00.000,2021-09-16 10:11:33.897
11972,15,624,부산,2,2,0,5812,2020-11-20 09:00:00.000,2021-09-16 10:11:33.897
11973,196,7211,대구,1,1,0,5811,2020-11-20 09:00:00.000,2021-09-16 10:11:33.897
11974,11,1157,인천,30,29,1,5810,2020-11-20 09:00:00.000,2021-09-16 10:11:33.897
11975,3,599,광주,4,4,0,5809,2020-11-20 09:00:00.000,2021-09-16 10:11:33.897
11976,6,456,대전,0,0,0,5808,2020-11-20 09:00:00.000,2021-09-16 10:11:33.897
11977,2,170,울산,0,0,0,5807,2020-11-20 09:00:00.000,2021-09-16 10:11:33.897
11978,0,86,세종,0,0,0,5806,2020-11-20 09:00:00.000,2021-09-16 10:11:33.897
11979,108,6274,경기,73,62,11,5805,2020-11-20 09:00:00.000,2021-09-16 10:11:33.897
11980,5,476,강원,24,24,0,5804,2020-11-20 09:00:00.000,2021-09-16 10:11:33.897
11981,3,224,충북,2,2,0,5803,2020-11-20 09:00:00.000,2021-09-16 10:11:33.897
11982,8,748,충남,15,15,0,5802,2020-11-20 09:00:00.000,2021-09-16 10:11:33.897
11983,1,194,전북,13,13,0,5801,2020-11-20 09:00:00.000,2021-09-16 10:11:33.897
11984,2,321,전남,14,14,0,5800,2020-11-20 09:00:00.000,2021-09-16 10:11:33.897
11985,57,1649,경북,10,7,3,5799,2020-11-20 09:00:00.000,2021-09-16 10:11:33.897
11986,0,446,경남,18,18,0,5798,2020-11-20 09:00:00.000,2021-09-16 10:11:33.897
11987,0,65,제주,2,2,0,5797,2020-11-20 09:00:00.000,2021-09-16 10:11:33.897
11988,0,2018,검역,8,0,8,5796,2020-11-20 09:00:00.000,2021-09-16 10:11:33.897
11989,498,29606,합계,325,293,32,5795,2020-11-19 09:00:00.000,2021-09-16 10:11:33.897
11990,83,7104,서울,109,107,2,5794,2020-11-19 09:00:00.000,2021-09-16 10:11:33.897
11991,15,622,부산,5,5,0,5793,2020-11-19 09:00:00.000,2021-09-16 10:11:33.897
11992,196,7210,대구,2,2,0,5792,2020-11-19 09:00:00.000,2021-09-16 10:11:33.897
11993,11,1127,인천,12,11,1,5791,2020-11-19 09:00:00.000,2021-09-16 10:11:33.897
11994,3,595,광주,8,8,0,5790,2020-11-19 09:00:00.000,2021-09-16 10:11:33.897
11995,6,456,대전,1,1,0,5789,2020-11-19 09:00:00.000,2021-09-16 10:11:33.897
11996,2,170,울산,0,0,0,5788,2020-11-19 09:00:00.000,2021-09-16 10:11:33.897
11997,0,86,세종,0,0,0,5787,2020-11-19 09:00:00.000,2021-09-16 10:11:33.897
11998,106,6201,경기,64,59,5,5786,2020-11-19 09:00:00.000,2021-09-16 10:11:33.897
11999,5,452,강원,20,20,0,5785,2020-11-19 09:00:00.000,2021-09-16 10:11:33.897
12000,3,222,충북,4,3,1,5784,2020-11-19 09:00:00.000,2021-09-16 10:11:33.897
12001,8,733,충남,13,13,0,5783,2020-11-19 09:00:00.000,2021-09-16 10:11:33.897
12002,1,181,전북,2,1,1,5782,2020-11-19 09:00:00.000,2021-09-16 10:11:33.897
12003,2,307,전남,28,27,1,5781,2020-11-19 09:00:00.000,2021-09-16 10:11:33.897
12004,57,1639,경북,8,8,0,5780,2020-11-19 09:00:00.000,2021-09-16 10:11:33.897
12005,0,428,경남,28,28,0,5779,2020-11-19 09:00:00.000,2021-09-16 10:11:33.897
12006,0,63,제주,0,0,0,5778,2020-11-19 09:00:00.000,2021-09-16 10:11:33.897
12007,0,2010,검역,21,0,21,5777,2020-11-19 09:00:00.000,2021-09-16 10:11:33.897
12008,496,29281,합계,285,245,40,5776,2020-11-18 09:00:00.000,2021-09-16 10:11:33.897
12009,82,6995,서울,92,91,1,5775,2020-11-18 09:00:00.000,2021-09-16 10:11:33.897
12010,15,617,부산,5,5,0,5774,2020-11-18 09:00:00.000,2021-09-16 10:11:33.897
12011,196,7208,대구,2,2,0,5773,2020-11-18 09:00:00.000,2021-09-16 10:11:33.897
12012,11,1115,인천,12,9,3,5772,2020-11-18 09:00:00.000,2021-09-16 10:11:33.897
12013,3,587,광주,9,9,0,5771,2020-11-18 09:00:00.000,2021-09-16 10:11:33.897
12014,6,455,대전,1,1,0,5770,2020-11-18 09:00:00.000,2021-09-16 10:11:33.897
12015,2,170,울산,3,0,3,5769,2020-11-18 09:00:00.000,2021-09-16 10:11:33.897
12016,0,86,세종,0,0,0,5768,2020-11-18 09:00:00.000,2021-09-16 10:11:33.897
12017,105,6137,경기,87,81,6,5767,2020-11-18 09:00:00.000,2021-09-16 10:11:33.897
12018,5,432,강원,5,5,0,5766,2020-11-18 09:00:00.000,2021-09-16 10:11:33.897
12019,3,218,충북,0,0,0,5765,2020-11-18 09:00:00.000,2021-09-16 10:11:33.897
12020,8,720,충남,7,6,1,5764,2020-11-18 09:00:00.000,2021-09-16 10:11:33.897
12021,1,179,전북,0,0,0,5763,2020-11-18 09:00:00.000,2021-09-16 10:11:33.897
12022,2,279,전남,15,15,0,5762,2020-11-18 09:00:00.000,2021-09-16 10:11:33.897
12023,57,1631,경북,16,12,4,5761,2020-11-18 09:00:00.000,2021-09-16 10:11:33.897
12024,0,400,경남,9,9,0,5760,2020-11-18 09:00:00.000,2021-09-16 10:11:33.897
12025,0,63,제주,0,0,0,5759,2020-11-18 09:00:00.000,2021-09-16 10:11:33.897
12026,0,1989,검역,22,0,22,5758,2020-11-18 09:00:00.000,2021-09-16 10:11:33.897
12027,494,28996,합계,230,202,28,5757,2020-11-17 09:00:00.000,2021-09-16 10:11:33.897
12028,81,6903,서울,90,87,3,5756,2020-11-17 09:00:00.000,2021-09-16 10:11:33.897
12029,15,612,부산,0,0,0,5755,2020-11-17 09:00:00.000,2021-09-16 10:11:33.897
12030,196,7206,대구,3,2,1,5754,2020-11-17 09:00:00.000,2021-09-16 10:11:33.897
12031,11,1103,인천,13,12,1,5753,2020-11-17 09:00:00.000,2021-09-16 10:11:33.897
12032,3,578,광주,18,18,0,5752,2020-11-17 09:00:00.000,2021-09-16 10:11:33.897
12033,6,454,대전,1,1,0,5751,2020-11-17 09:00:00.000,2021-09-16 10:11:33.897
12034,2,167,울산,0,0,0,5750,2020-11-17 09:00:00.000,2021-09-16 10:11:33.897
12035,0,86,세종,1,0,1,5749,2020-11-17 09:00:00.000,2021-09-16 10:11:33.897
12036,105,6050,경기,52,38,14,5748,2020-11-17 09:00:00.000,2021-09-16 10:11:33.897
12037,4,427,강원,13,13,0,5747,2020-11-17 09:00:00.000,2021-09-16 10:11:33.897
12038,3,218,충북,0,0,0,5746,2020-11-17 09:00:00.000,2021-09-16 10:11:33.897
12039,8,713,충남,9,9,0,5745,2020-11-17 09:00:00.000,2021-09-16 10:11:33.897
12040,1,179,전북,0,0,0,5744,2020-11-17 09:00:00.000,2021-09-16 10:11:33.897
12041,2,264,전남,16,16,0,5743,2020-11-17 09:00:00.000,2021-09-16 10:11:33.897
12042,57,1615,경북,3,3,0,5742,2020-11-17 09:00:00.000,2021-09-16 10:11:33.897
12043,0,391,경남,3,3,0,5741,2020-11-17 09:00:00.000,2021-09-16 10:11:33.897
12044,0,63,제주,0,0,0,5740,2020-11-17 09:00:00.000,2021-09-16 10:11:33.897
12045,0,1967,검역,8,0,8,5739,2020-11-17 09:00:00.000,2021-09-16 10:11:33.897
12046,494,28766,합계,222,192,30,5738,2020-11-16 09:00:00.000,2021-09-16 10:11:33.897
12047,81,6813,서울,80,78,2,5737,2020-11-16 09:00:00.000,2021-09-16 10:11:33.897
12048,15,612,부산,0,0,0,5736,2020-11-16 09:00:00.000,2021-09-16 10:11:33.897
12049,196,7203,대구,0,0,0,5735,2020-11-16 09:00:00.000,2021-09-16 10:11:33.897
12050,11,1090,인천,10,10,0,5734,2020-11-16 09:00:00.000,2021-09-16 10:11:33.897
12051,3,560,광주,4,4,0,5733,2020-11-16 09:00:00.000,2021-09-16 10:11:33.897
12052,6,453,대전,3,2,1,5732,2020-11-16 09:00:00.000,2021-09-16 10:11:33.897
12053,2,167,울산,0,0,0,5731,2020-11-16 09:00:00.000,2021-09-16 10:11:33.897
12054,0,85,세종,1,1,0,5730,2020-11-16 09:00:00.000,2021-09-16 10:11:33.897
12055,105,5998,경기,42,39,3,5729,2020-11-16 09:00:00.000,2021-09-16 10:11:33.897
12056,4,414,강원,20,20,0,5728,2020-11-16 09:00:00.000,2021-09-16 10:11:33.897
12057,3,218,충북,3,3,0,5727,2020-11-16 09:00:00.000,2021-09-16 10:11:33.897
12058,8,704,충남,6,6,0,5726,2020-11-16 09:00:00.000,2021-09-16 10:11:33.897
12059,1,179,전북,1,1,0,5725,2020-11-16 09:00:00.000,2021-09-16 10:11:33.897
12060,2,248,전남,10,10,0,5724,2020-11-16 09:00:00.000,2021-09-16 10:11:33.897
12061,57,1612,경북,14,13,1,5723,2020-11-16 09:00:00.000,2021-09-16 10:11:33.897
12062,0,388,경남,4,4,0,5722,2020-11-16 09:00:00.000,2021-09-16 10:11:33.897
12063,0,63,제주,1,1,0,5721,2020-11-16 09:00:00.000,2021-09-16 10:11:33.897
12064,0,1959,검역,23,0,23,5720,2020-11-16 09:00:00.000,2021-09-16 10:11:33.897
12065,493,28544,합계,208,176,32,5719,2020-11-15 09:00:00.000,2021-09-16 10:11:33.897
12066,81,6733,서울,85,81,4,5718,2020-11-15 09:00:00.000,2021-09-16 10:11:33.897
12067,15,612,부산,0,0,0,5717,2020-11-15 09:00:00.000,2021-09-16 10:11:33.897
12068,196,7203,대구,1,0,1,5716,2020-11-15 09:00:00.000,2021-09-16 10:11:33.897
12069,11,1080,인천,2,2,0,5715,2020-11-15 09:00:00.000,2021-09-16 10:11:33.897
12070,3,556,광주,9,7,2,5714,2020-11-15 09:00:00.000,2021-09-16 10:11:33.897
12071,6,450,대전,0,0,0,5713,2020-11-15 09:00:00.000,2021-09-16 10:11:33.897
12072,2,167,울산,0,0,0,5712,2020-11-15 09:00:00.000,2021-09-16 10:11:33.897
12073,0,84,세종,0,0,0,5711,2020-11-15 09:00:00.000,2021-09-16 10:11:33.897
12074,104,5956,경기,45,41,4,5710,2020-11-15 09:00:00.000,2021-09-16 10:11:33.897
12075,4,394,강원,19,19,0,5709,2020-11-15 09:00:00.000,2021-09-16 10:11:33.897
12076,3,215,충북,8,8,0,5708,2020-11-15 09:00:00.000,2021-09-16 10:11:33.897
12077,8,698,충남,5,5,0,5707,2020-11-15 09:00:00.000,2021-09-16 10:11:33.897
12078,1,178,전북,2,0,2,5706,2020-11-15 09:00:00.000,2021-09-16 10:11:33.897
12079,2,238,전남,9,8,1,5705,2020-11-15 09:00:00.000,2021-09-16 10:11:33.897
12080,57,1598,경북,2,2,0,5704,2020-11-15 09:00:00.000,2021-09-16 10:11:33.897
12081,0,384,경남,3,3,0,5703,2020-11-15 09:00:00.000,2021-09-16 10:11:33.897
12082,0,62,제주,0,0,0,5702,2020-11-15 09:00:00.000,2021-09-16 10:11:33.897
12083,0,1936,검역,18,0,18,5701,2020-11-15 09:00:00.000,2021-09-16 10:11:33.897
12084,492,28336,합계,205,166,39,5700,2020-11-14 09:00:00.000,2021-09-16 10:11:33.897
12085,80,6648,서울,69,63,6,5699,2020-11-14 09:00:00.000,2021-09-16 10:11:33.897
12086,15,612,부산,4,1,3,5698,2020-11-14 09:00:00.000,2021-09-16 10:11:33.897
12087,196,7202,대구,0,0,0,5697,2020-11-14 09:00:00.000,2021-09-16 10:11:33.897
12088,11,1078,인천,1,0,1,5696,2020-11-14 09:00:00.000,2021-09-16 10:11:33.897
12089,3,547,광주,8,7,1,5695,2020-11-14 09:00:00.000,2021-09-16 10:11:33.897
12090,6,450,대전,2,2,0,5694,2020-11-14 09:00:00.000,2021-09-16 10:11:33.897
12091,2,167,울산,0,0,0,5693,2020-11-14 09:00:00.000,2021-09-16 10:11:33.897
12092,0,84,세종,1,1,0,5692,2020-11-14 09:00:00.000,2021-09-16 10:11:33.897
12093,104,5911,경기,49,46,3,5691,2020-11-14 09:00:00.000,2021-09-16 10:11:33.897
12094,4,375,강원,18,18,0,5690,2020-11-14 09:00:00.000,2021-09-16 10:11:33.897
12095,3,207,충북,0,0,0,5689,2020-11-14 09:00:00.000,2021-09-16 10:11:33.897
12096,8,693,충남,11,11,0,5688,2020-11-14 09:00:00.000,2021-09-16 10:11:33.897
12097,1,176,전북,4,1,3,5687,2020-11-14 09:00:00.000,2021-09-16 10:11:33.897
12098,2,229,전남,13,13,0,5686,2020-11-14 09:00:00.000,2021-09-16 10:11:33.897
12099,57,1596,경북,0,0,0,5685,2020-11-14 09:00:00.000,2021-09-16 10:11:33.897
12100,0,381,경남,4,3,1,5684,2020-11-14 09:00:00.000,2021-09-16 10:11:33.897
12101,0,62,제주,0,0,0,5683,2020-11-14 09:00:00.000,2021-09-16 10:11:33.897
12102,0,1918,검역,21,0,21,5682,2020-11-14 09:00:00.000,2021-09-16 10:11:33.897
12103,488,28131,합계,191,162,29,5681,2020-11-13 09:00:00.000,2021-09-16 10:11:33.897
12104,79,6579,서울,74,74,0,5680,2020-11-13 09:00:00.000,2021-09-16 10:11:33.897
12105,15,608,부산,0,0,0,5679,2020-11-13 09:00:00.000,2021-09-16 10:11:33.897
12106,196,7202,대구,1,1,0,5678,2020-11-13 09:00:00.000,2021-09-16 10:11:33.897
12107,11,1077,인천,4,3,1,5677,2020-11-13 09:00:00.000,2021-09-16 10:11:33.897
12108,3,539,광주,5,5,0,5676,2020-11-13 09:00:00.000,2021-09-16 10:11:33.897
12109,6,448,대전,0,0,0,5675,2020-11-13 09:00:00.000,2021-09-16 10:11:33.897
12110,2,167,울산,0,0,0,5674,2020-11-13 09:00:00.000,2021-09-16 10:11:33.897
12111,0,83,세종,1,1,0,5673,2020-11-13 09:00:00.000,2021-09-16 10:11:33.897
12112,102,5862,경기,47,36,11,5672,2020-11-13 09:00:00.000,2021-09-16 10:11:33.897
12113,3,357,강원,23,23,0,5671,2020-11-13 09:00:00.000,2021-09-16 10:11:33.897
12114,3,207,충북,1,0,1,5670,2020-11-13 09:00:00.000,2021-09-16 10:11:33.897
12115,8,682,충남,8,7,1,5669,2020-11-13 09:00:00.000,2021-09-16 10:11:33.897
12116,1,172,전북,0,0,0,5668,2020-11-13 09:00:00.000,2021-09-16 10:11:33.897
12117,2,216,전남,9,9,0,5667,2020-11-13 09:00:00.000,2021-09-16 10:11:33.897
12118,57,1596,경북,0,0,0,5666,2020-11-13 09:00:00.000,2021-09-16 10:11:33.897
12119,0,377,경남,3,2,1,5665,2020-11-13 09:00:00.000,2021-09-16 10:11:33.897
12120,0,62,제주,1,1,0,5664,2020-11-13 09:00:00.000,2021-09-16 10:11:33.897
12121,0,1897,검역,14,0,14,5663,2020-11-13 09:00:00.000,2021-09-16 10:11:33.897
12122,487,27940,합계,143,128,15,5662,2020-11-12 09:00:00.000,2021-09-16 10:11:33.897
12123,79,6505,서울,53,52,1,5661,2020-11-12 09:00:00.000,2021-09-16 10:11:33.897
12124,15,608,부산,2,2,0,5660,2020-11-12 09:00:00.000,2021-09-16 10:11:33.897
12125,196,7201,대구,3,2,1,5659,2020-11-12 09:00:00.000,2021-09-16 10:11:33.897
12126,11,1073,인천,2,2,0,5658,2020-11-12 09:00:00.000,2021-09-16 10:11:33.897
12127,3,534,광주,6,6,0,5657,2020-11-12 09:00:00.000,2021-09-16 10:11:33.897
12128,6,448,대전,2,2,0,5656,2020-11-12 09:00:00.000,2021-09-16 10:11:33.897
12129,2,167,울산,1,0,1,5655,2020-11-12 09:00:00.000,2021-09-16 10:11:33.897
12130,0,82,세종,0,0,0,5654,2020-11-12 09:00:00.000,2021-09-16 10:11:33.897
12131,101,5815,경기,35,34,1,5653,2020-11-12 09:00:00.000,2021-09-16 10:11:33.897
12132,3,334,강원,6,6,0,5652,2020-11-12 09:00:00.000,2021-09-16 10:11:33.897
12133,3,206,충북,1,0,1,5651,2020-11-12 09:00:00.000,2021-09-16 10:11:33.897
12134,8,674,충남,9,9,0,5650,2020-11-12 09:00:00.000,2021-09-16 10:11:33.897
12135,1,172,전북,0,0,0,5649,2020-11-12 09:00:00.000,2021-09-16 10:11:33.897
12136,2,207,전남,8,8,0,5648,2020-11-12 09:00:00.000,2021-09-16 10:11:33.897
12137,57,1596,경북,1,1,0,5647,2020-11-12 09:00:00.000,2021-09-16 10:11:33.897
12138,0,374,경남,4,3,1,5646,2020-11-12 09:00:00.000,2021-09-16 10:11:33.897
12139,0,61,제주,1,1,0,5645,2020-11-12 09:00:00.000,2021-09-16 10:11:33.897
12140,0,1883,검역,9,0,9,5644,2020-11-12 09:00:00.000,2021-09-16 10:11:33.897
12141,487,27797,합계,145,113,32,5643,2020-11-11 09:00:00.000,2021-09-16 10:11:33.897
12142,79,6452,서울,45,39,6,5642,2020-11-11 09:00:00.000,2021-09-16 10:11:33.897
12143,15,606,부산,3,3,0,5641,2020-11-11 09:00:00.000,2021-09-16 10:11:33.897
12144,196,7198,대구,0,0,0,5640,2020-11-11 09:00:00.000,2021-09-16 10:11:33.897
12145,11,1071,인천,1,0,1,5639,2020-11-11 09:00:00.000,2021-09-16 10:11:33.897
12146,3,528,광주,4,2,2,5638,2020-11-11 09:00:00.000,2021-09-16 10:11:33.897
12147,6,446,대전,1,1,0,5637,2020-11-11 09:00:00.000,2021-09-16 10:11:33.897
12148,2,166,울산,0,0,0,5636,2020-11-11 09:00:00.000,2021-09-16 10:11:33.897
12149,0,82,세종,0,0,0,5635,2020-11-11 09:00:00.000,2021-09-16 10:11:33.897
12150,101,5780,경기,53,42,11,5634,2020-11-11 09:00:00.000,2021-09-16 10:11:33.897
12151,3,328,강원,9,8,1,5633,2020-11-11 09:00:00.000,2021-09-16 10:11:33.897
12152,3,205,충북,2,1,1,5632,2020-11-11 09:00:00.000,2021-09-16 10:11:33.897
12153,8,665,충남,7,6,1,5631,2020-11-11 09:00:00.000,2021-09-16 10:11:33.897
12154,1,172,전북,1,1,0,5630,2020-11-11 09:00:00.000,2021-09-16 10:11:33.897
12155,2,199,전남,1,0,1,5629,2020-11-11 09:00:00.000,2021-09-16 10:11:33.897
12156,57,1595,경북,0,0,0,5628,2020-11-11 09:00:00.000,2021-09-16 10:11:33.897
12157,0,370,경남,11,10,1,5627,2020-11-11 09:00:00.000,2021-09-16 10:11:33.897
12158,0,60,제주,0,0,0,5626,2020-11-11 09:00:00.000,2021-09-16 10:11:33.897
12159,0,1874,검역,7,0,7,5625,2020-11-11 09:00:00.000,2021-09-16 10:11:33.897
12160,485,27652,합계,100,71,29,5624,2020-11-10 09:00:00.000,2021-09-16 10:11:33.897
12161,79,6407,서울,35,32,3,5623,2020-11-10 09:00:00.000,2021-09-16 10:11:33.897
12162,15,603,부산,1,1,0,5622,2020-11-10 09:00:00.000,2021-09-16 10:11:33.897
12163,196,7198,대구,1,1,0,5621,2020-11-10 09:00:00.000,2021-09-16 10:11:33.897
12164,11,1070,인천,3,3,0,5620,2020-11-10 09:00:00.000,2021-09-16 10:11:33.897
12165,3,524,광주,5,4,1,5619,2020-11-10 09:00:00.000,2021-09-16 10:11:33.897
12166,6,445,대전,0,0,0,5618,2020-11-10 09:00:00.000,2021-09-16 10:11:33.897
12167,2,166,울산,0,0,0,5617,2020-11-10 09:00:00.000,2021-09-16 10:11:33.897
12168,0,82,세종,0,0,0,5616,2020-11-10 09:00:00.000,2021-09-16 10:11:33.897
12169,99,5727,경기,33,18,15,5615,2020-11-10 09:00:00.000,2021-09-16 10:11:33.897
12170,3,319,강원,3,3,0,5614,2020-11-10 09:00:00.000,2021-09-16 10:11:33.897
12171,3,203,충북,2,1,1,5613,2020-11-10 09:00:00.000,2021-09-16 10:11:33.897
12172,8,658,충남,4,4,0,5612,2020-11-10 09:00:00.000,2021-09-16 10:11:33.897
12173,1,171,전북,0,0,0,5611,2020-11-10 09:00:00.000,2021-09-16 10:11:33.897
12174,2,198,전남,2,2,0,5610,2020-11-10 09:00:00.000,2021-09-16 10:11:33.897
12175,57,1595,경북,1,0,1,5609,2020-11-10 09:00:00.000,2021-09-16 10:11:33.897
12176,0,359,경남,2,2,0,5608,2020-11-10 09:00:00.000,2021-09-16 10:11:33.897
12177,0,60,제주,0,0,0,5607,2020-11-10 09:00:00.000,2021-09-16 10:11:33.897
12178,0,1867,검역,8,0,8,5606,2020-11-10 09:00:00.000,2021-09-16 10:11:33.897
12179,480,27552,합계,126,99,27,5605,2020-11-09 09:00:00.000,2021-09-16 10:11:33.897
12180,78,6372,서울,46,39,7,5604,2020-11-09 09:00:00.000,2021-09-16 10:11:33.897
12181,14,602,부산,2,0,2,5603,2020-11-09 09:00:00.000,2021-09-16 10:11:33.897
12182,196,7197,대구,6,6,0,5602,2020-11-09 09:00:00.000,2021-09-16 10:11:33.897
12183,11,1067,인천,2,1,1,5601,2020-11-09 09:00:00.000,2021-09-16 10:11:33.897
12184,3,519,광주,1,0,1,5600,2020-11-09 09:00:00.000,2021-09-16 10:11:33.897
12185,6,445,대전,0,0,0,5599,2020-11-09 09:00:00.000,2021-09-16 10:11:33.897
12186,2,166,울산,0,0,0,5598,2020-11-09 09:00:00.000,2021-09-16 10:11:33.897
12187,0,82,세종,0,0,0,5597,2020-11-09 09:00:00.000,2021-09-16 10:11:33.897
12188,96,5694,경기,22,21,1,5596,2020-11-09 09:00:00.000,2021-09-16 10:11:33.897
12189,3,316,강원,11,11,0,5595,2020-11-09 09:00:00.000,2021-09-16 10:11:33.897
12190,3,201,충북,4,2,2,5594,2020-11-09 09:00:00.000,2021-09-16 10:11:33.897
12191,8,654,충남,10,10,0,5593,2020-11-09 09:00:00.000,2021-09-16 10:11:33.897
12192,1,171,전북,4,3,1,5592,2020-11-09 09:00:00.000,2021-09-16 10:11:33.897
12193,2,196,전남,2,2,0,5591,2020-11-09 09:00:00.000,2021-09-16 10:11:33.897
12194,57,1594,경북,1,0,1,5590,2020-11-09 09:00:00.000,2021-09-16 10:11:33.897
12195,0,357,경남,4,4,0,5589,2020-11-09 09:00:00.000,2021-09-16 10:11:33.897
12196,0,60,제주,0,0,0,5588,2020-11-09 09:00:00.000,2021-09-16 10:11:33.897
12197,0,1859,검역,11,0,11,5587,2020-11-09 09:00:00.000,2021-09-16 10:11:33.897
12198,478,27426,합계,143,118,25,5586,2020-11-08 09:00:00.000,2021-09-16 10:11:33.897
12199,78,6326,서울,54,54,0,5585,2020-11-08 09:00:00.000,2021-09-16 10:11:33.897
12200,13,600,부산,0,0,0,5584,2020-11-08 09:00:00.000,2021-09-16 10:11:33.897
12201,196,7191,대구,7,7,0,5583,2020-11-08 09:00:00.000,2021-09-16 10:11:33.897
12202,11,1065,인천,3,2,1,5582,2020-11-08 09:00:00.000,2021-09-16 10:11:33.897
12203,3,518,광주,2,2,0,5581,2020-11-08 09:00:00.000,2021-09-16 10:11:33.897
12204,6,445,대전,1,1,0,5580,2020-11-08 09:00:00.000,2021-09-16 10:11:33.897
12205,2,166,울산,1,0,1,5579,2020-11-08 09:00:00.000,2021-09-16 10:11:33.897
12206,0,82,세종,0,0,0,5578,2020-11-08 09:00:00.000,2021-09-16 10:11:33.897
12207,95,5672,경기,25,23,2,5577,2020-11-08 09:00:00.000,2021-09-16 10:11:33.897
12208,3,305,강원,9,9,0,5576,2020-11-08 09:00:00.000,2021-09-16 10:11:33.897
12209,3,197,충북,2,2,0,5575,2020-11-08 09:00:00.000,2021-09-16 10:11:33.897
12210,8,644,충남,9,8,1,5574,2020-11-08 09:00:00.000,2021-09-16 10:11:33.897
12211,1,167,전북,0,0,0,5573,2020-11-08 09:00:00.000,2021-09-16 10:11:33.897
12212,2,194,전남,4,3,1,5572,2020-11-08 09:00:00.000,2021-09-16 10:11:33.897
12213,57,1593,경북,2,2,0,5571,2020-11-08 09:00:00.000,2021-09-16 10:11:33.897
12214,0,353,경남,10,5,5,5570,2020-11-08 09:00:00.000,2021-09-16 10:11:33.897
12215,0,60,제주,0,0,0,5569,2020-11-08 09:00:00.000,2021-09-16 10:11:33.897
12216,0,1848,검역,14,0,14,5568,2020-11-08 09:00:00.000,2021-09-16 10:11:33.897
12217,477,27283,합계,89,72,17,5567,2020-11-07 09:00:00.000,2021-09-16 10:11:33.897
12218,78,6272,서울,37,34,3,5566,2020-11-07 09:00:00.000,2021-09-16 10:11:33.897
12219,13,600,부산,2,2,0,5565,2020-11-07 09:00:00.000,2021-09-16 10:11:33.897
12220,196,7184,대구,1,1,0,5564,2020-11-07 09:00:00.000,2021-09-16 10:11:33.897
12221,11,1062,인천,1,1,0,5563,2020-11-07 09:00:00.000,2021-09-16 10:11:33.897
12222,3,516,광주,0,0,0,5562,2020-11-07 09:00:00.000,2021-09-16 10:11:33.897
12223,6,444,대전,1,1,0,5561,2020-11-07 09:00:00.000,2021-09-16 10:11:33.897
12224,2,165,울산,0,0,0,5560,2020-11-07 09:00:00.000,2021-09-16 10:11:33.897
12225,0,82,세종,0,0,0,5559,2020-11-07 09:00:00.000,2021-09-16 10:11:33.897
12226,94,5647,경기,21,16,5,5558,2020-11-07 09:00:00.000,2021-09-16 10:11:33.897
12227,3,296,강원,4,4,0,5557,2020-11-07 09:00:00.000,2021-09-16 10:11:33.897
12228,3,195,충북,0,0,0,5556,2020-11-07 09:00:00.000,2021-09-16 10:11:33.897
12229,8,635,충남,9,8,1,5555,2020-11-07 09:00:00.000,2021-09-16 10:11:33.897
12230,1,167,전북,0,0,0,5554,2020-11-07 09:00:00.000,2021-09-16 10:11:33.897
12231,2,190,전남,0,0,0,5553,2020-11-07 09:00:00.000,2021-09-16 10:11:33.897
12232,57,1591,경북,0,0,0,5552,2020-11-07 09:00:00.000,2021-09-16 10:11:33.897
12233,0,343,경남,5,5,0,5551,2020-11-07 09:00:00.000,2021-09-16 10:11:33.897
12234,0,60,제주,0,0,0,5550,2020-11-07 09:00:00.000,2021-09-16 10:11:33.897
12235,0,1834,검역,8,0,8,5549,2020-11-07 09:00:00.000,2021-09-16 10:11:33.897
12236,476,27194,합계,145,117,28,5548,2020-11-06 09:00:00.000,2021-09-16 10:11:33.897
12237,78,6235,서울,40,38,2,5547,2020-11-06 09:00:00.000,2021-09-16 10:11:33.897
12238,13,598,부산,0,0,0,5546,2020-11-06 09:00:00.000,2021-09-16 10:11:33.897
12239,196,7183,대구,0,0,0,5545,2020-11-06 09:00:00.000,2021-09-16 10:11:33.897
12240,11,1061,인천,0,0,0,5544,2020-11-06 09:00:00.000,2021-09-16 10:11:33.897
12241,3,516,광주,0,0,0,5543,2020-11-06 09:00:00.000,2021-09-16 10:11:33.897
12242,6,443,대전,0,0,0,5542,2020-11-06 09:00:00.000,2021-09-16 10:11:33.897
12243,2,165,울산,0,0,0,5541,2020-11-06 09:00:00.000,2021-09-16 10:11:33.897
12244,0,82,세종,0,0,0,5540,2020-11-06 09:00:00.000,2021-09-16 10:11:33.897
12245,93,5626,경기,47,34,13,5539,2020-11-06 09:00:00.000,2021-09-16 10:11:33.897
12246,3,292,강원,7,7,0,5538,2020-11-06 09:00:00.000,2021-09-16 10:11:33.897
12247,3,195,충북,0,0,0,5537,2020-11-06 09:00:00.000,2021-09-16 10:11:33.897
12248,8,626,충남,25,25,0,5536,2020-11-06 09:00:00.000,2021-09-16 10:11:33.897
12249,1,167,전북,1,0,1,5535,2020-11-06 09:00:00.000,2021-09-16 10:11:33.897
12250,2,190,전남,0,0,0,5534,2020-11-06 09:00:00.000,2021-09-16 10:11:33.897
12251,57,1591,경북,1,0,1,5533,2020-11-06 09:00:00.000,2021-09-16 10:11:33.897
12252,0,338,경남,13,13,0,5532,2020-11-06 09:00:00.000,2021-09-16 10:11:33.897
12253,0,60,제주,0,0,0,5531,2020-11-06 09:00:00.000,2021-09-16 10:11:33.897
12254,0,1826,검역,11,0,11,5530,2020-11-06 09:00:00.000,2021-09-16 10:11:33.897
12255,475,27049,합계,125,108,17,5529,2020-11-05 09:00:00.000,2021-09-16 10:11:33.897
12256,78,6195,서울,50,46,4,5528,2020-11-05 09:00:00.000,2021-09-16 10:11:33.897
12257,13,598,부산,4,3,1,5527,2020-11-05 09:00:00.000,2021-09-16 10:11:33.897
12258,196,7183,대구,2,2,0,5526,2020-11-05 09:00:00.000,2021-09-16 10:11:33.897
12259,11,1061,인천,5,3,2,5525,2020-11-05 09:00:00.000,2021-09-16 10:11:33.897
12260,3,516,광주,0,0,0,5524,2020-11-05 09:00:00.000,2021-09-16 10:11:33.897
12261,6,443,대전,0,0,0,5523,2020-11-05 09:00:00.000,2021-09-16 10:11:33.897
12262,2,165,울산,0,0,0,5522,2020-11-05 09:00:00.000,2021-09-16 10:11:33.897
12263,0,82,세종,0,0,0,5521,2020-11-05 09:00:00.000,2021-09-16 10:11:33.897
12264,92,5579,경기,27,23,4,5520,2020-11-05 09:00:00.000,2021-09-16 10:11:33.897
12265,3,285,강원,1,1,0,5519,2020-11-05 09:00:00.000,2021-09-16 10:11:33.897
12266,3,195,충북,2,2,0,5518,2020-11-05 09:00:00.000,2021-09-16 10:11:33.897
12267,8,601,충남,23,23,0,5517,2020-11-05 09:00:00.000,2021-09-16 10:11:33.897
12268,1,166,전북,0,0,0,5516,2020-11-05 09:00:00.000,2021-09-16 10:11:33.897
12269,2,190,전남,0,0,0,5515,2020-11-05 09:00:00.000,2021-09-16 10:11:33.897
12270,57,1590,경북,0,0,0,5514,2020-11-05 09:00:00.000,2021-09-16 10:11:33.897
12271,0,325,경남,5,5,0,5513,2020-11-05 09:00:00.000,2021-09-16 10:11:33.897
12272,0,60,제주,0,0,0,5512,2020-11-05 09:00:00.000,2021-09-16 10:11:33.897
12273,0,1815,검역,6,0,6,5511,2020-11-05 09:00:00.000,2021-09-16 10:11:33.897
12274,474,26924,합계,117,98,19,5510,2020-11-04 09:00:00.000,2021-09-16 10:11:33.897
12275,78,6145,서울,42,39,3,5509,2020-11-04 09:00:00.000,2021-09-16 10:11:33.897
12276,13,594,부산,1,1,0,5508,2020-11-04 09:00:00.000,2021-09-16 10:11:33.897
12277,196,7181,대구,2,1,1,5507,2020-11-04 09:00:00.000,2021-09-16 10:11:33.897
12278,11,1056,인천,4,4,0,5506,2020-11-04 09:00:00.000,2021-09-16 10:11:33.897
12279,3,516,광주,0,0,0,5505,2020-11-04 09:00:00.000,2021-09-16 10:11:33.897
12280,6,443,대전,1,1,0,5504,2020-11-04 09:00:00.000,2021-09-16 10:11:33.897
12281,2,165,울산,1,0,1,5503,2020-11-04 09:00:00.000,2021-09-16 10:11:33.897
12282,0,82,세종,0,0,0,5502,2020-11-04 09:00:00.000,2021-09-16 10:11:33.897
12283,91,5552,경기,43,41,2,5501,2020-11-04 09:00:00.000,2021-09-16 10:11:33.897
12284,3,284,강원,0,0,0,5500,2020-11-04 09:00:00.000,2021-09-16 10:11:33.897
12285,3,193,충북,0,0,0,5499,2020-11-04 09:00:00.000,2021-09-16 10:11:33.897
12286,8,578,충남,10,10,0,5498,2020-11-04 09:00:00.000,2021-09-16 10:11:33.897
12287,1,166,전북,0,0,0,5497,2020-11-04 09:00:00.000,2021-09-16 10:11:33.897
12288,2,190,전남,0,0,0,5496,2020-11-04 09:00:00.000,2021-09-16 10:11:33.897
12289,57,1590,경북,2,0,2,5495,2020-11-04 09:00:00.000,2021-09-16 10:11:33.897
12290,0,320,경남,0,0,0,5494,2020-11-04 09:00:00.000,2021-09-16 10:11:33.897
12291,0,60,제주,1,1,0,5493,2020-11-04 09:00:00.000,2021-09-16 10:11:33.897
12292,0,1809,검역,10,0,10,5492,2020-11-04 09:00:00.000,2021-09-16 10:11:33.897
12293,472,26807,합계,75,46,29,5491,2020-11-03 09:00:00.000,2021-09-16 10:11:33.897
12294,78,6103,서울,22,21,1,5490,2020-11-03 09:00:00.000,2021-09-16 10:11:33.897
12295,11,593,부산,1,0,1,5489,2020-11-03 09:00:00.000,2021-09-16 10:11:33.897
12296,196,7179,대구,0,0,0,5488,2020-11-03 09:00:00.000,2021-09-16 10:11:33.897
12297,11,1052,인천,1,0,1,5487,2020-11-03 09:00:00.000,2021-09-16 10:11:33.897
12298,3,516,광주,2,2,0,5486,2020-11-03 09:00:00.000,2021-09-16 10:11:33.897
12299,6,442,대전,0,0,0,5485,2020-11-03 09:00:00.000,2021-09-16 10:11:33.897
12300,2,164,울산,0,0,0,5484,2020-11-03 09:00:00.000,2021-09-16 10:11:33.897
12301,0,82,세종,0,0,0,5483,2020-11-03 09:00:00.000,2021-09-16 10:11:33.897
12302,91,5509,경기,27,15,12,5482,2020-11-03 09:00:00.000,2021-09-16 10:11:33.897
12303,3,284,강원,1,1,0,5481,2020-11-03 09:00:00.000,2021-09-16 10:11:33.897
12304,3,193,충북,1,1,0,5480,2020-11-03 09:00:00.000,2021-09-16 10:11:33.897
12305,8,568,충남,7,6,1,5479,2020-11-03 09:00:00.000,2021-09-16 10:11:33.897
12306,1,166,전북,0,0,0,5478,2020-11-03 09:00:00.000,2021-09-16 10:11:33.897
12307,2,190,전남,0,0,0,5477,2020-11-03 09:00:00.000,2021-09-16 10:11:33.897
12308,57,1588,경북,0,0,0,5476,2020-11-03 09:00:00.000,2021-09-16 10:11:33.897
12309,0,320,경남,1,0,1,5475,2020-11-03 09:00:00.000,2021-09-16 10:11:33.897
12310,0,59,제주,0,0,0,5474,2020-11-03 09:00:00.000,2021-09-16 10:11:33.897
12311,0,1799,검역,12,0,12,5473,2020-11-03 09:00:00.000,2021-09-16 10:11:33.897
12312,468,26732,합계,97,79,18,5472,2020-11-02 09:00:00.000,2021-09-16 10:11:33.897
12313,78,6081,서울,25,20,5,5471,2020-11-02 09:00:00.000,2021-09-16 10:11:33.897
12314,10,592,부산,0,0,0,5470,2020-11-02 09:00:00.000,2021-09-16 10:11:33.897
12315,196,7179,대구,3,3,0,5469,2020-11-02 09:00:00.000,2021-09-16 10:11:33.897
12316,11,1051,인천,2,2,0,5468,2020-11-02 09:00:00.000,2021-09-16 10:11:33.897
12317,3,514,광주,0,0,0,5467,2020-11-02 09:00:00.000,2021-09-16 10:11:33.897
12318,6,442,대전,0,0,0,5466,2020-11-02 09:00:00.000,2021-09-16 10:11:33.897
12319,2,164,울산,1,0,1,5465,2020-11-02 09:00:00.000,2021-09-16 10:11:33.897
12320,0,82,세종,0,0,0,5464,2020-11-02 09:00:00.000,2021-09-16 10:11:33.897
12321,90,5482,경기,41,40,1,5463,2020-11-02 09:00:00.000,2021-09-16 10:11:33.897
12322,3,283,강원,1,0,1,5462,2020-11-02 09:00:00.000,2021-09-16 10:11:33.897
12323,2,192,충북,2,1,1,5461,2020-11-02 09:00:00.000,2021-09-16 10:11:33.897
12324,8,561,충남,11,11,0,5460,2020-11-02 09:00:00.000,2021-09-16 10:11:33.897
12325,0,166,전북,0,0,0,5459,2020-11-02 09:00:00.000,2021-09-16 10:11:33.897
12326,2,190,전남,2,2,0,5458,2020-11-02 09:00:00.000,2021-09-16 10:11:33.897
12327,57,1588,경북,1,0,1,5457,2020-11-02 09:00:00.000,2021-09-16 10:11:33.897
12328,0,319,경남,1,0,1,5456,2020-11-02 09:00:00.000,2021-09-16 10:11:33.897
12329,0,59,제주,0,0,0,5455,2020-11-02 09:00:00.000,2021-09-16 10:11:33.897
12330,0,1787,검역,7,0,7,5454,2020-11-02 09:00:00.000,2021-09-16 10:11:33.897
12331,466,26635,합계,124,101,23,5453,2020-11-01 09:00:00.000,2021-09-16 10:11:33.897
12332,78,6056,서울,45,45,0,5452,2020-11-01 09:00:00.000,2021-09-16 10:11:33.897
12333,9,592,부산,0,0,0,5451,2020-11-01 09:00:00.000,2021-09-16 10:11:33.897
12334,196,7176,대구,2,2,0,5450,2020-11-01 09:00:00.000,2021-09-16 10:11:33.897
12335,11,1049,인천,4,0,4,5449,2020-11-01 09:00:00.000,2021-09-16 10:11:33.897
12336,3,514,광주,3,0,3,5448,2020-11-01 09:00:00.000,2021-09-16 10:11:33.897
12337,6,442,대전,0,0,0,5447,2020-11-01 09:00:00.000,2021-09-16 10:11:33.897
12338,2,163,울산,0,0,0,5446,2020-11-01 09:00:00.000,2021-09-16 10:11:33.897
12339,0,82,세종,0,0,0,5445,2020-11-01 09:00:00.000,2021-09-16 10:11:33.897
12340,89,5441,경기,38,36,2,5444,2020-11-01 09:00:00.000,2021-09-16 10:11:33.897
12341,3,282,강원,3,3,0,5443,2020-11-01 09:00:00.000,2021-09-16 10:11:33.897
12342,2,190,충북,1,1,0,5442,2020-11-01 09:00:00.000,2021-09-16 10:11:33.897
12343,8,550,충남,9,9,0,5441,2020-11-01 09:00:00.000,2021-09-16 10:11:33.897
12344,0,166,전북,0,0,0,5440,2020-11-01 09:00:00.000,2021-09-16 10:11:33.897
12345,2,188,전남,3,3,0,5439,2020-11-01 09:00:00.000,2021-09-16 10:11:33.897
12346,57,1587,경북,0,0,0,5438,2020-11-01 09:00:00.000,2021-09-16 10:11:33.897
12347,0,318,경남,2,2,0,5437,2020-11-01 09:00:00.000,2021-09-16 10:11:33.897
12348,0,59,제주,0,0,0,5436,2020-11-01 09:00:00.000,2021-09-16 10:11:33.897
12349,0,1780,검역,14,0,14,5435,2020-11-01 09:00:00.000,2021-09-16 10:11:33.897
12350,464,26511,합계,127,96,31,5434,2020-10-31 09:00:00.000,2021-09-16 10:11:33.897
12351,78,6011,서울,52,51,1,5433,2020-10-31 09:00:00.000,2021-09-16 10:11:33.897
12352,8,592,부산,2,2,0,5432,2020-10-31 09:00:00.000,2021-09-16 10:11:33.897
12353,196,7174,대구,9,9,0,5431,2020-10-31 09:00:00.000,2021-09-16 10:11:33.897
12354,10,1045,인천,3,3,0,5430,2020-10-31 09:00:00.000,2021-09-16 10:11:33.897
12355,3,511,광주,0,0,0,5429,2020-10-31 09:00:00.000,2021-09-16 10:11:33.897
12356,6,442,대전,0,0,0,5428,2020-10-31 09:00:00.000,2021-09-16 10:11:33.897
12357,2,163,울산,0,0,0,5427,2020-10-31 09:00:00.000,2021-09-16 10:11:33.897
12358,0,82,세종,3,3,0,5426,2020-10-31 09:00:00.000,2021-09-16 10:11:33.897
12359,89,5403,경기,27,23,4,5425,2020-10-31 09:00:00.000,2021-09-16 10:11:33.897
12360,3,279,강원,0,0,0,5424,2020-10-31 09:00:00.000,2021-09-16 10:11:33.897
12361,2,189,충북,0,0,0,5423,2020-10-31 09:00:00.000,2021-09-16 10:11:33.897
12362,8,541,충남,5,4,1,5422,2020-10-31 09:00:00.000,2021-09-16 10:11:33.897
12363,0,166,전북,0,0,0,5421,2020-10-31 09:00:00.000,2021-09-16 10:11:33.897
12364,2,185,전남,0,0,0,5420,2020-10-31 09:00:00.000,2021-09-16 10:11:33.897
12365,57,1587,경북,0,0,0,5419,2020-10-31 09:00:00.000,2021-09-16 10:11:33.897
12366,0,316,경남,1,1,0,5418,2020-10-31 09:00:00.000,2021-09-16 10:11:33.897
12367,0,59,제주,0,0,0,5417,2020-10-31 09:00:00.000,2021-09-16 10:11:33.897
12368,0,1766,검역,25,0,25,5416,2020-10-31 09:00:00.000,2021-09-16 10:11:33.897
12369,463,26384,합계,113,93,20,5415,2020-10-30 09:00:00.000,2021-09-16 10:11:33.897
12370,78,5959,서울,47,47,0,5414,2020-10-30 09:00:00.000,2021-09-16 10:11:33.897
12371,7,590,부산,0,0,0,5413,2020-10-30 09:00:00.000,2021-09-16 10:11:33.897
12372,196,7165,대구,10,10,0,5412,2020-10-30 09:00:00.000,2021-09-16 10:11:33.897
12373,10,1042,인천,3,2,1,5411,2020-10-30 09:00:00.000,2021-09-16 10:11:33.897
12374,3,511,광주,0,0,0,5410,2020-10-30 09:00:00.000,2021-09-16 10:11:33.897
12375,6,442,대전,0,0,0,5409,2020-10-30 09:00:00.000,2021-09-16 10:11:33.897
12376,2,163,울산,2,0,2,5408,2020-10-30 09:00:00.000,2021-09-16 10:11:33.897
12377,0,79,세종,0,0,0,5407,2020-10-30 09:00:00.000,2021-09-16 10:11:33.897
12378,89,5376,경기,32,23,9,5406,2020-10-30 09:00:00.000,2021-09-16 10:11:33.897
12379,3,279,강원,6,6,0,5405,2020-10-30 09:00:00.000,2021-09-16 10:11:33.897
12380,2,189,충북,2,0,2,5404,2020-10-30 09:00:00.000,2021-09-16 10:11:33.897
12381,8,536,충남,3,3,0,5403,2020-10-30 09:00:00.000,2021-09-16 10:11:33.897
12382,0,166,전북,2,1,1,5402,2020-10-30 09:00:00.000,2021-09-16 10:11:33.897
12383,2,185,전남,1,1,0,5401,2020-10-30 09:00:00.000,2021-09-16 10:11:33.897
12384,57,1587,경북,0,0,0,5400,2020-10-30 09:00:00.000,2021-09-16 10:11:33.897
12385,0,315,경남,1,0,1,5399,2020-10-30 09:00:00.000,2021-09-16 10:11:33.897
12386,0,59,제주,0,0,0,5398,2020-10-30 09:00:00.000,2021-09-16 10:11:33.897
12387,0,1741,검역,4,0,4,5397,2020-10-30 09:00:00.000,2021-09-16 10:11:33.897
12388,462,26271,합계,125,107,18,5396,2020-10-29 09:00:00.000,2021-09-16 10:11:33.897
12389,78,5912,서울,36,36,0,5395,2020-10-29 09:00:00.000,2021-09-16 10:11:33.897
12390,7,590,부산,0,0,0,5394,2020-10-29 09:00:00.000,2021-09-16 10:11:33.897
12391,196,7155,대구,3,3,0,5393,2020-10-29 09:00:00.000,2021-09-16 10:11:33.897
12392,9,1039,인천,5,5,0,5392,2020-10-29 09:00:00.000,2021-09-16 10:11:33.897
12393,3,511,광주,2,1,1,5391,2020-10-29 09:00:00.000,2021-09-16 10:11:33.897
12394,6,442,대전,0,0,0,5390,2020-10-29 09:00:00.000,2021-09-16 10:11:33.897
12395,2,161,울산,2,1,1,5389,2020-10-29 09:00:00.000,2021-09-16 10:11:33.897
12396,0,79,세종,0,0,0,5388,2020-10-29 09:00:00.000,2021-09-16 10:11:33.897
12397,89,5344,경기,58,52,6,5387,2020-10-29 09:00:00.000,2021-09-16 10:11:33.897
12398,3,273,강원,7,7,0,5386,2020-10-29 09:00:00.000,2021-09-16 10:11:33.897
12399,2,187,충북,0,0,0,5385,2020-10-29 09:00:00.000,2021-09-16 10:11:33.897
12400,8,533,충남,1,1,0,5384,2020-10-29 09:00:00.000,2021-09-16 10:11:33.897
12401,0,164,전북,1,1,0,5383,2020-10-29 09:00:00.000,2021-09-16 10:11:33.897
12402,2,184,전남,0,0,0,5382,2020-10-29 09:00:00.000,2021-09-16 10:11:33.897
12403,57,1587,경북,1,0,1,5381,2020-10-29 09:00:00.000,2021-09-16 10:11:33.897
12404,0,314,경남,0,0,0,5380,2020-10-29 09:00:00.000,2021-09-16 10:11:33.897
12405,0,59,제주,0,0,0,5379,2020-10-29 09:00:00.000,2021-09-16 10:11:33.897
12406,0,1737,검역,9,0,9,5378,2020-10-29 09:00:00.000,2021-09-16 10:11:33.897
12407,461,26146,합계,103,96,7,5377,2020-10-28 09:00:00.000,2021-09-16 10:11:33.897
12408,77,5876,서울,25,23,2,5376,2020-10-28 09:00:00.000,2021-09-16 10:11:33.897
12409,7,590,부산,0,0,0,5375,2020-10-28 09:00:00.000,2021-09-16 10:11:33.897
12410,196,7152,대구,2,2,0,5374,2020-10-28 09:00:00.000,2021-09-16 10:11:33.897
12411,9,1034,인천,10,10,0,5373,2020-10-28 09:00:00.000,2021-09-16 10:11:33.897
12412,3,509,광주,0,0,0,5372,2020-10-28 09:00:00.000,2021-09-16 10:11:33.897
12413,6,442,대전,7,7,0,5371,2020-10-28 09:00:00.000,2021-09-16 10:11:33.897
12414,2,159,울산,0,0,0,5370,2020-10-28 09:00:00.000,2021-09-16 10:11:33.897
12415,0,79,세종,0,0,0,5369,2020-10-28 09:00:00.000,2021-09-16 10:11:33.897
12416,89,5286,경기,31,28,3,5368,2020-10-28 09:00:00.000,2021-09-16 10:11:33.897
12417,3,266,강원,14,14,0,5367,2020-10-28 09:00:00.000,2021-09-16 10:11:33.897
12418,2,187,충북,0,0,0,5366,2020-10-28 09:00:00.000,2021-09-16 10:11:33.897
12419,8,532,충남,1,1,0,5365,2020-10-28 09:00:00.000,2021-09-16 10:11:33.897
12420,0,163,전북,3,3,0,5364,2020-10-28 09:00:00.000,2021-09-16 10:11:33.897
12421,2,184,전남,0,0,0,5363,2020-10-28 09:00:00.000,2021-09-16 10:11:33.897
12422,57,1586,경북,5,5,0,5362,2020-10-28 09:00:00.000,2021-09-16 10:11:33.897
12423,0,314,경남,3,3,0,5361,2020-10-28 09:00:00.000,2021-09-16 10:11:33.897
12424,0,59,제주,0,0,0,5360,2020-10-28 09:00:00.000,2021-09-16 10:11:33.897
12425,0,1728,검역,2,0,2,5359,2020-10-28 09:00:00.000,2021-09-16 10:11:33.897
12426,460,26043,합계,88,72,16,5358,2020-10-27 09:00:00.000,2021-09-16 10:11:33.897
12427,76,5851,서울,24,24,0,5357,2020-10-27 09:00:00.000,2021-09-16 10:11:33.897
12428,7,590,부산,1,0,1,5356,2020-10-27 09:00:00.000,2021-09-16 10:11:33.897
12429,196,7150,대구,0,0,0,5355,2020-10-27 09:00:00.000,2021-09-16 10:11:33.897
12430,9,1024,인천,2,2,0,5354,2020-10-27 09:00:00.000,2021-09-16 10:11:33.897
12431,3,509,광주,0,0,0,5353,2020-10-27 09:00:00.000,2021-09-16 10:11:33.897
12432,6,435,대전,5,5,0,5352,2020-10-27 09:00:00.000,2021-09-16 10:11:33.897
12433,2,159,울산,0,0,0,5351,2020-10-27 09:00:00.000,2021-09-16 10:11:33.897
12434,0,79,세종,0,0,0,5350,2020-10-27 09:00:00.000,2021-09-16 10:11:33.897
12435,89,5255,경기,35,27,8,5349,2020-10-27 09:00:00.000,2021-09-16 10:11:33.897
12436,3,252,강원,6,6,0,5348,2020-10-27 09:00:00.000,2021-09-16 10:11:33.897
12437,2,187,충북,1,1,0,5347,2020-10-27 09:00:00.000,2021-09-16 10:11:33.897
12438,8,531,충남,1,0,1,5346,2020-10-27 09:00:00.000,2021-09-16 10:11:33.897
12439,0,160,전북,0,0,0,5345,2020-10-27 09:00:00.000,2021-09-16 10:11:33.897
12440,2,184,전남,3,2,1,5344,2020-10-27 09:00:00.000,2021-09-16 10:11:33.897
12441,57,1581,경북,0,0,0,5343,2020-10-27 09:00:00.000,2021-09-16 10:11:33.897
12442,0,311,경남,5,5,0,5342,2020-10-27 09:00:00.000,2021-09-16 10:11:33.897
12443,0,59,제주,0,0,0,5341,2020-10-27 09:00:00.000,2021-09-16 10:11:33.897
12444,0,1726,검역,5,0,5,5340,2020-10-27 09:00:00.000,2021-09-16 10:11:33.897
12445,457,25955,합계,119,94,25,5339,2020-10-26 09:00:00.000,2021-09-16 10:11:33.897
12446,74,5827,서울,20,20,0,5338,2020-10-26 09:00:00.000,2021-09-16 10:11:33.897
12447,7,589,부산,0,0,0,5337,2020-10-26 09:00:00.000,2021-09-16 10:11:33.897
12448,196,7150,대구,0,0,0,5336,2020-10-26 09:00:00.000,2021-09-16 10:11:33.897
12449,9,1022,인천,3,3,0,5335,2020-10-26 09:00:00.000,2021-09-16 10:11:33.897
12450,3,509,광주,0,0,0,5334,2020-10-26 09:00:00.000,2021-09-16 10:11:33.897
12451,5,430,대전,1,1,0,5333,2020-10-26 09:00:00.000,2021-09-16 10:11:33.897
12452,2,159,울산,1,0,1,5332,2020-10-26 09:00:00.000,2021-09-16 10:11:33.897
12453,0,79,세종,1,0,1,5331,2020-10-26 09:00:00.000,2021-09-16 10:11:33.897
12454,89,5220,경기,67,65,2,5330,2020-10-26 09:00:00.000,2021-09-16 10:11:33.897
12455,3,246,강원,0,0,0,5329,2020-10-26 09:00:00.000,2021-09-16 10:11:33.897
12456,2,186,충북,2,1,1,5328,2020-10-26 09:00:00.000,2021-09-16 10:11:33.897
12457,8,530,충남,1,1,0,5327,2020-10-26 09:00:00.000,2021-09-16 10:11:33.897
12458,0,160,전북,0,0,0,5326,2020-10-26 09:00:00.000,2021-09-16 10:11:33.897
12459,2,181,전남,0,0,0,5325,2020-10-26 09:00:00.000,2021-09-16 10:11:33.897
12460,57,1581,경북,3,0,3,5324,2020-10-26 09:00:00.000,2021-09-16 10:11:33.897
12461,0,306,경남,3,3,0,5323,2020-10-26 09:00:00.000,2021-09-16 10:11:33.897
12462,0,59,제주,0,0,0,5322,2020-10-26 09:00:00.000,2021-09-16 10:11:33.897
12463,0,1721,검역,17,0,17,5321,2020-10-26 09:00:00.000,2021-09-16 10:11:33.897
12464,457,25836,합계,61,50,11,5320,2020-10-25 09:00:00.000,2021-09-16 10:11:33.897
12465,74,5807,서울,17,17,0,5319,2020-10-25 09:00:00.000,2021-09-16 10:11:33.897
12466,7,589,부산,1,1,0,5318,2020-10-25 09:00:00.000,2021-09-16 10:11:33.897
12467,196,7150,대구,1,0,1,5317,2020-10-25 09:00:00.000,2021-09-16 10:11:33.897
12468,9,1019,인천,0,0,0,5316,2020-10-25 09:00:00.000,2021-09-16 10:11:33.897
12469,3,509,광주,0,0,0,5315,2020-10-25 09:00:00.000,2021-09-16 10:11:33.897
12470,5,429,대전,1,1,0,5314,2020-10-25 09:00:00.000,2021-09-16 10:11:33.897
12471,2,158,울산,1,1,0,5313,2020-10-25 09:00:00.000,2021-09-16 10:11:33.897
12472,0,78,세종,0,0,0,5312,2020-10-25 09:00:00.000,2021-09-16 10:11:33.897
12473,89,5153,경기,27,27,0,5311,2020-10-25 09:00:00.000,2021-09-16 10:11:33.897
12474,3,246,강원,0,0,0,5310,2020-10-25 09:00:00.000,2021-09-16 10:11:33.897
12475,2,184,충북,0,0,0,5309,2020-10-25 09:00:00.000,2021-09-16 10:11:33.897
12476,8,529,충남,2,2,0,5308,2020-10-25 09:00:00.000,2021-09-16 10:11:33.897
12477,0,160,전북,0,0,0,5307,2020-10-25 09:00:00.000,2021-09-16 10:11:33.897
12478,2,181,전남,0,0,0,5306,2020-10-25 09:00:00.000,2021-09-16 10:11:33.897
12479,57,1578,경북,0,0,0,5305,2020-10-25 09:00:00.000,2021-09-16 10:11:33.897
12480,0,303,경남,2,1,1,5304,2020-10-25 09:00:00.000,2021-09-16 10:11:33.897
12481,0,59,제주,0,0,0,5303,2020-10-25 09:00:00.000,2021-09-16 10:11:33.897
12482,0,1704,검역,9,0,9,5302,2020-10-25 09:00:00.000,2021-09-16 10:11:33.897
12483,457,25775,합계,77,66,11,5301,2020-10-24 09:00:00.000,2021-09-16 10:11:33.897
12484,74,5790,서울,22,22,0,5300,2020-10-24 09:00:00.000,2021-09-16 10:11:33.897
12485,7,588,부산,0,0,0,5299,2020-10-24 09:00:00.000,2021-09-16 10:11:33.897
12486,196,7149,대구,0,0,0,5298,2020-10-24 09:00:00.000,2021-09-16 10:11:33.897
12487,9,1019,인천,2,2,0,5297,2020-10-24 09:00:00.000,2021-09-16 10:11:33.897
12488,3,509,광주,0,0,0,5296,2020-10-24 09:00:00.000,2021-09-16 10:11:33.897
12489,5,428,대전,5,5,0,5295,2020-10-24 09:00:00.000,2021-09-16 10:11:33.897
12490,2,157,울산,0,0,0,5294,2020-10-24 09:00:00.000,2021-09-16 10:11:33.897
12491,0,78,세종,0,0,0,5293,2020-10-24 09:00:00.000,2021-09-16 10:11:33.897
12492,89,5126,경기,35,32,3,5292,2020-10-24 09:00:00.000,2021-09-16 10:11:33.897
12493,3,246,강원,0,0,0,5291,2020-10-24 09:00:00.000,2021-09-16 10:11:33.897
12494,2,184,충북,0,0,0,5290,2020-10-24 09:00:00.000,2021-09-16 10:11:33.897
12495,8,527,충남,5,5,0,5289,2020-10-24 09:00:00.000,2021-09-16 10:11:33.897
12496,0,160,전북,0,0,0,5288,2020-10-24 09:00:00.000,2021-09-16 10:11:33.897
12497,2,181,전남,2,0,2,5287,2020-10-24 09:00:00.000,2021-09-16 10:11:33.897
12498,57,1578,경북,0,0,0,5286,2020-10-24 09:00:00.000,2021-09-16 10:11:33.897
12499,0,301,경남,0,0,0,5285,2020-10-24 09:00:00.000,2021-09-16 10:11:33.897
12500,0,59,제주,0,0,0,5284,2020-10-24 09:00:00.000,2021-09-16 10:11:33.897
12501,0,1695,검역,6,0,6,5283,2020-10-24 09:00:00.000,2021-09-16 10:11:33.897
12502,455,25698,합계,155,138,17,5282,2020-10-23 09:00:00.000,2021-09-16 10:11:33.897
12503,74,5768,서울,20,19,1,5281,2020-10-23 09:00:00.000,2021-09-16 10:11:33.897
12504,7,588,부산,0,0,0,5280,2020-10-23 09:00:00.000,2021-09-16 10:11:33.897
12505,196,7149,대구,5,5,0,5279,2020-10-23 09:00:00.000,2021-09-16 10:11:33.897
12506,9,1017,인천,5,4,1,5278,2020-10-23 09:00:00.000,2021-09-16 10:11:33.897
12507,3,509,광주,6,4,2,5277,2020-10-23 09:00:00.000,2021-09-16 10:11:33.897
12508,5,423,대전,0,0,0,5276,2020-10-23 09:00:00.000,2021-09-16 10:11:33.897
12509,2,157,울산,0,0,0,5275,2020-10-23 09:00:00.000,2021-09-16 10:11:33.897
12510,0,78,세종,0,0,0,5274,2020-10-23 09:00:00.000,2021-09-16 10:11:33.897
12511,88,5091,경기,103,98,5,5273,2020-10-23 09:00:00.000,2021-09-16 10:11:33.897
12512,3,246,강원,1,1,0,5272,2020-10-23 09:00:00.000,2021-09-16 10:11:33.897
12513,2,184,충북,0,0,0,5271,2020-10-23 09:00:00.000,2021-09-16 10:11:33.897
12514,7,522,충남,4,4,0,5270,2020-10-23 09:00:00.000,2021-09-16 10:11:33.897
12515,0,160,전북,2,2,0,5269,2020-10-23 09:00:00.000,2021-09-16 10:11:33.897
12516,2,179,전남,1,1,0,5268,2020-10-23 09:00:00.000,2021-09-16 10:11:33.897
12517,57,1578,경북,0,0,0,5267,2020-10-23 09:00:00.000,2021-09-16 10:11:33.897
12518,0,301,경남,0,0,0,5266,2020-10-23 09:00:00.000,2021-09-16 10:11:33.897
12519,0,59,제주,0,0,0,5265,2020-10-23 09:00:00.000,2021-09-16 10:11:33.897
12520,0,1689,검역,8,0,8,5264,2020-10-23 09:00:00.000,2021-09-16 10:11:33.897
12521,453,25543,합계,121,104,17,5263,2020-10-22 09:00:00.000,2021-09-16 10:11:33.897
12522,74,5748,서울,18,18,0,5262,2020-10-22 09:00:00.000,2021-09-16 10:11:33.897
12523,6,588,부산,5,5,0,5261,2020-10-22 09:00:00.000,2021-09-16 10:11:33.897
12524,196,7144,대구,2,2,0,5260,2020-10-22 09:00:00.000,2021-09-16 10:11:33.897
12525,9,1012,인천,4,2,2,5259,2020-10-22 09:00:00.000,2021-09-16 10:11:33.897
12526,3,503,광주,0,0,0,5258,2020-10-22 09:00:00.000,2021-09-16 10:11:33.897
12527,5,423,대전,0,0,0,5257,2020-10-22 09:00:00.000,2021-09-16 10:11:33.897
12528,2,157,울산,0,0,0,5256,2020-10-22 09:00:00.000,2021-09-16 10:11:33.897
12529,0,78,세종,0,0,0,5255,2020-10-22 09:00:00.000,2021-09-16 10:11:33.897
12530,88,4988,경기,67,62,5,5254,2020-10-22 09:00:00.000,2021-09-16 10:11:33.897
12531,3,245,강원,2,2,0,5253,2020-10-22 09:00:00.000,2021-09-16 10:11:33.897
12532,2,184,충북,0,0,0,5252,2020-10-22 09:00:00.000,2021-09-16 10:11:33.897
12533,7,518,충남,11,11,0,5251,2020-10-22 09:00:00.000,2021-09-16 10:11:33.897
12534,0,158,전북,2,2,0,5250,2020-10-22 09:00:00.000,2021-09-16 10:11:33.897
12535,2,178,전남,0,0,0,5249,2020-10-22 09:00:00.000,2021-09-16 10:11:33.897
12536,56,1578,경북,1,0,1,5248,2020-10-22 09:00:00.000,2021-09-16 10:11:33.897
12537,0,301,경남,0,0,0,5247,2020-10-22 09:00:00.000,2021-09-16 10:11:33.897
12538,0,59,제주,0,0,0,5246,2020-10-22 09:00:00.000,2021-09-16 10:11:33.897
12539,0,1681,검역,9,0,9,5245,2020-10-22 09:00:00.000,2021-09-16 10:11:33.897
12540,450,25422,합계,89,57,32,5244,2020-10-21 09:00:00.000,2021-09-16 10:11:33.897
12541,71,5730,서울,17,13,4,5243,2020-10-21 09:00:00.000,2021-09-16 10:11:33.897
12542,6,583,부산,10,10,0,5242,2020-10-21 09:00:00.000,2021-09-16 10:11:33.897
12543,196,7142,대구,0,0,0,5241,2020-10-21 09:00:00.000,2021-09-16 10:11:33.897
12544,9,1008,인천,6,6,0,5240,2020-10-21 09:00:00.000,2021-09-16 10:11:33.897
12545,3,503,광주,1,0,1,5239,2020-10-21 09:00:00.000,2021-09-16 10:11:33.897
12546,5,423,대전,4,4,0,5238,2020-10-21 09:00:00.000,2021-09-16 10:11:33.897
12547,2,157,울산,1,1,0,5237,2020-10-21 09:00:00.000,2021-09-16 10:11:33.897
12548,0,78,세종,0,0,0,5236,2020-10-21 09:00:00.000,2021-09-16 10:11:33.897
12549,88,4921,경기,24,21,3,5235,2020-10-21 09:00:00.000,2021-09-16 10:11:33.897
12550,3,243,강원,2,0,2,5234,2020-10-21 09:00:00.000,2021-09-16 10:11:33.897
12551,2,184,충북,1,0,1,5233,2020-10-21 09:00:00.000,2021-09-16 10:11:33.897
12552,7,507,충남,0,0,0,5232,2020-10-21 09:00:00.000,2021-09-16 10:11:33.897
12553,0,156,전북,0,0,0,5231,2020-10-21 09:00:00.000,2021-09-16 10:11:33.897
12554,2,178,전남,1,0,1,5230,2020-10-21 09:00:00.000,2021-09-16 10:11:33.897
12555,56,1577,경북,2,2,0,5229,2020-10-21 09:00:00.000,2021-09-16 10:11:33.897
12556,0,301,경남,0,0,0,5228,2020-10-21 09:00:00.000,2021-09-16 10:11:33.897
12557,0,59,제주,0,0,0,5227,2020-10-21 09:00:00.000,2021-09-16 10:11:33.897
12558,0,1672,검역,20,0,20,5226,2020-10-21 09:00:00.000,2021-09-16 10:11:33.897
12559,447,25333,합계,58,41,17,5225,2020-10-20 09:00:00.000,2021-09-16 10:11:33.897
12560,69,5713,서울,11,11,0,5224,2020-10-20 09:00:00.000,2021-09-16 10:11:33.897
12561,6,573,부산,2,1,1,5223,2020-10-20 09:00:00.000,2021-09-16 10:11:33.897
12562,196,7142,대구,0,0,0,5222,2020-10-20 09:00:00.000,2021-09-16 10:11:33.897
12563,9,1002,인천,3,3,0,5221,2020-10-20 09:00:00.000,2021-09-16 10:11:33.897
12564,3,502,광주,0,0,0,5220,2020-10-20 09:00:00.000,2021-09-16 10:11:33.897
12565,5,419,대전,1,1,0,5219,2020-10-20 09:00:00.000,2021-09-16 10:11:33.897
12566,2,156,울산,0,0,0,5218,2020-10-20 09:00:00.000,2021-09-16 10:11:33.897
12567,0,78,세종,0,0,0,5217,2020-10-20 09:00:00.000,2021-09-16 10:11:33.897
12568,87,4897,경기,28,22,6,5216,2020-10-20 09:00:00.000,2021-09-16 10:11:33.897
12569,3,241,강원,3,2,1,5215,2020-10-20 09:00:00.000,2021-09-16 10:11:33.897
12570,2,183,충북,2,0,2,5214,2020-10-20 09:00:00.000,2021-09-16 10:11:33.897
12571,7,507,충남,2,1,1,5213,2020-10-20 09:00:00.000,2021-09-16 10:11:33.897
12572,0,156,전북,0,0,0,5212,2020-10-20 09:00:00.000,2021-09-16 10:11:33.897
12573,2,177,전남,0,0,0,5211,2020-10-20 09:00:00.000,2021-09-16 10:11:33.897
12574,56,1575,경북,2,0,2,5210,2020-10-20 09:00:00.000,2021-09-16 10:11:33.897
12575,0,301,경남,1,0,1,5209,2020-10-20 09:00:00.000,2021-09-16 10:11:33.897
12576,0,59,제주,0,0,0,5208,2020-10-20 09:00:00.000,2021-09-16 10:11:33.897
12577,0,1652,검역,3,0,3,5207,2020-10-20 09:00:00.000,2021-09-16 10:11:33.897
12578,444,25275,합계,76,50,26,5206,2020-10-19 09:00:00.000,2021-09-16 10:11:33.897
12579,69,5702,서울,14,11,3,5205,2020-10-19 09:00:00.000,2021-09-16 10:11:33.897
12580,6,571,부산,15,14,1,5204,2020-10-19 09:00:00.000,2021-09-16 10:11:33.897
12581,196,7142,대구,0,0,0,5203,2020-10-19 09:00:00.000,2021-09-16 10:11:33.897
12582,8,999,인천,5,4,1,5202,2020-10-19 09:00:00.000,2021-09-16 10:11:33.897
12583,3,502,광주,2,1,1,5201,2020-10-19 09:00:00.000,2021-09-16 10:11:33.897
12584,5,418,대전,2,2,0,5200,2020-10-19 09:00:00.000,2021-09-16 10:11:33.897
12585,2,156,울산,0,0,0,5199,2020-10-19 09:00:00.000,2021-09-16 10:11:33.897
12586,0,78,세종,0,0,0,5198,2020-10-19 09:00:00.000,2021-09-16 10:11:33.897
12587,86,4869,경기,18,15,3,5197,2020-10-19 09:00:00.000,2021-09-16 10:11:33.897
12588,3,238,강원,1,1,0,5196,2020-10-19 09:00:00.000,2021-09-16 10:11:33.897
12589,1,181,충북,1,0,1,5195,2020-10-19 09:00:00.000,2021-09-16 10:11:33.897
12590,7,505,충남,2,2,0,5194,2020-10-19 09:00:00.000,2021-09-16 10:11:33.897
12591,0,156,전북,1,0,1,5193,2020-10-19 09:00:00.000,2021-09-16 10:11:33.897
12592,2,177,전남,0,0,0,5192,2020-10-19 09:00:00.000,2021-09-16 10:11:33.897
12593,56,1573,경북,2,0,2,5191,2020-10-19 09:00:00.000,2021-09-16 10:11:33.897
12594,0,300,경남,1,0,1,5190,2020-10-19 09:00:00.000,2021-09-16 10:11:33.897
12595,0,59,제주,0,0,0,5189,2020-10-19 09:00:00.000,2021-09-16 10:11:33.897
12596,0,1649,검역,12,0,12,5188,2020-10-19 09:00:00.000,2021-09-16 10:11:33.897
12597,444,25199,합계,91,71,20,5187,2020-10-18 09:00:00.000,2021-09-16 10:11:33.897
12598,69,5688,서울,20,18,2,5186,2020-10-18 09:00:00.000,2021-09-16 10:11:33.897
12599,6,556,부산,4,2,2,5185,2020-10-18 09:00:00.000,2021-09-16 10:11:33.897
12600,196,7142,대구,0,0,0,5184,2020-10-18 09:00:00.000,2021-09-16 10:11:33.897
12601,8,994,인천,1,1,0,5183,2020-10-18 09:00:00.000,2021-09-16 10:11:33.897
12602,3,500,광주,0,0,0,5182,2020-10-18 09:00:00.000,2021-09-16 10:11:33.897
12603,5,416,대전,1,1,0,5181,2020-10-18 09:00:00.000,2021-09-16 10:11:33.897
12604,2,156,울산,0,0,0,5180,2020-10-18 09:00:00.000,2021-09-16 10:11:33.897
12605,0,78,세종,0,0,0,5179,2020-10-18 09:00:00.000,2021-09-16 10:11:33.897
12606,86,4851,경기,50,48,2,5178,2020-10-18 09:00:00.000,2021-09-16 10:11:33.897
12607,3,237,강원,2,1,1,5177,2020-10-18 09:00:00.000,2021-09-16 10:11:33.897
12608,1,180,충북,0,0,0,5176,2020-10-18 09:00:00.000,2021-09-16 10:11:33.897
12609,7,503,충남,0,0,0,5175,2020-10-18 09:00:00.000,2021-09-16 10:11:33.897
12610,0,155,전북,0,0,0,5174,2020-10-18 09:00:00.000,2021-09-16 10:11:33.897
12611,2,177,전남,0,0,0,5173,2020-10-18 09:00:00.000,2021-09-16 10:11:33.897
12612,56,1571,경북,0,0,0,5172,2020-10-18 09:00:00.000,2021-09-16 10:11:33.897
12613,0,299,경남,0,0,0,5171,2020-10-18 09:00:00.000,2021-09-16 10:11:33.897
12614,0,59,제주,0,0,0,5170,2020-10-18 09:00:00.000,2021-09-16 10:11:33.897
12615,0,1637,검역,13,0,13,5169,2020-10-18 09:00:00.000,2021-09-16 10:11:33.897
12616,443,25108,합계,73,62,11,5168,2020-10-17 09:00:00.000,2021-09-16 10:11:33.897
12617,68,5668,서울,18,17,1,5167,2020-10-17 09:00:00.000,2021-09-16 10:11:33.897
12618,6,552,부산,6,6,0,5166,2020-10-17 09:00:00.000,2021-09-16 10:11:33.897
12619,196,7142,대구,1,0,1,5165,2020-10-17 09:00:00.000,2021-09-16 10:11:33.897
12620,8,993,인천,2,1,1,5164,2020-10-17 09:00:00.000,2021-09-16 10:11:33.897
12621,3,500,광주,1,0,1,5163,2020-10-17 09:00:00.000,2021-09-16 10:11:33.897
12622,5,415,대전,0,0,0,5162,2020-10-17 09:00:00.000,2021-09-16 10:11:33.897
12623,2,156,울산,0,0,0,5161,2020-10-17 09:00:00.000,2021-09-16 10:11:33.897
12624,0,78,세종,0,0,0,5160,2020-10-17 09:00:00.000,2021-09-16 10:11:33.897
12625,86,4801,경기,32,32,0,5159,2020-10-17 09:00:00.000,2021-09-16 10:11:33.897
12626,3,235,강원,3,3,0,5158,2020-10-17 09:00:00.000,2021-09-16 10:11:33.897
12627,1,180,충북,0,0,0,5157,2020-10-17 09:00:00.000,2021-09-16 10:11:33.897
12628,7,503,충남,2,2,0,5156,2020-10-17 09:00:00.000,2021-09-16 10:11:33.897
12629,0,155,전북,0,0,0,5155,2020-10-17 09:00:00.000,2021-09-16 10:11:33.897
12630,2,177,전남,1,0,1,5154,2020-10-17 09:00:00.000,2021-09-16 10:11:33.897
12631,56,1571,경북,0,0,0,5153,2020-10-17 09:00:00.000,2021-09-16 10:11:33.897
12632,0,299,경남,2,1,1,5152,2020-10-17 09:00:00.000,2021-09-16 10:11:33.897
12633,0,59,제주,0,0,0,5151,2020-10-17 09:00:00.000,2021-09-16 10:11:33.897
12634,0,1624,검역,5,0,5,5150,2020-10-17 09:00:00.000,2021-09-16 10:11:33.897
12635,441,25035,합계,47,41,6,5149,2020-10-16 09:00:00.000,2021-09-16 10:11:33.897
12636,67,5650,서울,18,17,1,5148,2020-10-16 09:00:00.000,2021-09-16 10:11:33.897
12637,6,546,부산,0,0,0,5147,2020-10-16 09:00:00.000,2021-09-16 10:11:33.897
12638,196,7141,대구,0,0,0,5146,2020-10-16 09:00:00.000,2021-09-16 10:11:33.897
12639,8,991,인천,4,4,0,5145,2020-10-16 09:00:00.000,2021-09-16 10:11:33.897
12640,3,499,광주,0,0,0,5144,2020-10-16 09:00:00.000,2021-09-16 10:11:33.897
12641,5,415,대전,2,2,0,5143,2020-10-16 09:00:00.000,2021-09-16 10:11:33.897
12642,2,156,울산,0,0,0,5142,2020-10-16 09:00:00.000,2021-09-16 10:11:33.897
12643,0,78,세종,0,0,0,5141,2020-10-16 09:00:00.000,2021-09-16 10:11:33.897
12644,86,4769,경기,17,15,2,5140,2020-10-16 09:00:00.000,2021-09-16 10:11:33.897
12645,3,232,강원,0,0,0,5139,2020-10-16 09:00:00.000,2021-09-16 10:11:33.897
12646,1,180,충북,0,0,0,5138,2020-10-16 09:00:00.000,2021-09-16 10:11:33.897
12647,6,501,충남,1,1,0,5137,2020-10-16 09:00:00.000,2021-09-16 10:11:33.897
12648,0,155,전북,2,2,0,5136,2020-10-16 09:00:00.000,2021-09-16 10:11:33.897
12649,2,176,전남,0,0,0,5135,2020-10-16 09:00:00.000,2021-09-16 10:11:33.897
12650,56,1571,경북,0,0,0,5134,2020-10-16 09:00:00.000,2021-09-16 10:11:33.897
12651,0,297,경남,0,0,0,5133,2020-10-16 09:00:00.000,2021-09-16 10:11:33.897
12652,0,59,제주,0,0,0,5132,2020-10-16 09:00:00.000,2021-09-16 10:11:33.897
12653,0,1619,검역,3,0,3,5131,2020-10-16 09:00:00.000,2021-09-16 10:11:33.897
12654,439,24988,합계,110,95,15,5130,2020-10-15 09:00:00.000,2021-09-16 10:11:33.897
12655,66,5632,서울,25,22,3,5129,2020-10-15 09:00:00.000,2021-09-16 10:11:33.897
12656,5,546,부산,55,54,1,5128,2020-10-15 09:00:00.000,2021-09-16 10:11:33.897
12657,196,7141,대구,0,0,0,5127,2020-10-15 09:00:00.000,2021-09-16 10:11:33.897
12658,8,987,인천,11,11,0,5126,2020-10-15 09:00:00.000,2021-09-16 10:11:33.897
12659,3,499,광주,0,0,0,5125,2020-10-15 09:00:00.000,2021-09-16 10:11:33.897
12660,5,413,대전,1,1,0,5124,2020-10-15 09:00:00.000,2021-09-16 10:11:33.897
12661,2,156,울산,0,0,0,5123,2020-10-15 09:00:00.000,2021-09-16 10:11:33.897
12662,0,78,세종,0,0,0,5122,2020-10-15 09:00:00.000,2021-09-16 10:11:33.897
12663,86,4752,경기,8,6,2,5121,2020-10-15 09:00:00.000,2021-09-16 10:11:33.897
12664,3,232,강원,1,1,0,5120,2020-10-15 09:00:00.000,2021-09-16 10:11:33.897
12665,1,180,충북,1,0,1,5119,2020-10-15 09:00:00.000,2021-09-16 10:11:33.897
12666,6,500,충남,0,0,0,5118,2020-10-15 09:00:00.000,2021-09-16 10:11:33.897
12667,0,153,전북,1,0,1,5117,2020-10-15 09:00:00.000,2021-09-16 10:11:33.897
12668,2,176,전남,0,0,0,5116,2020-10-15 09:00:00.000,2021-09-16 10:11:33.897
12669,56,1571,경북,1,0,1,5115,2020-10-15 09:00:00.000,2021-09-16 10:11:33.897
12670,0,297,경남,0,0,0,5114,2020-10-15 09:00:00.000,2021-09-16 10:11:33.897
12671,0,59,제주,0,0,0,5113,2020-10-15 09:00:00.000,2021-09-16 10:11:33.897
12672,0,1616,검역,6,0,6,5112,2020-10-15 09:00:00.000,2021-09-16 10:11:33.897
12673,438,24878,합계,84,53,31,5111,2020-10-14 09:00:00.000,2021-09-16 10:11:33.897
12674,66,5607,서울,23,23,0,5110,2020-10-14 09:00:00.000,2021-09-16 10:11:33.897
12675,4,491,부산,2,2,0,5109,2020-10-14 09:00:00.000,2021-09-16 10:11:33.897
12676,196,7141,대구,0,0,0,5108,2020-10-14 09:00:00.000,2021-09-16 10:11:33.897
12677,8,976,인천,8,8,0,5107,2020-10-14 09:00:00.000,2021-09-16 10:11:33.897
12678,3,499,광주,0,0,0,5106,2020-10-14 09:00:00.000,2021-09-16 10:11:33.897
12679,5,412,대전,4,4,0,5105,2020-10-14 09:00:00.000,2021-09-16 10:11:33.897
12680,2,156,울산,1,0,1,5104,2020-10-14 09:00:00.000,2021-09-16 10:11:33.897
12681,0,78,세종,0,0,0,5103,2020-10-14 09:00:00.000,2021-09-16 10:11:33.897
12682,86,4744,경기,31,15,16,5102,2020-10-14 09:00:00.000,2021-09-16 10:11:33.897
12683,3,231,강원,0,0,0,5101,2020-10-14 09:00:00.000,2021-09-16 10:11:33.897
12684,1,179,충북,0,0,0,5100,2020-10-14 09:00:00.000,2021-09-16 10:11:33.897
12685,6,500,충남,1,1,0,5099,2020-10-14 09:00:00.000,2021-09-16 10:11:33.897
12686,0,152,전북,0,0,0,5098,2020-10-14 09:00:00.000,2021-09-16 10:11:33.897
12687,2,176,전남,0,0,0,5097,2020-10-14 09:00:00.000,2021-09-16 10:11:33.897
12688,56,1570,경북,0,0,0,5096,2020-10-14 09:00:00.000,2021-09-16 10:11:33.897
12689,0,297,경남,0,0,0,5095,2020-10-14 09:00:00.000,2021-09-16 10:11:33.897
12690,0,59,제주,0,0,0,5094,2020-10-14 09:00:00.000,2021-09-16 10:11:33.897
12691,0,1610,검역,14,0,14,5093,2020-10-14 09:00:00.000,2021-09-16 10:11:33.897
12692,434,24794,합계,91,69,22,5092,2020-10-13 09:00:00.000,2021-09-16 10:11:33.897
12693,65,5584,서울,20,18,2,5091,2020-10-13 09:00:00.000,2021-09-16 10:11:33.897
12694,4,489,부산,1,1,0,5090,2020-10-13 09:00:00.000,2021-09-16 10:11:33.897
12695,196,7141,대구,1,0,1,5089,2020-10-13 09:00:00.000,2021-09-16 10:11:33.897
12696,8,968,인천,0,0,0,5088,2020-10-13 09:00:00.000,2021-09-16 10:11:33.897
12697,3,499,광주,2,1,1,5087,2020-10-13 09:00:00.000,2021-09-16 10:11:33.897
12698,5,408,대전,10,9,1,5086,2020-10-13 09:00:00.000,2021-09-16 10:11:33.897
12699,2,155,울산,0,0,0,5085,2020-10-13 09:00:00.000,2021-09-16 10:11:33.897
12700,0,78,세종,0,0,0,5084,2020-10-13 09:00:00.000,2021-09-16 10:11:33.897
12701,83,4713,경기,38,32,6,5083,2020-10-13 09:00:00.000,2021-09-16 10:11:33.897
12702,3,231,강원,4,4,0,5082,2020-10-13 09:00:00.000,2021-09-16 10:11:33.897
12703,1,179,충북,1,1,0,5081,2020-10-13 09:00:00.000,2021-09-16 10:11:33.897
12704,6,499,충남,2,2,0,5080,2020-10-13 09:00:00.000,2021-09-16 10:11:33.897
12705,0,152,전북,1,1,0,5079,2020-10-13 09:00:00.000,2021-09-16 10:11:33.897
12706,2,176,전남,0,0,0,5078,2020-10-13 09:00:00.000,2021-09-16 10:11:33.897
12707,56,1570,경북,1,0,1,5077,2020-10-13 09:00:00.000,2021-09-16 10:11:33.897
12708,0,297,경남,0,0,0,5076,2020-10-13 09:00:00.000,2021-09-16 10:11:33.897
12709,0,59,제주,0,0,0,5075,2020-10-13 09:00:00.000,2021-09-16 10:11:33.897
12710,0,1596,검역,10,0,10,5074,2020-10-13 09:00:00.000,2021-09-16 10:11:33.897
12711,433,24703,합계,98,69,29,5073,2020-10-12 09:00:00.000,2021-09-16 10:11:33.897
12712,64,5564,서울,31,29,2,5072,2020-10-12 09:00:00.000,2021-09-16 10:11:33.897
12713,4,488,부산,4,3,1,5071,2020-10-12 09:00:00.000,2021-09-16 10:11:33.897
12714,196,7140,대구,0,0,0,5070,2020-10-12 09:00:00.000,2021-09-16 10:11:33.897
12715,8,968,인천,3,3,0,5069,2020-10-12 09:00:00.000,2021-09-16 10:11:33.897
12716,3,497,광주,1,1,0,5068,2020-10-12 09:00:00.000,2021-09-16 10:11:33.897
12717,5,398,대전,13,13,0,5067,2020-10-12 09:00:00.000,2021-09-16 10:11:33.897
12718,2,155,울산,0,0,0,5066,2020-10-12 09:00:00.000,2021-09-16 10:11:33.897
12719,0,78,세종,0,0,0,5065,2020-10-12 09:00:00.000,2021-09-16 10:11:33.897
12720,83,4675,경기,30,17,13,5064,2020-10-12 09:00:00.000,2021-09-16 10:11:33.897
12721,3,227,강원,1,1,0,5063,2020-10-12 09:00:00.000,2021-09-16 10:11:33.897
12722,1,178,충북,0,0,0,5062,2020-10-12 09:00:00.000,2021-09-16 10:11:33.897
12723,6,497,충남,2,0,2,5061,2020-10-12 09:00:00.000,2021-09-16 10:11:33.897
12724,0,151,전북,2,1,1,5060,2020-10-12 09:00:00.000,2021-09-16 10:11:33.897
12725,2,176,전남,0,0,0,5059,2020-10-12 09:00:00.000,2021-09-16 10:11:33.897
12726,56,1569,경북,1,0,1,5058,2020-10-12 09:00:00.000,2021-09-16 10:11:33.897
12727,0,297,경남,1,1,0,5057,2020-10-12 09:00:00.000,2021-09-16 10:11:33.897
12728,0,59,제주,0,0,0,5056,2020-10-12 09:00:00.000,2021-09-16 10:11:33.897
12729,0,1586,검역,9,0,9,5055,2020-10-12 09:00:00.000,2021-09-16 10:11:33.897
12730,432,24605,합계,58,46,12,5054,2020-10-11 09:00:00.000,2021-09-16 10:11:33.897
12731,64,5533,서울,23,19,4,5053,2020-10-11 09:00:00.000,2021-09-16 10:11:33.897
12732,4,484,부산,3,3,0,5052,2020-10-11 09:00:00.000,2021-09-16 10:11:33.897
12733,196,7140,대구,1,0,1,5051,2020-10-11 09:00:00.000,2021-09-16 10:11:33.897
12734,8,965,인천,1,1,0,5050,2020-10-11 09:00:00.000,2021-09-16 10:11:33.897
12735,3,496,광주,0,0,0,5049,2020-10-11 09:00:00.000,2021-09-16 10:11:33.897
12736,5,385,대전,2,2,0,5048,2020-10-11 09:00:00.000,2021-09-16 10:11:33.897
12737,2,155,울산,1,0,1,5047,2020-10-11 09:00:00.000,2021-09-16 10:11:33.897
12738,0,78,세종,0,0,0,5046,2020-10-11 09:00:00.000,2021-09-16 10:11:33.897
12739,82,4645,경기,21,18,3,5045,2020-10-11 09:00:00.000,2021-09-16 10:11:33.897
12740,3,226,강원,2,2,0,5044,2020-10-11 09:00:00.000,2021-09-16 10:11:33.897
12741,1,178,충북,0,0,0,5043,2020-10-11 09:00:00.000,2021-09-16 10:11:33.897
12742,6,495,충남,1,1,0,5042,2020-10-11 09:00:00.000,2021-09-16 10:11:33.897
12743,0,149,전북,0,0,0,5041,2020-10-11 09:00:00.000,2021-09-16 10:11:33.897
12744,2,176,전남,0,0,0,5040,2020-10-11 09:00:00.000,2021-09-16 10:11:33.897
12745,56,1568,경북,0,0,0,5039,2020-10-11 09:00:00.000,2021-09-16 10:11:33.897
12746,0,296,경남,0,0,0,5038,2020-10-11 09:00:00.000,2021-09-16 10:11:33.897
12747,0,59,제주,0,0,0,5037,2020-10-11 09:00:00.000,2021-09-16 10:11:33.897
12748,0,1577,검역,3,0,3,5036,2020-10-11 09:00:00.000,2021-09-16 10:11:33.897
12749,430,24547,합계,72,61,11,5035,2020-10-10 09:00:00.000,2021-09-16 10:11:33.897
12750,63,5510,서울,25,23,2,5034,2020-10-10 09:00:00.000,2021-09-16 10:11:33.897
12751,4,481,부산,3,3,0,5033,2020-10-10 09:00:00.000,2021-09-16 10:11:33.897
12752,196,7139,대구,1,0,1,5032,2020-10-10 09:00:00.000,2021-09-16 10:11:33.897
12753,8,964,인천,8,8,0,5031,2020-10-10 09:00:00.000,2021-09-16 10:11:33.897
12754,3,496,광주,0,0,0,5030,2020-10-10 09:00:00.000,2021-09-16 10:11:33.897
12755,5,383,대전,1,1,0,5029,2020-10-10 09:00:00.000,2021-09-16 10:11:33.897
12756,2,154,울산,0,0,0,5028,2020-10-10 09:00:00.000,2021-09-16 10:11:33.897
12757,0,78,세종,0,0,0,5027,2020-10-10 09:00:00.000,2021-09-16 10:11:33.897
12758,81,4624,경기,24,24,0,5026,2020-10-10 09:00:00.000,2021-09-16 10:11:33.897
12759,3,224,강원,0,0,0,5025,2020-10-10 09:00:00.000,2021-09-16 10:11:33.897
12760,1,178,충북,0,0,0,5024,2020-10-10 09:00:00.000,2021-09-16 10:11:33.897
12761,6,494,충남,3,1,2,5023,2020-10-10 09:00:00.000,2021-09-16 10:11:33.897
12762,0,149,전북,0,0,0,5022,2020-10-10 09:00:00.000,2021-09-16 10:11:33.897
12763,2,176,전남,2,1,1,5021,2020-10-10 09:00:00.000,2021-09-16 10:11:33.897
12764,56,1568,경북,0,0,0,5020,2020-10-10 09:00:00.000,2021-09-16 10:11:33.897
12765,0,296,경남,0,0,0,5019,2020-10-10 09:00:00.000,2021-09-16 10:11:33.897
12766,0,59,제주,0,0,0,5018,2020-10-10 09:00:00.000,2021-09-16 10:11:33.897
12767,0,1574,검역,5,0,5,5017,2020-10-10 09:00:00.000,2021-09-16 10:11:33.897
12768,428,24475,합계,54,38,16,5016,2020-10-09 09:00:00.000,2021-09-16 10:11:33.897
12769,62,5485,서울,22,17,5,5015,2020-10-09 09:00:00.000,2021-09-16 10:11:33.897
12770,4,478,부산,5,5,0,5014,2020-10-09 09:00:00.000,2021-09-16 10:11:33.897
12771,196,7138,대구,1,0,1,5013,2020-10-09 09:00:00.000,2021-09-16 10:11:33.897
12772,8,956,인천,0,0,0,5012,2020-10-09 09:00:00.000,2021-09-16 10:11:33.897
12773,3,496,광주,0,0,0,5011,2020-10-09 09:00:00.000,2021-09-16 10:11:33.897
12774,5,382,대전,5,5,0,5010,2020-10-09 09:00:00.000,2021-09-16 10:11:33.897
12775,2,154,울산,0,0,0,5009,2020-10-09 09:00:00.000,2021-09-16 10:11:33.897
12776,0,78,세종,0,0,0,5008,2020-10-09 09:00:00.000,2021-09-16 10:11:33.897
12777,80,4600,경기,12,9,3,5007,2020-10-09 09:00:00.000,2021-09-16 10:11:33.897
12778,3,224,강원,0,0,0,5006,2020-10-09 09:00:00.000,2021-09-16 10:11:33.897
12779,1,178,충북,1,1,0,5005,2020-10-09 09:00:00.000,2021-09-16 10:11:33.897
12780,6,491,충남,0,0,0,5004,2020-10-09 09:00:00.000,2021-09-16 10:11:33.897
12781,0,149,전북,0,0,0,5003,2020-10-09 09:00:00.000,2021-09-16 10:11:33.897
12782,2,174,전남,1,1,0,5002,2020-10-09 09:00:00.000,2021-09-16 10:11:33.897
12783,56,1568,경북,0,0,0,5001,2020-10-09 09:00:00.000,2021-09-16 10:11:33.897
12784,0,296,경남,1,0,1,5000,2020-10-09 09:00:00.000,2021-09-16 10:11:33.897
12785,0,59,제주,0,0,0,4999,2020-10-09 09:00:00.000,2021-09-16 10:11:33.897
12786,0,1569,검역,6,0,6,4998,2020-10-09 09:00:00.000,2021-09-16 10:11:33.897
12787,427,24421,합계,69,60,9,4997,2020-10-08 09:00:00.000,2021-09-16 10:11:33.897
12788,62,5463,서울,20,19,1,4996,2020-10-08 09:00:00.000,2021-09-16 10:11:33.897
12789,4,473,부산,5,5,0,4995,2020-10-08 09:00:00.000,2021-09-16 10:11:33.897
12790,196,7137,대구,0,0,0,4994,2020-10-08 09:00:00.000,2021-09-16 10:11:33.897
12791,8,956,인천,5,5,0,4993,2020-10-08 09:00:00.000,2021-09-16 10:11:33.897
12792,3,496,광주,0,0,0,4992,2020-10-08 09:00:00.000,2021-09-16 10:11:33.897
12793,4,377,대전,7,7,0,4991,2020-10-08 09:00:00.000,2021-09-16 10:11:33.897
12794,2,154,울산,0,0,0,4990,2020-10-08 09:00:00.000,2021-09-16 10:11:33.897
12795,0,78,세종,0,0,0,4989,2020-10-08 09:00:00.000,2021-09-16 10:11:33.897
12796,80,4588,경기,24,22,2,4988,2020-10-08 09:00:00.000,2021-09-16 10:11:33.897
12797,3,224,강원,0,0,0,4987,2020-10-08 09:00:00.000,2021-09-16 10:11:33.897
12798,1,177,충북,1,0,1,4986,2020-10-08 09:00:00.000,2021-09-16 10:11:33.897
12799,6,491,충남,0,0,0,4985,2020-10-08 09:00:00.000,2021-09-16 10:11:33.897
12800,0,149,전북,0,0,0,4984,2020-10-08 09:00:00.000,2021-09-16 10:11:33.897
12801,2,173,전남,0,0,0,4983,2020-10-08 09:00:00.000,2021-09-16 10:11:33.897
12802,56,1568,경북,1,1,0,4982,2020-10-08 09:00:00.000,2021-09-16 10:11:33.897
12803,0,295,경남,3,1,2,4981,2020-10-08 09:00:00.000,2021-09-16 10:11:33.897
12804,0,59,제주,0,0,0,4980,2020-10-08 09:00:00.000,2021-09-16 10:11:33.897
12805,0,1563,검역,3,0,3,4979,2020-10-08 09:00:00.000,2021-09-16 10:11:33.897
12806,425,24352,합계,114,94,20,4978,2020-10-07 09:00:00.000,2021-09-16 10:11:33.897
12807,61,5443,서울,33,29,4,4977,2020-10-07 09:00:00.000,2021-09-16 10:11:33.897
12808,4,468,부산,2,2,0,4976,2020-10-07 09:00:00.000,2021-09-16 10:11:33.897
12809,196,7137,대구,1,1,0,4975,2020-10-07 09:00:00.000,2021-09-16 10:11:33.897
12810,8,951,인천,6,5,1,4974,2020-10-07 09:00:00.000,2021-09-16 10:11:33.897
12811,3,496,광주,0,0,0,4973,2020-10-07 09:00:00.000,2021-09-16 10:11:33.897
12812,4,370,대전,2,2,0,4972,2020-10-07 09:00:00.000,2021-09-16 10:11:33.897
12813,2,154,울산,1,0,1,4971,2020-10-07 09:00:00.000,2021-09-16 10:11:33.897
12814,0,78,세종,1,0,1,4970,2020-10-07 09:00:00.000,2021-09-16 10:11:33.897
12815,79,4564,경기,53,49,4,4969,2020-10-07 09:00:00.000,2021-09-16 10:11:33.897
12816,3,224,강원,0,0,0,4968,2020-10-07 09:00:00.000,2021-09-16 10:11:33.897
12817,1,176,충북,0,0,0,4967,2020-10-07 09:00:00.000,2021-09-16 10:11:33.897
12818,6,491,충남,0,0,0,4966,2020-10-07 09:00:00.000,2021-09-16 10:11:33.897
12819,0,149,전북,8,6,2,4965,2020-10-07 09:00:00.000,2021-09-16 10:11:33.897
12820,2,173,전남,0,0,0,4964,2020-10-07 09:00:00.000,2021-09-16 10:11:33.897
12821,56,1567,경북,0,0,0,4963,2020-10-07 09:00:00.000,2021-09-16 10:11:33.897
12822,0,292,경남,0,0,0,4962,2020-10-07 09:00:00.000,2021-09-16 10:11:33.897
12823,0,59,제주,0,0,0,4961,2020-10-07 09:00:00.000,2021-09-16 10:11:33.897
12824,0,1560,검역,7,0,7,4960,2020-10-07 09:00:00.000,2021-09-16 10:11:33.897
12825,422,24238,합계,75,66,9,4959,2020-10-06 09:00:00.000,2021-09-16 10:11:33.897
12826,61,5410,서울,15,13,2,4958,2020-10-06 09:00:00.000,2021-09-16 10:11:33.897
12827,4,466,부산,3,3,0,4957,2020-10-06 09:00:00.000,2021-09-16 10:11:33.897
12828,195,7136,대구,0,0,0,4956,2020-10-06 09:00:00.000,2021-09-16 10:11:33.897
12829,8,945,인천,4,4,0,4955,2020-10-06 09:00:00.000,2021-09-16 10:11:33.897
12830,3,496,광주,0,0,0,4954,2020-10-06 09:00:00.000,2021-09-16 10:11:33.897
12831,4,368,대전,3,2,1,4953,2020-10-06 09:00:00.000,2021-09-16 10:11:33.897
12832,2,153,울산,1,1,0,4952,2020-10-06 09:00:00.000,2021-09-16 10:11:33.897
12833,0,77,세종,0,0,0,4951,2020-10-06 09:00:00.000,2021-09-16 10:11:33.897
12834,77,4511,경기,35,34,1,4950,2020-10-06 09:00:00.000,2021-09-16 10:11:33.897
12835,3,224,강원,0,0,0,4949,2020-10-06 09:00:00.000,2021-09-16 10:11:33.897
12836,1,176,충북,0,0,0,4948,2020-10-06 09:00:00.000,2021-09-16 10:11:33.897
12837,6,491,충남,0,0,0,4947,2020-10-06 09:00:00.000,2021-09-16 10:11:33.897
12838,0,141,전북,9,9,0,4946,2020-10-06 09:00:00.000,2021-09-16 10:11:33.897
12839,2,173,전남,0,0,0,4945,2020-10-06 09:00:00.000,2021-09-16 10:11:33.897
12840,56,1567,경북,0,0,0,4944,2020-10-06 09:00:00.000,2021-09-16 10:11:33.897
12841,0,292,경남,0,0,0,4943,2020-10-06 09:00:00.000,2021-09-16 10:11:33.897
12842,0,59,제주,0,0,0,4942,2020-10-06 09:00:00.000,2021-09-16 10:11:33.897
12843,0,1553,검역,5,0,5,4941,2020-10-06 09:00:00.000,2021-09-16 10:11:33.897
12844,422,24163,합계,73,64,9,4940,2020-10-05 09:00:00.000,2021-09-16 10:11:33.897
12845,61,5395,서울,19,19,0,4939,2020-10-05 09:00:00.000,2021-09-16 10:11:33.897
12846,4,463,부산,5,5,0,4938,2020-10-05 09:00:00.000,2021-09-16 10:11:33.897
12847,195,7136,대구,1,0,1,4937,2020-10-05 09:00:00.000,2021-09-16 10:11:33.897
12848,8,941,인천,5,5,0,4936,2020-10-05 09:00:00.000,2021-09-16 10:11:33.897
12849,3,496,광주,0,0,0,4935,2020-10-05 09:00:00.000,2021-09-16 10:11:33.897
12850,4,365,대전,1,1,0,4934,2020-10-05 09:00:00.000,2021-09-16 10:11:33.897
12851,2,152,울산,4,4,0,4933,2020-10-05 09:00:00.000,2021-09-16 10:11:33.897
12852,0,77,세종,1,0,1,4932,2020-10-05 09:00:00.000,2021-09-16 10:11:33.897
12853,77,4476,경기,27,25,2,4931,2020-10-05 09:00:00.000,2021-09-16 10:11:33.897
12854,3,224,강원,0,0,0,4930,2020-10-05 09:00:00.000,2021-09-16 10:11:33.897
12855,1,176,충북,1,0,1,4929,2020-10-05 09:00:00.000,2021-09-16 10:11:33.897
12856,6,491,충남,2,2,0,4928,2020-10-05 09:00:00.000,2021-09-16 10:11:33.897
12857,0,132,전북,3,2,1,4927,2020-10-05 09:00:00.000,2021-09-16 10:11:33.897
12858,2,173,전남,0,0,0,4926,2020-10-05 09:00:00.000,2021-09-16 10:11:33.897
12859,56,1567,경북,1,1,0,4925,2020-10-05 09:00:00.000,2021-09-16 10:11:33.897
12860,0,292,경남,1,0,1,4924,2020-10-05 09:00:00.000,2021-09-16 10:11:33.897
12861,0,59,제주,0,0,0,4923,2020-10-05 09:00:00.000,2021-09-16 10:11:33.897
12862,0,1548,검역,2,0,2,4922,2020-10-05 09:00:00.000,2021-09-16 10:11:33.897
12863,421,24090,합계,64,47,17,4921,2020-10-04 09:00:00.000,2021-09-16 10:11:33.897
12864,60,5376,서울,16,16,0,4920,2020-10-04 09:00:00.000,2021-09-16 10:11:33.897
12865,4,458,부산,5,5,0,4919,2020-10-04 09:00:00.000,2021-09-16 10:11:33.897
12866,195,7135,대구,2,0,2,4918,2020-10-04 09:00:00.000,2021-09-16 10:11:33.897
12867,8,936,인천,6,5,1,4917,2020-10-04 09:00:00.000,2021-09-16 10:11:33.897
12868,3,496,광주,1,0,1,4916,2020-10-04 09:00:00.000,2021-09-16 10:11:33.897
12869,4,364,대전,2,2,0,4915,2020-10-04 09:00:00.000,2021-09-16 10:11:33.897
12870,2,148,울산,1,1,0,4914,2020-10-04 09:00:00.000,2021-09-16 10:11:33.897
12871,0,76,세종,0,0,0,4913,2020-10-04 09:00:00.000,2021-09-16 10:11:33.897
12872,77,4449,경기,16,14,2,4912,2020-10-04 09:00:00.000,2021-09-16 10:11:33.897
12873,3,224,강원,0,0,0,4911,2020-10-04 09:00:00.000,2021-09-16 10:11:33.897
12874,1,175,충북,2,1,1,4910,2020-10-04 09:00:00.000,2021-09-16 10:11:33.897
12875,6,489,충남,0,0,0,4909,2020-10-04 09:00:00.000,2021-09-16 10:11:33.897
12876,0,129,전북,0,0,0,4908,2020-10-04 09:00:00.000,2021-09-16 10:11:33.897
12877,2,173,전남,0,0,0,4907,2020-10-04 09:00:00.000,2021-09-16 10:11:33.897
12878,56,1566,경북,4,3,1,4906,2020-10-04 09:00:00.000,2021-09-16 10:11:33.897
12879,0,291,경남,0,0,0,4905,2020-10-04 09:00:00.000,2021-09-16 10:11:33.897
12880,0,59,제주,0,0,0,4904,2020-10-04 09:00:00.000,2021-09-16 10:11:33.897
12881,0,1546,검역,9,0,9,4903,2020-10-04 09:00:00.000,2021-09-16 10:11:33.897
12882,420,24026,합계,75,52,23,4902,2020-10-03 09:00:00.000,2021-09-16 10:11:33.897
12883,59,5360,서울,26,25,1,4901,2020-10-03 09:00:00.000,2021-09-16 10:11:33.897
12884,4,453,부산,8,8,0,4900,2020-10-03 09:00:00.000,2021-09-16 10:11:33.897
12885,195,7133,대구,0,0,0,4899,2020-10-03 09:00:00.000,2021-09-16 10:11:33.897
12886,8,930,인천,7,7,0,4898,2020-10-03 09:00:00.000,2021-09-16 10:11:33.897
12887,3,495,광주,0,0,0,4897,2020-10-03 09:00:00.000,2021-09-16 10:11:33.897
12888,4,362,대전,2,1,1,4896,2020-10-03 09:00:00.000,2021-09-16 10:11:33.897
12889,2,147,울산,0,0,0,4895,2020-10-03 09:00:00.000,2021-09-16 10:11:33.897
12890,0,76,세종,0,0,0,4894,2020-10-03 09:00:00.000,2021-09-16 10:11:33.897
12891,77,4433,경기,10,8,2,4893,2020-10-03 09:00:00.000,2021-09-16 10:11:33.897
12892,3,224,강원,0,0,0,4892,2020-10-03 09:00:00.000,2021-09-16 10:11:33.897
12893,1,173,충북,1,0,1,4891,2020-10-03 09:00:00.000,2021-09-16 10:11:33.897
12894,6,489,충남,1,1,0,4890,2020-10-03 09:00:00.000,2021-09-16 10:11:33.897
12895,0,129,전북,1,0,1,4889,2020-10-03 09:00:00.000,2021-09-16 10:11:33.897
12896,2,173,전남,3,0,3,4888,2020-10-03 09:00:00.000,2021-09-16 10:11:33.897
12897,56,1562,경북,2,2,0,4887,2020-10-03 09:00:00.000,2021-09-16 10:11:33.897
12898,0,291,경남,0,0,0,4886,2020-10-03 09:00:00.000,2021-09-16 10:11:33.897
12899,0,59,제주,0,0,0,4885,2020-10-03 09:00:00.000,2021-09-16 10:11:33.897
12900,0,1537,검역,14,0,14,4884,2020-10-03 09:00:00.000,2021-09-16 10:11:33.897
12901,416,23951,합계,63,53,10,4883,2020-10-02 09:00:00.000,2021-09-16 10:11:33.897
12902,57,5334,서울,11,9,2,4882,2020-10-02 09:00:00.000,2021-09-16 10:11:33.897
12903,4,445,부산,18,16,2,4881,2020-10-02 09:00:00.000,2021-09-16 10:11:33.897
12904,195,7133,대구,0,0,0,4880,2020-10-02 09:00:00.000,2021-09-16 10:11:33.897
12905,8,923,인천,4,4,0,4879,2020-10-02 09:00:00.000,2021-09-16 10:11:33.897
12906,3,495,광주,0,0,0,4878,2020-10-02 09:00:00.000,2021-09-16 10:11:33.897
12907,4,360,대전,0,0,0,4877,2020-10-02 09:00:00.000,2021-09-16 10:11:33.897
12908,2,147,울산,0,0,0,4876,2020-10-02 09:00:00.000,2021-09-16 10:11:33.897
12909,0,76,세종,0,0,0,4875,2020-10-02 09:00:00.000,2021-09-16 10:11:33.897
12910,75,4423,경기,19,19,0,4874,2020-10-02 09:00:00.000,2021-09-16 10:11:33.897
12911,3,224,강원,0,0,0,4873,2020-10-02 09:00:00.000,2021-09-16 10:11:33.897
12912,1,172,충북,0,0,0,4872,2020-10-02 09:00:00.000,2021-09-16 10:11:33.897
12913,6,488,충남,1,1,0,4871,2020-10-02 09:00:00.000,2021-09-16 10:11:33.897
12914,0,128,전북,0,0,0,4870,2020-10-02 09:00:00.000,2021-09-16 10:11:33.897
12915,2,170,전남,0,0,0,4869,2020-10-02 09:00:00.000,2021-09-16 10:11:33.897
12916,56,1560,경북,4,4,0,4868,2020-10-02 09:00:00.000,2021-09-16 10:11:33.897
12917,0,291,경남,0,0,0,4867,2020-10-02 09:00:00.000,2021-09-16 10:11:33.897
12918,0,59,제주,0,0,0,4866,2020-10-02 09:00:00.000,2021-09-16 10:11:33.897
12919,0,1523,검역,6,0,6,4865,2020-10-02 09:00:00.000,2021-09-16 10:11:33.897
12920,415,23888,합계,77,67,10,4864,2020-10-01 09:00:00.000,2021-09-16 10:11:33.897
12921,57,5323,서울,30,30,0,4863,2020-10-01 09:00:00.000,2021-09-16 10:11:33.897
12922,4,427,부산,6,6,0,4862,2020-10-01 09:00:00.000,2021-09-16 10:11:33.897
12923,195,7133,대구,1,1,0,4861,2020-10-01 09:00:00.000,2021-09-16 10:11:33.897
12924,8,919,인천,3,3,0,4860,2020-10-01 09:00:00.000,2021-09-16 10:11:33.897
12925,3,495,광주,0,0,0,4859,2020-10-01 09:00:00.000,2021-09-16 10:11:33.897
12926,4,360,대전,0,0,0,4858,2020-10-01 09:00:00.000,2021-09-16 10:11:33.897
12927,2,147,울산,0,0,0,4857,2020-10-01 09:00:00.000,2021-09-16 10:11:33.897
12928,0,76,세종,0,0,0,4856,2020-10-01 09:00:00.000,2021-09-16 10:11:33.897
12929,74,4404,경기,21,17,4,4855,2020-10-01 09:00:00.000,2021-09-16 10:11:33.897
12930,3,224,강원,0,0,0,4854,2020-10-01 09:00:00.000,2021-09-16 10:11:33.897
12931,1,172,충북,1,1,0,4853,2020-10-01 09:00:00.000,2021-09-16 10:11:33.897
12932,6,487,충남,3,3,0,4852,2020-10-01 09:00:00.000,2021-09-16 10:11:33.897
12933,0,128,전북,0,0,0,4851,2020-10-01 09:00:00.000,2021-09-16 10:11:33.897
12934,2,170,전남,1,1,0,4850,2020-10-01 09:00:00.000,2021-09-16 10:11:33.897
12935,56,1556,경북,5,5,0,4849,2020-10-01 09:00:00.000,2021-09-16 10:11:33.897
12936,0,291,경남,0,0,0,4848,2020-10-01 09:00:00.000,2021-09-16 10:11:33.897
12937,0,59,제주,0,0,0,4847,2020-10-01 09:00:00.000,2021-09-16 10:11:33.897
12938,0,1517,검역,6,0,6,4846,2020-10-01 09:00:00.000,2021-09-16 10:11:33.897
12939,413,23811,합계,113,94,19,4845,2020-09-30 09:00:00.000,2021-09-16 10:11:33.897
12940,56,5293,서울,51,51,0,4844,2020-09-30 09:00:00.000,2021-09-16 10:11:33.897
12941,4,421,부산,5,5,0,4843,2020-09-30 09:00:00.000,2021-09-16 10:11:33.897
12942,194,7132,대구,2,1,1,4842,2020-09-30 09:00:00.000,2021-09-16 10:11:33.897
12943,8,916,인천,4,4,0,4841,2020-09-30 09:00:00.000,2021-09-16 10:11:33.897
12944,3,495,광주,3,3,0,4840,2020-09-30 09:00:00.000,2021-09-16 10:11:33.897
12945,4,360,대전,2,0,2,4839,2020-09-30 09:00:00.000,2021-09-16 10:11:33.897
12946,2,147,울산,1,1,0,4838,2020-09-30 09:00:00.000,2021-09-16 10:11:33.897
12947,0,76,세종,0,0,0,4837,2020-09-30 09:00:00.000,2021-09-16 10:11:33.897
12948,74,4383,경기,26,21,5,4836,2020-09-30 09:00:00.000,2021-09-16 10:11:33.897
12949,3,224,강원,0,0,0,4835,2020-09-30 09:00:00.000,2021-09-16 10:11:33.897
12950,1,171,충북,0,0,0,4834,2020-09-30 09:00:00.000,2021-09-16 10:11:33.897
12951,6,484,충남,5,1,4,4833,2020-09-30 09:00:00.000,2021-09-16 10:11:33.897
12952,0,128,전북,3,2,1,4832,2020-09-30 09:00:00.000,2021-09-16 10:11:33.897
12953,2,169,전남,0,0,0,4831,2020-09-30 09:00:00.000,2021-09-16 10:11:33.897
12954,56,1551,경북,6,5,1,4830,2020-09-30 09:00:00.000,2021-09-16 10:11:33.897
12955,0,291,경남,0,0,0,4829,2020-09-30 09:00:00.000,2021-09-16 10:11:33.897
12956,0,59,제주,0,0,0,4828,2020-09-30 09:00:00.000,2021-09-16 10:11:33.897
12957,0,1511,검역,5,0,5,4827,2020-09-30 09:00:00.000,2021-09-16 10:11:33.897
12958,407,23698,합계,38,23,15,4826,2020-09-29 09:00:00.000,2021-09-16 10:11:33.897
12959,54,5242,서울,11,11,0,4825,2020-09-29 09:00:00.000,2021-09-16 10:11:33.897
12960,4,416,부산,3,3,0,4824,2020-09-29 09:00:00.000,2021-09-16 10:11:33.897
12961,194,7130,대구,0,0,0,4823,2020-09-29 09:00:00.000,2021-09-16 10:11:33.897
12962,8,912,인천,0,0,0,4822,2020-09-29 09:00:00.000,2021-09-16 10:11:33.897
12963,3,492,광주,0,0,0,4821,2020-09-29 09:00:00.000,2021-09-16 10:11:33.897
12964,4,358,대전,0,0,0,4820,2020-09-29 09:00:00.000,2021-09-16 10:11:33.897
12965,2,146,울산,0,0,0,4819,2020-09-29 09:00:00.000,2021-09-16 10:11:33.897
12966,0,76,세종,0,0,0,4818,2020-09-29 09:00:00.000,2021-09-16 10:11:33.897
12967,73,4357,경기,10,6,4,4817,2020-09-29 09:00:00.000,2021-09-16 10:11:33.897
12968,3,224,강원,0,0,0,4816,2020-09-29 09:00:00.000,2021-09-16 10:11:33.897
12969,1,171,충북,1,1,0,4815,2020-09-29 09:00:00.000,2021-09-16 10:11:33.897
12970,5,479,충남,2,0,2,4814,2020-09-29 09:00:00.000,2021-09-16 10:11:33.897
12971,0,125,전북,0,0,0,4813,2020-09-29 09:00:00.000,2021-09-16 10:11:33.897
12972,1,169,전남,0,0,0,4812,2020-09-29 09:00:00.000,2021-09-16 10:11:33.897
12973,55,1545,경북,2,2,0,4811,2020-09-29 09:00:00.000,2021-09-16 10:11:33.897
12974,0,291,경남,0,0,0,4810,2020-09-29 09:00:00.000,2021-09-16 10:11:33.897
12975,0,59,제주,0,0,0,4809,2020-09-29 09:00:00.000,2021-09-16 10:11:33.897
12976,0,1506,검역,9,0,9,4808,2020-09-29 09:00:00.000,2021-09-16 10:11:33.897
12977,406,23660,합계,50,40,10,4807,2020-09-28 09:00:00.000,2021-09-16 10:11:33.897
12978,54,5231,서울,19,19,0,4806,2020-09-28 09:00:00.000,2021-09-16 10:11:33.897
12979,4,413,부산,1,1,0,4805,2020-09-28 09:00:00.000,2021-09-16 10:11:33.897
12980,194,7130,대구,0,0,0,4804,2020-09-28 09:00:00.000,2021-09-16 10:11:33.897
12981,8,912,인천,1,1,0,4803,2020-09-28 09:00:00.000,2021-09-16 10:11:33.897
12982,3,492,광주,0,0,0,4802,2020-09-28 09:00:00.000,2021-09-16 10:11:33.897
12983,4,358,대전,0,0,0,4801,2020-09-28 09:00:00.000,2021-09-16 10:11:33.897
12984,2,146,울산,1,1,0,4800,2020-09-28 09:00:00.000,2021-09-16 10:11:33.897
12985,0,76,세종,0,0,0,4799,2020-09-28 09:00:00.000,2021-09-16 10:11:33.897
12986,72,4347,경기,14,13,1,4798,2020-09-28 09:00:00.000,2021-09-16 10:11:33.897
12987,3,224,강원,1,1,0,4797,2020-09-28 09:00:00.000,2021-09-16 10:11:33.897
12988,1,170,충북,1,1,0,4796,2020-09-28 09:00:00.000,2021-09-16 10:11:33.897
12989,5,477,충남,0,0,0,4795,2020-09-28 09:00:00.000,2021-09-16 10:11:33.897
12990,0,125,전북,0,0,0,4794,2020-09-28 09:00:00.000,2021-09-16 10:11:33.897
12991,1,169,전남,0,0,0,4793,2020-09-28 09:00:00.000,2021-09-16 10:11:33.897
12992,55,1543,경북,4,3,1,4792,2020-09-28 09:00:00.000,2021-09-16 10:11:33.897
12993,0,291,경남,1,0,1,4791,2020-09-28 09:00:00.000,2021-09-16 10:11:33.897
12994,0,59,제주,0,0,0,4790,2020-09-28 09:00:00.000,2021-09-16 10:11:33.897
12995,0,1497,검역,7,0,7,4789,2020-09-28 09:00:00.000,2021-09-16 10:11:33.897
12996,401,23610,합계,95,73,22,4788,2020-09-27 09:00:00.000,2021-09-16 10:11:33.897
12997,53,5212,서울,34,33,1,4787,2020-09-27 09:00:00.000,2021-09-16 10:11:33.897
12998,4,412,부산,3,3,0,4786,2020-09-27 09:00:00.000,2021-09-16 10:11:33.897
12999,194,7130,대구,0,0,0,4785,2020-09-27 09:00:00.000,2021-09-16 10:11:33.897
13000,8,911,인천,9,9,0,4784,2020-09-27 09:00:00.000,2021-09-16 10:11:33.897
13001,3,492,광주,2,0,2,4783,2020-09-27 09:00:00.000,2021-09-16 10:11:33.897
13002,3,358,대전,0,0,0,4782,2020-09-27 09:00:00.000,2021-09-16 10:11:33.897
13003,2,145,울산,0,0,0,4781,2020-09-27 09:00:00.000,2021-09-16 10:11:33.897
13004,0,76,세종,1,0,1,4780,2020-09-27 09:00:00.000,2021-09-16 10:11:33.897
13005,70,4333,경기,21,18,3,4779,2020-09-27 09:00:00.000,2021-09-16 10:11:33.897
13006,3,223,강원,0,0,0,4778,2020-09-27 09:00:00.000,2021-09-16 10:11:33.897
13007,1,169,충북,2,2,0,4777,2020-09-27 09:00:00.000,2021-09-16 10:11:33.897
13008,4,477,충남,2,1,1,4776,2020-09-27 09:00:00.000,2021-09-16 10:11:33.897
13009,0,125,전북,2,1,1,4775,2020-09-27 09:00:00.000,2021-09-16 10:11:33.897
13010,1,169,전남,1,0,1,4774,2020-09-27 09:00:00.000,2021-09-16 10:11:33.897
13011,55,1539,경북,6,6,0,4773,2020-09-27 09:00:00.000,2021-09-16 10:11:33.897
13012,0,290,경남,1,0,1,4772,2020-09-27 09:00:00.000,2021-09-16 10:11:33.897
13013,0,59,제주,0,0,0,4771,2020-09-27 09:00:00.000,2021-09-16 10:11:33.897
13014,0,1490,검역,11,0,11,4770,2020-09-27 09:00:00.000,2021-09-16 10:11:33.897
13015,399,23515,합계,61,49,12,4769,2020-09-26 09:00:00.000,2021-09-16 10:11:33.897
13016,53,5178,서울,26,25,1,4768,2020-09-26 09:00:00.000,2021-09-16 10:11:33.897
13017,4,409,부산,2,2,0,4767,2020-09-26 09:00:00.000,2021-09-16 10:11:33.897
13018,194,7130,대구,1,1,0,4766,2020-09-26 09:00:00.000,2021-09-16 10:11:33.897
13019,8,902,인천,1,1,0,4765,2020-09-26 09:00:00.000,2021-09-16 10:11:33.897
13020,3,490,광주,0,0,0,4764,2020-09-26 09:00:00.000,2021-09-16 10:11:33.897
13021,3,358,대전,1,0,1,4763,2020-09-26 09:00:00.000,2021-09-16 10:11:33.897
13022,2,145,울산,0,0,0,4762,2020-09-26 09:00:00.000,2021-09-16 10:11:33.897
13023,0,75,세종,0,0,0,4761,2020-09-26 09:00:00.000,2021-09-16 10:11:33.897
13024,69,4312,경기,14,13,1,4760,2020-09-26 09:00:00.000,2021-09-16 10:11:33.897
13025,3,223,강원,0,0,0,4759,2020-09-26 09:00:00.000,2021-09-16 10:11:33.897
13026,1,167,충북,0,0,0,4758,2020-09-26 09:00:00.000,2021-09-16 10:11:33.897
13027,4,475,충남,0,0,0,4757,2020-09-26 09:00:00.000,2021-09-16 10:11:33.897
13028,0,123,전북,3,3,0,4756,2020-09-26 09:00:00.000,2021-09-16 10:11:33.897
13029,0,168,전남,0,0,0,4755,2020-09-26 09:00:00.000,2021-09-16 10:11:33.897
13030,55,1533,경북,3,3,0,4754,2020-09-26 09:00:00.000,2021-09-16 10:11:33.897
13031,0,289,경남,1,1,0,4753,2020-09-26 09:00:00.000,2021-09-16 10:11:33.897
13032,0,59,제주,0,0,0,4752,2020-09-26 09:00:00.000,2021-09-16 10:11:33.897
13033,0,1479,검역,9,0,9,4751,2020-09-26 09:00:00.000,2021-09-16 10:11:33.897
13034,395,23454,합계,114,95,19,4750,2020-09-25 09:00:00.000,2021-09-16 10:11:33.897
13035,52,5152,서울,57,56,1,4749,2020-09-25 09:00:00.000,2021-09-16 10:11:33.897
13036,4,407,부산,3,2,1,4748,2020-09-25 09:00:00.000,2021-09-16 10:11:33.897
13037,193,7129,대구,0,0,0,4747,2020-09-25 09:00:00.000,2021-09-16 10:11:33.897
13038,8,901,인천,3,1,2,4746,2020-09-25 09:00:00.000,2021-09-16 10:11:33.897
13039,3,490,광주,2,0,2,4745,2020-09-25 09:00:00.000,2021-09-16 10:11:33.897
13040,3,357,대전,0,0,0,4744,2020-09-25 09:00:00.000,2021-09-16 10:11:33.897
13041,2,145,울산,0,0,0,4743,2020-09-25 09:00:00.000,2021-09-16 10:11:33.897
13042,0,75,세종,1,0,1,4742,2020-09-25 09:00:00.000,2021-09-16 10:11:33.897
13043,68,4298,경기,27,26,1,4741,2020-09-25 09:00:00.000,2021-09-16 10:11:33.897
13044,3,223,강원,1,1,0,4740,2020-09-25 09:00:00.000,2021-09-16 10:11:33.897
13045,1,167,충북,3,1,2,4739,2020-09-25 09:00:00.000,2021-09-16 10:11:33.897
13046,3,475,충남,1,0,1,4738,2020-09-25 09:00:00.000,2021-09-16 10:11:33.897
13047,0,120,전북,3,3,0,4737,2020-09-25 09:00:00.000,2021-09-16 10:11:33.897
13048,0,168,전남,0,0,0,4736,2020-09-25 09:00:00.000,2021-09-16 10:11:33.897
13049,55,1530,경북,6,4,2,4735,2020-09-25 09:00:00.000,2021-09-16 10:11:33.897
13050,0,288,경남,1,1,0,4734,2020-09-25 09:00:00.000,2021-09-16 10:11:33.897
13051,0,59,제주,0,0,0,4733,2020-09-25 09:00:00.000,2021-09-16 10:11:33.897
13052,0,1470,검역,6,0,6,4732,2020-09-25 09:00:00.000,2021-09-16 10:11:33.897
13053,393,23340,합계,125,109,16,4731,2020-09-24 09:00:00.000,2021-09-16 10:11:33.897
13054,50,5095,서울,39,39,0,4730,2020-09-24 09:00:00.000,2021-09-16 10:11:33.897
13055,4,404,부산,7,7,0,4729,2020-09-24 09:00:00.000,2021-09-16 10:11:33.897
13056,193,7129,대구,1,1,0,4728,2020-09-24 09:00:00.000,2021-09-16 10:11:33.897
13057,8,898,인천,10,10,0,4727,2020-09-24 09:00:00.000,2021-09-16 10:11:33.897
13058,3,488,광주,0,0,0,4726,2020-09-24 09:00:00.000,2021-09-16 10:11:33.897
13059,3,357,대전,1,1,0,4725,2020-09-24 09:00:00.000,2021-09-16 10:11:33.897
13060,2,145,울산,0,0,0,4724,2020-09-24 09:00:00.000,2021-09-16 10:11:33.897
13061,0,74,세종,3,0,3,4723,2020-09-24 09:00:00.000,2021-09-16 10:11:33.897
13062,68,4271,경기,48,43,5,4722,2020-09-24 09:00:00.000,2021-09-16 10:11:33.897
13063,3,222,강원,2,2,0,4721,2020-09-24 09:00:00.000,2021-09-16 10:11:33.897
13064,1,164,충북,2,1,1,4720,2020-09-24 09:00:00.000,2021-09-16 10:11:33.897
13065,3,474,충남,1,1,0,4719,2020-09-24 09:00:00.000,2021-09-16 10:11:33.897
13066,0,117,전북,1,1,0,4718,2020-09-24 09:00:00.000,2021-09-16 10:11:33.897
13067,0,168,전남,1,0,1,4717,2020-09-24 09:00:00.000,2021-09-16 10:11:33.897
13068,55,1524,경북,2,2,0,4716,2020-09-24 09:00:00.000,2021-09-16 10:11:33.897
13069,0,287,경남,1,1,0,4715,2020-09-24 09:00:00.000,2021-09-16 10:11:33.897
13070,0,59,제주,1,0,1,4714,2020-09-24 09:00:00.000,2021-09-16 10:11:33.897
13071,0,1464,검역,5,0,5,4713,2020-09-24 09:00:00.000,2021-09-16 10:11:33.897
13072,388,23215,합계,110,99,11,4712,2020-09-23 09:00:00.000,2021-09-16 10:11:33.897
13073,49,5056,서울,40,40,0,4711,2020-09-23 09:00:00.000,2021-09-16 10:11:33.897
13074,4,397,부산,7,6,1,4710,2020-09-23 09:00:00.000,2021-09-16 10:11:33.897
13075,193,7128,대구,3,3,0,4709,2020-09-23 09:00:00.000,2021-09-16 10:11:33.897
13076,8,888,인천,5,5,0,4708,2020-09-23 09:00:00.000,2021-09-16 10:11:33.897
13077,3,488,광주,2,2,0,4707,2020-09-23 09:00:00.000,2021-09-16 10:11:33.897
13078,3,356,대전,0,0,0,4706,2020-09-23 09:00:00.000,2021-09-16 10:11:33.897
13079,2,145,울산,2,2,0,4705,2020-09-23 09:00:00.000,2021-09-16 10:11:33.897
13080,0,71,세종,0,0,0,4704,2020-09-23 09:00:00.000,2021-09-16 10:11:33.897
13081,65,4223,경기,30,28,2,4703,2020-09-23 09:00:00.000,2021-09-16 10:11:33.897
13082,3,220,강원,1,1,0,4702,2020-09-23 09:00:00.000,2021-09-16 10:11:33.897
13083,1,162,충북,2,2,0,4701,2020-09-23 09:00:00.000,2021-09-16 10:11:33.897
13084,2,473,충남,5,4,1,4700,2020-09-23 09:00:00.000,2021-09-16 10:11:33.897
13085,0,116,전북,1,0,1,4699,2020-09-23 09:00:00.000,2021-09-16 10:11:33.897
13086,0,167,전남,0,0,0,4698,2020-09-23 09:00:00.000,2021-09-16 10:11:33.897
13087,55,1522,경북,6,6,0,4697,2020-09-23 09:00:00.000,2021-09-16 10:11:33.897
13088,0,286,경남,0,0,0,4696,2020-09-23 09:00:00.000,2021-09-16 10:11:33.897
13089,0,58,제주,0,0,0,4695,2020-09-23 09:00:00.000,2021-09-16 10:11:33.897
13090,0,1459,검역,6,0,6,4694,2020-09-23 09:00:00.000,2021-09-16 10:11:33.897
13091,388,23105,합계,61,50,11,4693,2020-09-22 09:00:00.000,2021-09-16 10:11:33.897
13092,49,5016,서울,21,19,2,4692,2020-09-22 09:00:00.000,2021-09-16 10:11:33.897
13093,4,390,부산,5,5,0,4691,2020-09-22 09:00:00.000,2021-09-16 10:11:33.897
13094,193,7125,대구,0,0,0,4690,2020-09-22 09:00:00.000,2021-09-16 10:11:33.897
13095,8,883,인천,2,2,0,4689,2020-09-22 09:00:00.000,2021-09-16 10:11:33.897
13096,3,486,광주,0,0,0,4688,2020-09-22 09:00:00.000,2021-09-16 10:11:33.897
13097,3,356,대전,0,0,0,4687,2020-09-22 09:00:00.000,2021-09-16 10:11:33.897
13098,2,143,울산,1,1,0,4686,2020-09-22 09:00:00.000,2021-09-16 10:11:33.897
13099,0,71,세종,1,0,1,4685,2020-09-22 09:00:00.000,2021-09-16 10:11:33.897
13100,65,4193,경기,20,14,6,4684,2020-09-22 09:00:00.000,2021-09-16 10:11:33.897
13101,3,219,강원,2,2,0,4683,2020-09-22 09:00:00.000,2021-09-16 10:11:33.897
13102,1,160,충북,2,2,0,4682,2020-09-22 09:00:00.000,2021-09-16 10:11:33.897
13103,2,468,충남,0,0,0,4681,2020-09-22 09:00:00.000,2021-09-16 10:11:33.897
13104,0,115,전북,0,0,0,4680,2020-09-22 09:00:00.000,2021-09-16 10:11:33.897
13105,0,167,전남,0,0,0,4679,2020-09-22 09:00:00.000,2021-09-16 10:11:33.897
13106,55,1516,경북,4,4,0,4678,2020-09-22 09:00:00.000,2021-09-16 10:11:33.897
13107,0,286,경남,1,1,0,4677,2020-09-22 09:00:00.000,2021-09-16 10:11:33.897
13108,0,58,제주,0,0,0,4676,2020-09-22 09:00:00.000,2021-09-16 10:11:33.897
13109,0,1453,검역,2,0,2,4675,2020-09-22 09:00:00.000,2021-09-16 10:11:33.897
13110,385,23044,합계,70,55,15,4674,2020-09-21 09:00:00.000,2021-09-16 10:11:33.897
13111,48,4995,서울,23,21,2,4673,2020-09-21 09:00:00.000,2021-09-16 10:11:33.897
13112,4,385,부산,8,8,0,4672,2020-09-21 09:00:00.000,2021-09-16 10:11:33.897
13113,193,7125,대구,1,0,1,4671,2020-09-21 09:00:00.000,2021-09-16 10:11:33.897
13114,8,881,인천,2,1,1,4670,2020-09-21 09:00:00.000,2021-09-16 10:11:33.897
13115,3,486,광주,1,0,1,4669,2020-09-21 09:00:00.000,2021-09-16 10:11:33.897
13116,3,356,대전,2,2,0,4668,2020-09-21 09:00:00.000,2021-09-16 10:11:33.897
13117,2,142,울산,0,0,0,4667,2020-09-21 09:00:00.000,2021-09-16 10:11:33.897
13118,0,70,세종,0,0,0,4666,2020-09-21 09:00:00.000,2021-09-16 10:11:33.897
13119,63,4173,경기,18,18,0,4665,2020-09-21 09:00:00.000,2021-09-16 10:11:33.897
13120,3,217,강원,0,0,0,4664,2020-09-21 09:00:00.000,2021-09-16 10:11:33.897
13121,1,158,충북,2,2,0,4663,2020-09-21 09:00:00.000,2021-09-16 10:11:33.897
13122,2,468,충남,0,0,0,4662,2020-09-21 09:00:00.000,2021-09-16 10:11:33.897
13123,0,115,전북,0,0,0,4661,2020-09-21 09:00:00.000,2021-09-16 10:11:33.897
13124,0,167,전남,0,0,0,4660,2020-09-21 09:00:00.000,2021-09-16 10:11:33.897
13125,55,1512,경북,1,1,0,4659,2020-09-21 09:00:00.000,2021-09-16 10:11:33.897
13126,0,285,경남,2,2,0,4658,2020-09-21 09:00:00.000,2021-09-16 10:11:33.897
13127,0,58,제주,0,0,0,4657,2020-09-21 09:00:00.000,2021-09-16 10:11:33.897
13128,0,1451,검역,10,0,10,4656,2020-09-21 09:00:00.000,2021-09-16 10:11:33.897
13129,383,22974,합계,82,72,10,4655,2020-09-20 09:00:00.000,2021-09-16 10:11:33.897
13130,47,4972,서울,28,28,0,4654,2020-09-20 09:00:00.000,2021-09-16 10:11:33.897
13131,4,377,부산,6,6,0,4653,2020-09-20 09:00:00.000,2021-09-16 10:11:33.897
13132,193,7124,대구,2,2,0,4652,2020-09-20 09:00:00.000,2021-09-16 10:11:33.897
13133,8,879,인천,3,3,0,4651,2020-09-20 09:00:00.000,2021-09-16 10:11:33.897
13134,3,485,광주,0,0,0,4650,2020-09-20 09:00:00.000,2021-09-16 10:11:33.897
13135,3,354,대전,2,1,1,4649,2020-09-20 09:00:00.000,2021-09-16 10:11:33.897
13136,2,142,울산,1,1,0,4648,2020-09-20 09:00:00.000,2021-09-16 10:11:33.897
13137,0,70,세종,0,0,0,4647,2020-09-20 09:00:00.000,2021-09-16 10:11:33.897
13138,62,4155,경기,26,24,2,4646,2020-09-20 09:00:00.000,2021-09-16 10:11:33.897
13139,3,217,강원,0,0,0,4645,2020-09-20 09:00:00.000,2021-09-16 10:11:33.897
13140,1,156,충북,1,1,0,4644,2020-09-20 09:00:00.000,2021-09-16 10:11:33.897
13141,2,468,충남,1,1,0,4643,2020-09-20 09:00:00.000,2021-09-16 10:11:33.897
13142,0,115,전북,0,0,0,4642,2020-09-20 09:00:00.000,2021-09-16 10:11:33.897
13143,0,167,전남,0,0,0,4641,2020-09-20 09:00:00.000,2021-09-16 10:11:33.897
13144,55,1511,경북,5,4,1,4640,2020-09-20 09:00:00.000,2021-09-16 10:11:33.897
13145,0,283,경남,1,1,0,4639,2020-09-20 09:00:00.000,2021-09-16 10:11:33.897
13146,0,58,제주,0,0,0,4638,2020-09-20 09:00:00.000,2021-09-16 10:11:33.897
13147,0,1441,검역,6,0,6,4637,2020-09-20 09:00:00.000,2021-09-16 10:11:33.897
13148,378,22892,합계,110,106,4,4636,2020-09-19 09:00:00.000,2021-09-16 10:11:33.897
13149,46,4944,서울,40,38,2,4635,2020-09-19 09:00:00.000,2021-09-16 10:11:33.897
13150,4,371,부산,2,2,0,4634,2020-09-19 09:00:00.000,2021-09-16 10:11:33.897
13151,192,7122,대구,2,2,0,4633,2020-09-19 09:00:00.000,2021-09-16 10:11:33.897
13152,8,876,인천,11,11,0,4632,2020-09-19 09:00:00.000,2021-09-16 10:11:33.897
13153,3,485,광주,0,0,0,4631,2020-09-19 09:00:00.000,2021-09-16 10:11:33.897
13154,3,352,대전,2,2,0,4630,2020-09-19 09:00:00.000,2021-09-16 10:11:33.897
13155,2,141,울산,0,0,0,4629,2020-09-19 09:00:00.000,2021-09-16 10:11:33.897
13156,0,70,세종,0,0,0,4628,2020-09-19 09:00:00.000,2021-09-16 10:11:33.897
13157,59,4129,경기,41,41,0,4627,2020-09-19 09:00:00.000,2021-09-16 10:11:33.897
13158,3,217,강원,0,0,0,4626,2020-09-19 09:00:00.000,2021-09-16 10:11:33.897
13159,1,155,충북,1,1,0,4625,2020-09-19 09:00:00.000,2021-09-16 10:11:33.897
13160,2,467,충남,4,4,0,4624,2020-09-19 09:00:00.000,2021-09-16 10:11:33.897
13161,0,115,전북,1,1,0,4623,2020-09-19 09:00:00.000,2021-09-16 10:11:33.897
13162,0,167,전남,0,0,0,4622,2020-09-19 09:00:00.000,2021-09-16 10:11:33.897
13163,55,1506,경북,4,4,0,4621,2020-09-19 09:00:00.000,2021-09-16 10:11:33.897
13164,0,282,경남,1,0,1,4620,2020-09-19 09:00:00.000,2021-09-16 10:11:33.897
13165,0,58,제주,0,0,0,4619,2020-09-19 09:00:00.000,2021-09-16 10:11:33.897
13166,0,1435,검역,1,0,1,4618,2020-09-19 09:00:00.000,2021-09-16 10:11:33.897
13167,377,22782,합계,126,109,17,4617,2020-09-18 09:00:00.000,2021-09-16 10:11:33.897
13168,46,4904,서울,46,46,0,4616,2020-09-18 09:00:00.000,2021-09-16 10:11:33.897
13169,4,369,부산,2,1,1,4615,2020-09-18 09:00:00.000,2021-09-16 10:11:33.897
13170,192,7120,대구,2,2,0,4614,2020-09-18 09:00:00.000,2021-09-16 10:11:33.897
13171,8,865,인천,6,4,2,4613,2020-09-18 09:00:00.000,2021-09-16 10:11:33.897
13172,3,485,광주,0,0,0,4612,2020-09-18 09:00:00.000,2021-09-16 10:11:33.897
13173,3,350,대전,3,2,1,4611,2020-09-18 09:00:00.000,2021-09-16 10:11:33.897
13174,1,141,울산,0,0,0,4610,2020-09-18 09:00:00.000,2021-09-16 10:11:33.897
13175,0,70,세종,0,0,0,4609,2020-09-18 09:00:00.000,2021-09-16 10:11:33.897
13176,59,4088,경기,37,32,5,4608,2020-09-18 09:00:00.000,2021-09-16 10:11:33.897
13177,3,217,강원,0,0,0,4607,2020-09-18 09:00:00.000,2021-09-16 10:11:33.897
13178,1,154,충북,3,3,0,4606,2020-09-18 09:00:00.000,2021-09-16 10:11:33.897
13179,2,463,충남,6,3,3,4605,2020-09-18 09:00:00.000,2021-09-16 10:11:33.897
13180,0,114,전북,8,7,1,4604,2020-09-18 09:00:00.000,2021-09-16 10:11:33.897
13181,0,167,전남,0,0,0,4603,2020-09-18 09:00:00.000,2021-09-16 10:11:33.897
13182,55,1502,경북,5,5,0,4602,2020-09-18 09:00:00.000,2021-09-16 10:11:33.897
13183,0,281,경남,4,3,1,4601,2020-09-18 09:00:00.000,2021-09-16 10:11:33.897
13184,0,58,제주,2,1,1,4600,2020-09-18 09:00:00.000,2021-09-16 10:11:33.897
13185,0,1434,검역,2,0,2,4599,2020-09-18 09:00:00.000,2021-09-16 10:11:33.897
13186,372,22656,합계,153,145,8,4598,2020-09-17 09:00:00.000,2021-09-16 10:11:33.897
13187,43,4858,서울,64,63,1,4597,2020-09-17 09:00:00.000,2021-09-16 10:11:33.897
13188,4,367,부산,2,2,0,4596,2020-09-17 09:00:00.000,2021-09-16 10:11:33.897
13189,192,7118,대구,2,2,0,4595,2020-09-17 09:00:00.000,2021-09-16 10:11:33.897
13190,7,859,인천,7,7,0,4594,2020-09-17 09:00:00.000,2021-09-16 10:11:33.897
13191,3,485,광주,1,1,0,4593,2020-09-17 09:00:00.000,2021-09-16 10:11:33.897
13192,3,347,대전,1,0,1,4592,2020-09-17 09:00:00.000,2021-09-16 10:11:33.897
13193,1,141,울산,0,0,0,4591,2020-09-17 09:00:00.000,2021-09-16 10:11:33.897
13194,0,70,세종,0,0,0,4590,2020-09-17 09:00:00.000,2021-09-16 10:11:33.897
13195,58,4051,경기,54,52,2,4589,2020-09-17 09:00:00.000,2021-09-16 10:11:33.897
13196,3,217,강원,0,0,0,4588,2020-09-17 09:00:00.000,2021-09-16 10:11:33.897
13197,1,151,충북,0,0,0,4587,2020-09-17 09:00:00.000,2021-09-16 10:11:33.897
13198,2,457,충남,10,9,1,4586,2020-09-17 09:00:00.000,2021-09-16 10:11:33.897
13199,0,106,전북,0,0,0,4585,2020-09-17 09:00:00.000,2021-09-16 10:11:33.897
13200,0,167,전남,1,0,1,4584,2020-09-17 09:00:00.000,2021-09-16 10:11:33.897
13201,55,1497,경북,6,6,0,4583,2020-09-17 09:00:00.000,2021-09-16 10:11:33.897
13202,0,277,경남,3,3,0,4582,2020-09-17 09:00:00.000,2021-09-16 10:11:33.897
13203,0,56,제주,0,0,0,4581,2020-09-17 09:00:00.000,2021-09-16 10:11:33.897
13204,0,1432,검역,2,0,2,4580,2020-09-17 09:00:00.000,2021-09-16 10:11:33.897
13205,367,22503,합계,113,105,8,4579,2020-09-16 09:00:00.000,2021-09-16 10:11:33.897
13206,42,4794,서울,51,49,2,4578,2020-09-16 09:00:00.000,2021-09-16 10:11:33.897
13207,4,365,부산,4,4,0,4577,2020-09-16 09:00:00.000,2021-09-16 10:11:33.897
13208,192,7116,대구,4,4,0,4576,2020-09-16 09:00:00.000,2021-09-16 10:11:33.897
13209,6,852,인천,9,8,1,4575,2020-09-16 09:00:00.000,2021-09-16 10:11:33.897
13210,3,484,광주,2,2,0,4574,2020-09-16 09:00:00.000,2021-09-16 10:11:33.897
13211,3,346,대전,1,1,0,4573,2020-09-16 09:00:00.000,2021-09-16 10:11:33.897
13212,1,141,울산,0,0,0,4572,2020-09-16 09:00:00.000,2021-09-16 10:11:33.897
13213,0,70,세종,0,0,0,4571,2020-09-16 09:00:00.000,2021-09-16 10:11:33.897
13214,56,3997,경기,26,24,2,4570,2020-09-16 09:00:00.000,2021-09-16 10:11:33.897
13215,3,217,강원,0,0,0,4569,2020-09-16 09:00:00.000,2021-09-16 10:11:33.897
13216,1,151,충북,2,2,0,4568,2020-09-16 09:00:00.000,2021-09-16 10:11:33.897
13217,2,447,충남,2,2,0,4567,2020-09-16 09:00:00.000,2021-09-16 10:11:33.897
13218,0,106,전북,5,5,0,4566,2020-09-16 09:00:00.000,2021-09-16 10:11:33.897
13219,0,166,전남,0,0,0,4565,2020-09-16 09:00:00.000,2021-09-16 10:11:33.897
13220,54,1491,경북,2,2,0,4564,2020-09-16 09:00:00.000,2021-09-16 10:11:33.897
13221,0,274,경남,3,2,1,4563,2020-09-16 09:00:00.000,2021-09-16 10:11:33.897
13222,0,56,제주,0,0,0,4562,2020-09-16 09:00:00.000,2021-09-16 10:11:33.897
13223,0,1430,검역,2,0,2,4561,2020-09-16 09:00:00.000,2021-09-16 10:11:33.897
13224,367,22390,합계,106,90,16,4560,2020-09-15 09:00:00.000,2021-09-16 10:11:33.897
13225,42,4743,서울,32,31,1,4559,2020-09-15 09:00:00.000,2021-09-16 10:11:33.897
13226,4,361,부산,4,4,0,4558,2020-09-15 09:00:00.000,2021-09-16 10:11:33.897
13227,192,7112,대구,0,0,0,4557,2020-09-15 09:00:00.000,2021-09-16 10:11:33.897
13228,6,843,인천,9,8,1,4556,2020-09-15 09:00:00.000,2021-09-16 10:11:33.897
13229,3,482,광주,1,1,0,4555,2020-09-15 09:00:00.000,2021-09-16 10:11:33.897
13230,3,345,대전,3,2,1,4554,2020-09-15 09:00:00.000,2021-09-16 10:11:33.897
13231,1,141,울산,0,0,0,4553,2020-09-15 09:00:00.000,2021-09-16 10:11:33.897
13232,0,70,세종,0,0,0,4552,2020-09-15 09:00:00.000,2021-09-16 10:11:33.897
13233,56,3971,경기,39,31,8,4551,2020-09-15 09:00:00.000,2021-09-16 10:11:33.897
13234,3,217,강원,1,1,0,4550,2020-09-15 09:00:00.000,2021-09-16 10:11:33.897
13235,1,149,충북,2,2,0,4549,2020-09-15 09:00:00.000,2021-09-16 10:11:33.897
13236,2,445,충남,3,3,0,4548,2020-09-15 09:00:00.000,2021-09-16 10:11:33.897
13237,0,101,전북,1,1,0,4547,2020-09-15 09:00:00.000,2021-09-16 10:11:33.897
13238,0,166,전남,0,0,0,4546,2020-09-15 09:00:00.000,2021-09-16 10:11:33.897
13239,54,1489,경북,1,1,0,4545,2020-09-15 09:00:00.000,2021-09-16 10:11:33.897
13240,0,271,경남,2,2,0,4544,2020-09-15 09:00:00.000,2021-09-16 10:11:33.897
13241,0,56,제주,3,3,0,4543,2020-09-15 09:00:00.000,2021-09-16 10:11:33.897
13242,0,1428,검역,5,0,5,4542,2020-09-15 09:00:00.000,2021-09-16 10:11:33.897
13243,363,22284,합계,109,98,11,4541,2020-09-14 09:00:00.000,2021-09-16 10:11:33.897
13244,40,4711,서울,41,41,0,4540,2020-09-14 09:00:00.000,2021-09-16 10:11:33.897
13245,4,357,부산,3,3,0,4539,2020-09-14 09:00:00.000,2021-09-16 10:11:33.897
13246,191,7112,대구,4,1,3,4538,2020-09-14 09:00:00.000,2021-09-16 10:11:33.897
13247,5,834,인천,10,10,0,4537,2020-09-14 09:00:00.000,2021-09-16 10:11:33.897
13248,3,481,광주,3,3,0,4536,2020-09-14 09:00:00.000,2021-09-16 10:11:33.897
13249,3,342,대전,1,1,0,4535,2020-09-14 09:00:00.000,2021-09-16 10:11:33.897
13250,1,141,울산,1,1,0,4534,2020-09-14 09:00:00.000,2021-09-16 10:11:33.897
13251,0,70,세종,0,0,0,4533,2020-09-14 09:00:00.000,2021-09-16 10:11:33.897
13252,56,3932,경기,30,30,0,4532,2020-09-14 09:00:00.000,2021-09-16 10:11:33.897
13253,3,216,강원,0,0,0,4531,2020-09-14 09:00:00.000,2021-09-16 10:11:33.897
13254,1,147,충북,0,0,0,4530,2020-09-14 09:00:00.000,2021-09-16 10:11:33.897
13255,2,442,충남,8,7,1,4529,2020-09-14 09:00:00.000,2021-09-16 10:11:33.897
13256,0,100,전북,1,0,1,4528,2020-09-14 09:00:00.000,2021-09-16 10:11:33.897
13257,0,166,전남,0,0,0,4527,2020-09-14 09:00:00.000,2021-09-16 10:11:33.897
13258,54,1488,경북,1,0,1,4526,2020-09-14 09:00:00.000,2021-09-16 10:11:33.897
13259,0,269,경남,1,1,0,4525,2020-09-14 09:00:00.000,2021-09-16 10:11:33.897
13260,0,53,제주,0,0,0,4524,2020-09-14 09:00:00.000,2021-09-16 10:11:33.897
13261,0,1423,검역,5,0,5,4523,2020-09-14 09:00:00.000,2021-09-16 10:11:33.897
13262,358,22175,합계,121,99,22,4522,2020-09-13 09:00:00.000,2021-09-16 10:11:33.897
13263,38,4670,서울,31,30,1,4521,2020-09-13 09:00:00.000,2021-09-16 10:11:33.897
13264,4,354,부산,3,3,0,4520,2020-09-13 09:00:00.000,2021-09-16 10:11:33.897
13265,191,7108,대구,14,14,0,4519,2020-09-13 09:00:00.000,2021-09-16 10:11:33.897
13266,3,824,인천,3,3,0,4518,2020-09-13 09:00:00.000,2021-09-16 10:11:33.897
13267,3,478,광주,3,2,1,4517,2020-09-13 09:00:00.000,2021-09-16 10:11:33.897
13268,3,341,대전,2,2,0,4516,2020-09-13 09:00:00.000,2021-09-16 10:11:33.897
13269,1,140,울산,7,4,3,4515,2020-09-13 09:00:00.000,2021-09-16 10:11:33.897
13270,0,70,세종,0,0,0,4514,2020-09-13 09:00:00.000,2021-09-16 10:11:33.897
13271,55,3902,경기,32,27,5,4513,2020-09-13 09:00:00.000,2021-09-16 10:11:33.897
13272,3,216,강원,1,1,0,4512,2020-09-13 09:00:00.000,2021-09-16 10:11:33.897
13273,1,147,충북,0,0,0,4511,2020-09-13 09:00:00.000,2021-09-16 10:11:33.897
13274,2,434,충남,11,9,2,4510,2020-09-13 09:00:00.000,2021-09-16 10:11:33.897
13275,0,99,전북,2,0,2,4509,2020-09-13 09:00:00.000,2021-09-16 10:11:33.897
13276,0,166,전남,0,0,0,4508,2020-09-13 09:00:00.000,2021-09-16 10:11:33.897
13277,54,1487,경북,2,2,0,4507,2020-09-13 09:00:00.000,2021-09-16 10:11:33.897
13278,0,268,경남,3,2,1,4506,2020-09-13 09:00:00.000,2021-09-16 10:11:33.897
13279,0,53,제주,0,0,0,4505,2020-09-13 09:00:00.000,2021-09-16 10:11:33.897
13280,0,1418,검역,7,0,7,4504,2020-09-13 09:00:00.000,2021-09-16 10:11:33.897
13281,355,22054,합계,136,118,18,4503,2020-09-12 09:00:00.000,2021-09-16 10:11:33.897
13282,35,4639,서울,50,50,0,4502,2020-09-12 09:00:00.000,2021-09-16 10:11:33.897
13283,4,351,부산,4,4,0,4501,2020-09-12 09:00:00.000,2021-09-16 10:11:33.897
13284,191,7094,대구,4,3,1,4500,2020-09-12 09:00:00.000,2021-09-16 10:11:33.897
13285,3,821,인천,8,8,0,4499,2020-09-12 09:00:00.000,2021-09-16 10:11:33.897
13286,3,475,광주,3,3,0,4498,2020-09-12 09:00:00.000,2021-09-16 10:11:33.897
13287,3,339,대전,7,7,0,4497,2020-09-12 09:00:00.000,2021-09-16 10:11:33.897
13288,1,133,울산,1,1,0,4496,2020-09-12 09:00:00.000,2021-09-16 10:11:33.897
13289,0,70,세종,0,0,0,4495,2020-09-12 09:00:00.000,2021-09-16 10:11:33.897
13290,55,3870,경기,32,28,4,4494,2020-09-12 09:00:00.000,2021-09-16 10:11:33.897
13291,3,215,강원,3,3,0,4493,2020-09-12 09:00:00.000,2021-09-16 10:11:33.897
13292,1,147,충북,0,0,0,4492,2020-09-12 09:00:00.000,2021-09-16 10:11:33.897
13293,2,423,충남,6,6,0,4491,2020-09-12 09:00:00.000,2021-09-16 10:11:33.897
13294,0,97,전북,1,0,1,4490,2020-09-12 09:00:00.000,2021-09-16 10:11:33.897
13295,0,166,전남,1,0,1,4489,2020-09-12 09:00:00.000,2021-09-16 10:11:33.897
13296,54,1485,경북,2,2,0,4488,2020-09-12 09:00:00.000,2021-09-16 10:11:33.897
13297,0,265,경남,3,2,1,4487,2020-09-12 09:00:00.000,2021-09-16 10:11:33.897
13298,0,53,제주,1,1,0,4486,2020-09-12 09:00:00.000,2021-09-16 10:11:33.897
13299,0,1411,검역,10,0,10,4485,2020-09-12 09:00:00.000,2021-09-16 10:11:33.897
13300,350,21918,합계,176,161,15,4484,2020-09-11 09:00:00.000,2021-09-16 10:11:33.897
13301,34,4589,서울,63,61,2,4483,2020-09-11 09:00:00.000,2021-09-16 10:11:33.897
13302,4,347,부산,3,3,0,4482,2020-09-11 09:00:00.000,2021-09-16 10:11:33.897
13303,191,7090,대구,1,1,0,4481,2020-09-11 09:00:00.000,2021-09-16 10:11:33.897
13304,3,813,인천,8,8,0,4480,2020-09-11 09:00:00.000,2021-09-16 10:11:33.897
13305,2,472,광주,8,7,1,4479,2020-09-11 09:00:00.000,2021-09-16 10:11:33.897
13306,3,332,대전,11,10,1,4478,2020-09-11 09:00:00.000,2021-09-16 10:11:33.897
13307,1,132,울산,5,4,1,4477,2020-09-11 09:00:00.000,2021-09-16 10:11:33.897
13308,0,70,세종,0,0,0,4476,2020-09-11 09:00:00.000,2021-09-16 10:11:33.897
13309,53,3838,경기,47,47,0,4475,2020-09-11 09:00:00.000,2021-09-16 10:11:33.897
13310,3,212,강원,0,0,0,4474,2020-09-11 09:00:00.000,2021-09-16 10:11:33.897
13311,1,147,충북,1,1,0,4473,2020-09-11 09:00:00.000,2021-09-16 10:11:33.897
13312,1,417,충남,14,14,0,4472,2020-09-11 09:00:00.000,2021-09-16 10:11:33.897
13313,0,96,전북,0,0,0,4471,2020-09-11 09:00:00.000,2021-09-16 10:11:33.897
13314,0,165,전남,2,2,0,4470,2020-09-11 09:00:00.000,2021-09-16 10:11:33.897
13315,54,1483,경북,2,2,0,4469,2020-09-11 09:00:00.000,2021-09-16 10:11:33.897
13316,0,262,경남,0,0,0,4468,2020-09-11 09:00:00.000,2021-09-16 10:11:33.897
13317,0,52,제주,2,1,1,4467,2020-09-11 09:00:00.000,2021-09-16 10:11:33.897
13318,0,1401,검역,9,0,9,4466,2020-09-11 09:00:00.000,2021-09-16 10:11:33.897
13319,346,21742,합계,155,140,15,4465,2020-09-10 09:00:00.000,2021-09-16 10:11:33.897
13320,32,4526,서울,48,46,2,4464,2020-09-10 09:00:00.000,2021-09-16 10:11:33.897
13321,4,344,부산,1,1,0,4463,2020-09-10 09:00:00.000,2021-09-16 10:11:33.897
13322,191,7089,대구,1,1,0,4462,2020-09-10 09:00:00.000,2021-09-16 10:11:33.897
13323,3,805,인천,5,5,0,4461,2020-09-10 09:00:00.000,2021-09-16 10:11:33.897
13324,2,464,광주,5,5,0,4460,2020-09-10 09:00:00.000,2021-09-16 10:11:33.897
13325,3,321,대전,11,11,0,4459,2020-09-10 09:00:00.000,2021-09-16 10:11:33.897
13326,1,127,울산,4,4,0,4458,2020-09-10 09:00:00.000,2021-09-16 10:11:33.897
13327,0,70,세종,0,0,0,4457,2020-09-10 09:00:00.000,2021-09-16 10:11:33.897
13328,51,3791,경기,50,47,3,4456,2020-09-10 09:00:00.000,2021-09-16 10:11:33.897
13329,3,212,강원,2,1,1,4455,2020-09-10 09:00:00.000,2021-09-16 10:11:33.897
13330,1,146,충북,3,2,1,4454,2020-09-10 09:00:00.000,2021-09-16 10:11:33.897
13331,1,403,충남,12,12,0,4453,2020-09-10 09:00:00.000,2021-09-16 10:11:33.897
13332,0,96,전북,1,1,0,4452,2020-09-10 09:00:00.000,2021-09-16 10:11:33.897
13333,0,163,전남,2,1,1,4451,2020-09-10 09:00:00.000,2021-09-16 10:11:33.897
13334,54,1481,경북,3,2,1,4450,2020-09-10 09:00:00.000,2021-09-16 10:11:33.897
13335,0,262,경남,1,0,1,4449,2020-09-10 09:00:00.000,2021-09-16 10:11:33.897
13336,0,50,제주,2,1,1,4448,2020-09-10 09:00:00.000,2021-09-16 10:11:33.897
13337,0,1392,검역,4,0,4,4447,2020-09-10 09:00:00.000,2021-09-16 10:11:33.897
13338,344,21587,합계,156,144,12,4446,2020-09-09 09:00:00.000,2021-09-16 10:11:33.897
13339,32,4478,서울,49,48,1,4445,2020-09-09 09:00:00.000,2021-09-16 10:11:33.897
13340,4,343,부산,2,2,0,4444,2020-09-09 09:00:00.000,2021-09-16 10:11:33.897
13341,191,7088,대구,2,2,0,4443,2020-09-09 09:00:00.000,2021-09-16 10:11:33.897
13342,3,800,인천,1,1,0,4442,2020-09-09 09:00:00.000,2021-09-16 10:11:33.897
13343,2,459,광주,17,17,0,4441,2020-09-09 09:00:00.000,2021-09-16 10:11:33.897
13344,3,310,대전,8,8,0,4440,2020-09-09 09:00:00.000,2021-09-16 10:11:33.897
13345,1,123,울산,4,4,0,4439,2020-09-09 09:00:00.000,2021-09-16 10:11:33.897
13346,0,70,세종,2,2,0,4438,2020-09-09 09:00:00.000,2021-09-16 10:11:33.897
13347,49,3741,경기,55,51,4,4437,2020-09-09 09:00:00.000,2021-09-16 10:11:33.897
13348,3,210,강원,0,0,0,4436,2020-09-09 09:00:00.000,2021-09-16 10:11:33.897
13349,1,143,충북,1,1,0,4435,2020-09-09 09:00:00.000,2021-09-16 10:11:33.897
13350,1,391,충남,8,5,3,4434,2020-09-09 09:00:00.000,2021-09-16 10:11:33.897
13351,0,95,전북,1,1,0,4433,2020-09-09 09:00:00.000,2021-09-16 10:11:33.897
13352,0,161,전남,1,1,0,4432,2020-09-09 09:00:00.000,2021-09-16 10:11:33.897
13353,54,1478,경북,0,0,0,4431,2020-09-09 09:00:00.000,2021-09-16 10:11:33.897
13354,0,261,경남,1,1,0,4430,2020-09-09 09:00:00.000,2021-09-16 10:11:33.897
13355,0,48,제주,0,0,0,4429,2020-09-09 09:00:00.000,2021-09-16 10:11:33.897
13356,0,1388,검역,4,0,4,4428,2020-09-09 09:00:00.000,2021-09-16 10:11:33.897
13357,341,21431,합계,136,120,16,4427,2020-09-08 09:00:00.000,2021-09-16 10:11:33.897
13358,32,4429,서울,67,67,0,4426,2020-09-08 09:00:00.000,2021-09-16 10:11:33.897
13359,4,341,부산,1,1,0,4425,2020-09-08 09:00:00.000,2021-09-16 10:11:33.897
13360,191,7086,대구,2,0,2,4424,2020-09-08 09:00:00.000,2021-09-16 10:11:33.897
13361,3,799,인천,2,2,0,4423,2020-09-08 09:00:00.000,2021-09-16 10:11:33.897
13362,2,442,광주,13,12,1,4422,2020-09-08 09:00:00.000,2021-09-16 10:11:33.897
13363,3,302,대전,4,4,0,4421,2020-09-08 09:00:00.000,2021-09-16 10:11:33.897
13364,1,119,울산,3,3,0,4420,2020-09-08 09:00:00.000,2021-09-16 10:11:33.897
13365,0,68,세종,1,1,0,4419,2020-09-08 09:00:00.000,2021-09-16 10:11:33.897
13366,46,3686,경기,31,29,2,4418,2020-09-08 09:00:00.000,2021-09-16 10:11:33.897
13367,3,210,강원,0,0,0,4417,2020-09-08 09:00:00.000,2021-09-16 10:11:33.897
13368,1,142,충북,1,1,0,4416,2020-09-08 09:00:00.000,2021-09-16 10:11:33.897
13369,1,383,충남,0,0,0,4415,2020-09-08 09:00:00.000,2021-09-16 10:11:33.897
13370,0,94,전북,3,0,3,4414,2020-09-08 09:00:00.000,2021-09-16 10:11:33.897
13371,0,160,전남,1,0,1,4413,2020-09-08 09:00:00.000,2021-09-16 10:11:33.897
13372,54,1478,경북,3,0,3,4412,2020-09-08 09:00:00.000,2021-09-16 10:11:33.897
13373,0,260,경남,0,0,0,4411,2020-09-08 09:00:00.000,2021-09-16 10:11:33.897
13374,0,48,제주,0,0,0,4410,2020-09-08 09:00:00.000,2021-09-16 10:11:33.897
13375,0,1384,검역,4,0,4,4409,2020-09-08 09:00:00.000,2021-09-16 10:11:33.897
13376,336,21295,합계,119,107,12,4408,2020-09-07 09:00:00.000,2021-09-16 10:11:33.897
13377,28,4362,서울,48,46,2,4407,2020-09-07 09:00:00.000,2021-09-16 10:11:33.897
13378,4,340,부산,9,9,0,4406,2020-09-07 09:00:00.000,2021-09-16 10:11:33.897
13379,191,7084,대구,2,1,1,4405,2020-09-07 09:00:00.000,2021-09-16 10:11:33.897
13380,3,797,인천,1,1,0,4404,2020-09-07 09:00:00.000,2021-09-16 10:11:33.897
13381,2,429,광주,9,7,2,4403,2020-09-07 09:00:00.000,2021-09-16 10:11:33.897
13382,3,298,대전,5,5,0,4402,2020-09-07 09:00:00.000,2021-09-16 10:11:33.897
13383,1,116,울산,3,3,0,4401,2020-09-07 09:00:00.000,2021-09-16 10:11:33.897
13384,0,67,세종,0,0,0,4400,2020-09-07 09:00:00.000,2021-09-16 10:11:33.897
13385,45,3655,경기,31,30,1,4399,2020-09-07 09:00:00.000,2021-09-16 10:11:33.897
13386,3,210,강원,0,0,0,4398,2020-09-07 09:00:00.000,2021-09-16 10:11:33.897
13387,1,141,충북,0,0,0,4397,2020-09-07 09:00:00.000,2021-09-16 10:11:33.897
13388,1,383,충남,3,3,0,4396,2020-09-07 09:00:00.000,2021-09-16 10:11:33.897
13389,0,91,전북,1,0,1,4395,2020-09-07 09:00:00.000,2021-09-16 10:11:33.897
13390,0,159,전남,0,0,0,4394,2020-09-07 09:00:00.000,2021-09-16 10:11:33.897
13391,54,1475,경북,0,0,0,4393,2020-09-07 09:00:00.000,2021-09-16 10:11:33.897
13392,0,260,경남,3,2,1,4392,2020-09-07 09:00:00.000,2021-09-16 10:11:33.897
13393,0,48,제주,0,0,0,4391,2020-09-07 09:00:00.000,2021-09-16 10:11:33.897
13394,0,1380,검역,4,0,4,4390,2020-09-07 09:00:00.000,2021-09-16 10:11:33.897
13395,334,21176,합계,167,152,15,4389,2020-09-06 09:00:00.000,2021-09-16 10:11:33.897
13396,26,4314,서울,63,63,0,4388,2020-09-06 09:00:00.000,2021-09-16 10:11:33.897
13397,4,331,부산,2,2,0,4387,2020-09-06 09:00:00.000,2021-09-16 10:11:33.897
13398,191,7082,대구,5,4,1,4386,2020-09-06 09:00:00.000,2021-09-16 10:11:33.897
13399,3,796,인천,12,9,3,4385,2020-09-06 09:00:00.000,2021-09-16 10:11:33.897
13400,2,420,광주,7,7,0,4384,2020-09-06 09:00:00.000,2021-09-16 10:11:33.897
13401,3,293,대전,5,5,0,4383,2020-09-06 09:00:00.000,2021-09-16 10:11:33.897
13402,1,113,울산,1,1,0,4382,2020-09-06 09:00:00.000,2021-09-16 10:11:33.897
13403,0,67,세종,0,0,0,4381,2020-09-06 09:00:00.000,2021-09-16 10:11:33.897
13404,45,3624,경기,47,45,2,4380,2020-09-06 09:00:00.000,2021-09-16 10:11:33.897
13405,3,210,강원,5,5,0,4379,2020-09-06 09:00:00.000,2021-09-16 10:11:33.897
13406,1,141,충북,2,2,0,4378,2020-09-06 09:00:00.000,2021-09-16 10:11:33.897
13407,1,380,충남,2,2,0,4377,2020-09-06 09:00:00.000,2021-09-16 10:11:33.897
13408,0,90,전북,1,1,0,4376,2020-09-06 09:00:00.000,2021-09-16 10:11:33.897
13409,0,159,전남,3,0,3,4375,2020-09-06 09:00:00.000,2021-09-16 10:11:33.897
13410,54,1475,경북,2,2,0,4374,2020-09-06 09:00:00.000,2021-09-16 10:11:33.897
13411,0,257,경남,6,4,2,4373,2020-09-06 09:00:00.000,2021-09-16 10:11:33.897
13412,0,48,제주,0,0,0,4372,2020-09-06 09:00:00.000,2021-09-16 10:11:33.897
13413,0,1376,검역,4,0,4,4371,2020-09-06 09:00:00.000,2021-09-16 10:11:33.897
13414,333,21009,합계,168,158,10,4370,2020-09-05 09:00:00.000,2021-09-16 10:11:33.897
13415,25,4251,서울,51,51,0,4369,2020-09-05 09:00:00.000,2021-09-16 10:11:33.897
13416,4,329,부산,10,10,0,4368,2020-09-05 09:00:00.000,2021-09-16 10:11:33.897
13417,191,7077,대구,5,5,0,4367,2020-09-05 09:00:00.000,2021-09-16 10:11:33.897
13418,3,784,인천,14,14,0,4366,2020-09-05 09:00:00.000,2021-09-16 10:11:33.897
13419,2,413,광주,8,8,0,4365,2020-09-05 09:00:00.000,2021-09-16 10:11:33.897
13420,3,288,대전,2,2,0,4364,2020-09-05 09:00:00.000,2021-09-16 10:11:33.897
13421,1,112,울산,1,1,0,4363,2020-09-05 09:00:00.000,2021-09-16 10:11:33.897
13422,0,67,세종,0,0,0,4362,2020-09-05 09:00:00.000,2021-09-16 10:11:33.897
13423,45,3577,경기,50,47,3,4361,2020-09-05 09:00:00.000,2021-09-16 10:11:33.897
13424,3,205,강원,3,3,0,4360,2020-09-05 09:00:00.000,2021-09-16 10:11:33.897
13425,1,139,충북,4,2,2,4359,2020-09-05 09:00:00.000,2021-09-16 10:11:33.897
13426,1,378,충남,4,4,0,4358,2020-09-05 09:00:00.000,2021-09-16 10:11:33.897
13427,0,89,전북,2,2,0,4357,2020-09-05 09:00:00.000,2021-09-16 10:11:33.897
13428,0,156,전남,0,0,0,4356,2020-09-05 09:00:00.000,2021-09-16 10:11:33.897
13429,54,1473,경북,1,0,1,4355,2020-09-05 09:00:00.000,2021-09-16 10:11:33.897
13430,0,251,경남,8,8,0,4354,2020-09-05 09:00:00.000,2021-09-16 10:11:33.897
13431,0,48,제주,1,1,0,4353,2020-09-05 09:00:00.000,2021-09-16 10:11:33.897
13432,0,1372,검역,4,0,4,4352,2020-09-05 09:00:00.000,2021-09-16 10:11:33.897
13433,331,20841,합계,198,188,10,4351,2020-09-04 09:00:00.000,2021-09-16 10:11:33.897
13434,24,4200,서울,68,68,0,4350,2020-09-04 09:00:00.000,2021-09-16 10:11:33.897
13435,4,319,부산,4,3,1,4349,2020-09-04 09:00:00.000,2021-09-16 10:11:33.897
13436,191,7072,대구,7,7,0,4348,2020-09-04 09:00:00.000,2021-09-16 10:11:33.897
13437,3,770,인천,5,5,0,4347,2020-09-04 09:00:00.000,2021-09-16 10:11:33.897
13438,2,405,광주,11,10,1,4346,2020-09-04 09:00:00.000,2021-09-16 10:11:33.897
13439,3,286,대전,4,3,1,4345,2020-09-04 09:00:00.000,2021-09-16 10:11:33.897
13440,1,111,울산,3,3,0,4344,2020-09-04 09:00:00.000,2021-09-16 10:11:33.897
13441,0,67,세종,0,0,0,4343,2020-09-04 09:00:00.000,2021-09-16 10:11:33.897
13442,44,3527,경기,56,55,1,4342,2020-09-04 09:00:00.000,2021-09-16 10:11:33.897
13443,3,202,강원,3,3,0,4341,2020-09-04 09:00:00.000,2021-09-16 10:11:33.897
13444,1,135,충북,4,3,1,4340,2020-09-04 09:00:00.000,2021-09-16 10:11:33.897
13445,1,374,충남,21,20,1,4339,2020-09-04 09:00:00.000,2021-09-16 10:11:33.897
13446,0,87,전북,0,0,0,4338,2020-09-04 09:00:00.000,2021-09-16 10:11:33.897
13447,0,156,전남,1,1,0,4337,2020-09-04 09:00:00.000,2021-09-16 10:11:33.897
13448,54,1472,경북,4,4,0,4336,2020-09-04 09:00:00.000,2021-09-16 10:11:33.897
13449,0,243,경남,3,3,0,4335,2020-09-04 09:00:00.000,2021-09-16 10:11:33.897
13450,0,47,제주,0,0,0,4334,2020-09-04 09:00:00.000,2021-09-16 10:11:33.897
13451,0,1368,검역,4,0,4,4333,2020-09-04 09:00:00.000,2021-09-16 10:11:33.897
13452,329,20643,합계,195,188,7,4332,2020-09-03 09:00:00.000,2021-09-16 10:11:33.897
13453,24,4132,서울,69,69,0,4331,2020-09-03 09:00:00.000,2021-09-16 10:11:33.897
13454,4,315,부산,4,4,0,4330,2020-09-03 09:00:00.000,2021-09-16 10:11:33.897
13455,191,7065,대구,3,2,1,4329,2020-09-03 09:00:00.000,2021-09-16 10:11:33.897
13456,3,765,인천,16,15,1,4328,2020-09-03 09:00:00.000,2021-09-16 10:11:33.897
13457,2,394,광주,6,6,0,4327,2020-09-03 09:00:00.000,2021-09-16 10:11:33.897
13458,3,282,대전,4,4,0,4326,2020-09-03 09:00:00.000,2021-09-16 10:11:33.897
13459,1,108,울산,8,7,1,4325,2020-09-03 09:00:00.000,2021-09-16 10:11:33.897
13460,0,67,세종,0,0,0,4324,2020-09-03 09:00:00.000,2021-09-16 10:11:33.897
13461,42,3471,경기,64,64,0,4323,2020-09-03 09:00:00.000,2021-09-16 10:11:33.897
13462,3,199,강원,4,4,0,4322,2020-09-03 09:00:00.000,2021-09-16 10:11:33.897
13463,1,131,충북,1,1,0,4321,2020-09-03 09:00:00.000,2021-09-16 10:11:33.897
13464,1,353,충남,7,7,0,4320,2020-09-03 09:00:00.000,2021-09-16 10:11:33.897
13465,0,87,전북,0,0,0,4319,2020-09-03 09:00:00.000,2021-09-16 10:11:33.897
13466,0,155,전남,6,5,1,4318,2020-09-03 09:00:00.000,2021-09-16 10:11:33.897
13467,54,1468,경북,0,0,0,4317,2020-09-03 09:00:00.000,2021-09-16 10:11:33.897
13468,0,240,경남,0,0,0,4316,2020-09-03 09:00:00.000,2021-09-16 10:11:33.897
13469,0,47,제주,0,0,0,4315,2020-09-03 09:00:00.000,2021-09-16 10:11:33.897
13470,0,1364,검역,3,0,3,4314,2020-09-03 09:00:00.000,2021-09-16 10:11:33.897
13471,326,20448,합계,267,253,14,4313,2020-09-02 09:00:00.000,2021-09-16 10:11:33.897
13472,24,4063,서울,101,98,3,4312,2020-09-02 09:00:00.000,2021-09-16 10:11:33.897
13473,3,311,부산,7,7,0,4311,2020-09-02 09:00:00.000,2021-09-16 10:11:33.897
13474,191,7062,대구,13,13,0,4310,2020-09-02 09:00:00.000,2021-09-16 10:11:33.897
13475,3,749,인천,11,10,1,4309,2020-09-02 09:00:00.000,2021-09-16 10:11:33.897
13476,2,388,광주,10,10,0,4308,2020-09-02 09:00:00.000,2021-09-16 10:11:33.897
13477,2,278,대전,14,14,0,4307,2020-09-02 09:00:00.000,2021-09-16 10:11:33.897
13478,1,100,울산,5,5,0,4306,2020-09-02 09:00:00.000,2021-09-16 10:11:33.897
13479,0,67,세종,0,0,0,4305,2020-09-02 09:00:00.000,2021-09-16 10:11:33.897
13480,41,3407,경기,84,79,5,4304,2020-09-02 09:00:00.000,2021-09-16 10:11:33.897
13481,3,195,강원,2,2,0,4303,2020-09-02 09:00:00.000,2021-09-16 10:11:33.897
13482,1,130,충북,1,1,0,4302,2020-09-02 09:00:00.000,2021-09-16 10:11:33.897
13483,1,346,충남,7,7,0,4301,2020-09-02 09:00:00.000,2021-09-16 10:11:33.897
13484,0,87,전북,0,0,0,4300,2020-09-02 09:00:00.000,2021-09-16 10:11:33.897
13485,0,149,전남,3,3,0,4299,2020-09-02 09:00:00.000,2021-09-16 10:11:33.897
13486,54,1468,경북,4,3,1,4298,2020-09-02 09:00:00.000,2021-09-16 10:11:33.897
13487,0,240,경남,1,0,1,4297,2020-09-02 09:00:00.000,2021-09-16 10:11:33.897
13488,0,47,제주,1,1,0,4296,2020-09-02 09:00:00.000,2021-09-16 10:11:33.897
13489,0,1361,검역,3,0,3,4295,2020-09-02 09:00:00.000,2021-09-16 10:11:33.897
13490,324,20181,합계,235,221,14,4294,2020-09-01 09:00:00.000,2021-09-16 10:11:33.897
13491,23,3962,서울,94,92,2,4293,2020-09-01 09:00:00.000,2021-09-16 10:11:33.897
13492,3,304,부산,3,3,0,4292,2020-09-01 09:00:00.000,2021-09-16 10:11:33.897
13493,191,7049,대구,2,1,1,4291,2020-09-01 09:00:00.000,2021-09-16 10:11:33.897
13494,3,738,인천,22,22,0,4290,2020-09-01 09:00:00.000,2021-09-16 10:11:33.897
13495,2,378,광주,4,4,0,4289,2020-09-01 09:00:00.000,2021-09-16 10:11:33.897
13496,2,264,대전,8,8,0,4288,2020-09-01 09:00:00.000,2021-09-16 10:11:33.897
13497,1,95,울산,6,6,0,4287,2020-09-01 09:00:00.000,2021-09-16 10:11:33.897
13498,0,67,세종,0,0,0,4286,2020-09-01 09:00:00.000,2021-09-16 10:11:33.897
13499,40,3323,경기,63,60,3,4285,2020-09-01 09:00:00.000,2021-09-16 10:11:33.897
13500,3,193,강원,4,4,0,4284,2020-09-01 09:00:00.000,2021-09-16 10:11:33.897
13501,1,129,충북,1,1,0,4283,2020-09-01 09:00:00.000,2021-09-16 10:11:33.897
13502,1,339,충남,7,7,0,4282,2020-09-01 09:00:00.000,2021-09-16 10:11:33.897
13503,0,87,전북,0,0,0,4281,2020-09-01 09:00:00.000,2021-09-16 10:11:33.897
13504,0,146,전남,4,4,0,4280,2020-09-01 09:00:00.000,2021-09-16 10:11:33.897
13505,54,1464,경북,9,5,4,4279,2020-09-01 09:00:00.000,2021-09-16 10:11:33.897
13506,0,239,경남,3,3,0,4278,2020-09-01 09:00:00.000,2021-09-16 10:11:33.897
13507,0,46,제주,1,1,0,4277,2020-09-01 09:00:00.000,2021-09-16 10:11:33.897
13508,0,1358,검역,4,0,4,4276,2020-09-01 09:00:00.000,2021-09-16 10:11:33.897
13509,324,19946,합계,248,238,10,4275,2020-08-31 09:00:00.000,2021-09-16 10:11:33.897
13510,23,3868,서울,94,91,3,4274,2020-08-31 09:00:00.000,2021-09-16 10:11:33.897
13511,3,301,부산,4,4,0,4273,2020-08-31 09:00:00.000,2021-09-16 10:11:33.897
13512,191,7047,대구,4,4,0,4272,2020-08-31 09:00:00.000,2021-09-16 10:11:33.897
13513,3,716,인천,14,13,1,4271,2020-08-31 09:00:00.000,2021-09-16 10:11:33.897
13514,2,374,광주,9,9,0,4270,2020-08-31 09:00:00.000,2021-09-16 10:11:33.897
13515,2,256,대전,7,6,1,4269,2020-08-31 09:00:00.000,2021-09-16 10:11:33.897
13516,1,89,울산,5,5,0,4268,2020-08-31 09:00:00.000,2021-09-16 10:11:33.897
13517,0,67,세종,1,1,0,4267,2020-08-31 09:00:00.000,2021-09-16 10:11:33.897
13518,40,3260,경기,79,79,0,4266,2020-08-31 09:00:00.000,2021-09-16 10:11:33.897
13519,3,189,강원,3,3,0,4265,2020-08-31 09:00:00.000,2021-09-16 10:11:33.897
13520,1,128,충북,1,0,1,4264,2020-08-31 09:00:00.000,2021-09-16 10:11:33.897
13521,1,332,충남,9,9,0,4263,2020-08-31 09:00:00.000,2021-09-16 10:11:33.897
13522,0,87,전북,1,1,0,4262,2020-08-31 09:00:00.000,2021-09-16 10:11:33.897
13523,0,142,전남,5,5,0,4261,2020-08-31 09:00:00.000,2021-09-16 10:11:33.897
13524,54,1455,경북,2,2,0,4260,2020-08-31 09:00:00.000,2021-09-16 10:11:33.897
13525,0,236,경남,1,1,0,4259,2020-08-31 09:00:00.000,2021-09-16 10:11:33.897
13526,0,45,제주,6,5,1,4258,2020-08-31 09:00:00.000,2021-09-16 10:11:33.897
13527,0,1354,검역,3,0,3,4257,2020-08-31 09:00:00.000,2021-09-16 10:11:33.897
13528,323,19698,합계,299,283,16,4256,2020-08-30 09:00:00.000,2021-09-16 10:11:33.897
13529,22,3774,서울,116,114,2,4255,2020-08-30 09:00:00.000,2021-09-16 10:11:33.897
13530,3,297,부산,6,6,0,4254,2020-08-30 09:00:00.000,2021-09-16 10:11:33.897
13531,191,7043,대구,30,30,0,4253,2020-08-30 09:00:00.000,2021-09-16 10:11:33.897
13532,3,702,인천,13,12,1,4252,2020-08-30 09:00:00.000,2021-09-16 10:11:33.897
13533,2,365,광주,2,2,0,4251,2020-08-30 09:00:00.000,2021-09-16 10:11:33.897
13534,2,249,대전,6,6,0,4250,2020-08-30 09:00:00.000,2021-09-16 10:11:33.897
13535,1,84,울산,3,3,0,4249,2020-08-30 09:00:00.000,2021-09-16 10:11:33.897
13536,0,66,세종,1,1,0,4248,2020-08-30 09:00:00.000,2021-09-16 10:11:33.897
13537,40,3181,경기,80,77,3,4247,2020-08-30 09:00:00.000,2021-09-16 10:11:33.897
13538,3,186,강원,2,2,0,4246,2020-08-30 09:00:00.000,2021-09-16 10:11:33.897
13539,1,127,충북,5,5,0,4245,2020-08-30 09:00:00.000,2021-09-16 10:11:33.897
13540,1,323,충남,8,5,3,4244,2020-08-30 09:00:00.000,2021-09-16 10:11:33.897
13541,0,86,전북,0,0,0,4243,2020-08-30 09:00:00.000,2021-09-16 10:11:33.897
13542,0,137,전남,8,8,0,4242,2020-08-30 09:00:00.000,2021-09-16 10:11:33.897
13543,54,1453,경북,3,3,0,4241,2020-08-30 09:00:00.000,2021-09-16 10:11:33.897
13544,0,235,경남,7,7,0,4240,2020-08-30 09:00:00.000,2021-09-16 10:11:33.897
13545,0,39,제주,2,2,0,4239,2020-08-30 09:00:00.000,2021-09-16 10:11:33.897
13546,0,1351,검역,7,0,7,4238,2020-08-30 09:00:00.000,2021-09-16 10:11:33.897
13547,321,19399,합계,323,308,15,4237,2020-08-29 09:00:00.000,2021-09-16 10:11:33.897
13548,20,3658,서울,125,124,1,4236,2020-08-29 09:00:00.000,2021-09-16 10:11:33.897
13549,3,291,부산,6,5,1,4235,2020-08-29 09:00:00.000,2021-09-16 10:11:33.897
13550,191,7013,대구,6,5,1,4234,2020-08-29 09:00:00.000,2021-09-16 10:11:33.897
13551,3,689,인천,20,20,0,4233,2020-08-29 09:00:00.000,2021-09-16 10:11:33.897
13552,2,363,광주,16,14,2,4232,2020-08-29 09:00:00.000,2021-09-16 10:11:33.897
13553,2,243,대전,4,4,0,4231,2020-08-29 09:00:00.000,2021-09-16 10:11:33.897
13554,1,81,울산,0,0,0,4230,2020-08-29 09:00:00.000,2021-09-16 10:11:33.897
13555,0,65,세종,0,0,0,4229,2020-08-29 09:00:00.000,2021-09-16 10:11:33.897
13556,40,3101,경기,104,100,4,4228,2020-08-29 09:00:00.000,2021-09-16 10:11:33.897
13557,3,184,강원,0,0,0,4227,2020-08-29 09:00:00.000,2021-09-16 10:11:33.897
13558,1,122,충북,6,6,0,4226,2020-08-29 09:00:00.000,2021-09-16 10:11:33.897
13559,1,315,충남,8,8,0,4225,2020-08-29 09:00:00.000,2021-09-16 10:11:33.897
13560,0,86,전북,0,0,0,4224,2020-08-29 09:00:00.000,2021-09-16 10:11:33.897
13561,0,129,전남,9,9,0,4223,2020-08-29 09:00:00.000,2021-09-16 10:11:33.897
13562,54,1450,경북,1,0,1,4222,2020-08-29 09:00:00.000,2021-09-16 10:11:33.897
13563,0,228,경남,12,12,0,4221,2020-08-29 09:00:00.000,2021-09-16 10:11:33.897
13564,0,37,제주,1,1,0,4220,2020-08-29 09:00:00.000,2021-09-16 10:11:33.897
13565,0,1344,검역,5,0,5,4219,2020-08-29 09:00:00.000,2021-09-16 10:11:33.897
13566,316,19076,합계,371,359,12,4218,2020-08-28 09:00:00.000,2021-09-16 10:11:33.897
13567,19,3533,서울,146,145,1,4217,2020-08-28 09:00:00.000,2021-09-16 10:11:33.897
13568,3,285,부산,8,8,0,4216,2020-08-28 09:00:00.000,2021-09-16 10:11:33.897
13569,191,7007,대구,8,8,0,4215,2020-08-28 09:00:00.000,2021-09-16 10:11:33.897
13570,3,669,인천,27,27,0,4214,2020-08-28 09:00:00.000,2021-09-16 10:11:33.897
13571,2,347,광주,17,17,0,4213,2020-08-28 09:00:00.000,2021-09-16 10:11:33.897
13572,2,239,대전,3,3,0,4212,2020-08-28 09:00:00.000,2021-09-16 10:11:33.897
13573,1,81,울산,1,1,0,4211,2020-08-28 09:00:00.000,2021-09-16 10:11:33.897
13574,0,65,세종,2,2,0,4210,2020-08-28 09:00:00.000,2021-09-16 10:11:33.897
13575,36,2997,경기,113,112,1,4209,2020-08-28 09:00:00.000,2021-09-16 10:11:33.897
13576,3,184,강원,3,3,0,4208,2020-08-28 09:00:00.000,2021-09-16 10:11:33.897
13577,1,116,충북,5,5,0,4207,2020-08-28 09:00:00.000,2021-09-16 10:11:33.897
13578,1,307,충남,9,9,0,4206,2020-08-28 09:00:00.000,2021-09-16 10:11:33.897
13579,0,86,전북,2,2,0,4205,2020-08-28 09:00:00.000,2021-09-16 10:11:33.897
13580,0,120,전남,12,12,0,4204,2020-08-28 09:00:00.000,2021-09-16 10:11:33.897
13581,54,1449,경북,1,1,0,4203,2020-08-28 09:00:00.000,2021-09-16 10:11:33.897
13582,0,216,경남,4,2,2,4202,2020-08-28 09:00:00.000,2021-09-16 10:11:33.897
13583,0,36,제주,2,2,0,4201,2020-08-28 09:00:00.000,2021-09-16 10:11:33.897
13584,0,1339,검역,8,0,8,4200,2020-08-28 09:00:00.000,2021-09-16 10:11:33.897
13585,313,18705,합계,441,434,7,4199,2020-08-27 09:00:00.000,2021-09-16 10:11:33.897
13586,17,3387,서울,154,154,0,4198,2020-08-27 09:00:00.000,2021-09-16 10:11:33.897
13587,3,277,부산,8,8,0,4197,2020-08-27 09:00:00.000,2021-09-16 10:11:33.897
13588,191,6999,대구,13,12,1,4196,2020-08-27 09:00:00.000,2021-09-16 10:11:33.897
13589,3,642,인천,59,59,0,4195,2020-08-27 09:00:00.000,2021-09-16 10:11:33.897
13590,2,330,광주,39,39,0,4194,2020-08-27 09:00:00.000,2021-09-16 10:11:33.897
13591,2,236,대전,3,3,0,4193,2020-08-27 09:00:00.000,2021-09-16 10:11:33.897
13592,1,80,울산,2,2,0,4192,2020-08-27 09:00:00.000,2021-09-16 10:11:33.897
13593,0,63,세종,0,0,0,4191,2020-08-27 09:00:00.000,2021-09-16 10:11:33.897
13594,35,2884,경기,102,100,2,4190,2020-08-27 09:00:00.000,2021-09-16 10:11:33.897
13595,3,181,강원,14,14,0,4189,2020-08-27 09:00:00.000,2021-09-16 10:11:33.897
13596,1,111,충북,1,1,0,4188,2020-08-27 09:00:00.000,2021-09-16 10:11:33.897
13597,1,298,충남,15,15,0,4187,2020-08-27 09:00:00.000,2021-09-16 10:11:33.897
13598,0,84,전북,2,2,0,4186,2020-08-27 09:00:00.000,2021-09-16 10:11:33.897
13599,0,108,전남,13,13,0,4185,2020-08-27 09:00:00.000,2021-09-16 10:11:33.897
13600,54,1448,경북,4,3,1,4184,2020-08-27 09:00:00.000,2021-09-16 10:11:33.897
13601,0,212,경남,8,8,0,4183,2020-08-27 09:00:00.000,2021-09-16 10:11:33.897
13602,0,34,제주,1,1,0,4182,2020-08-27 09:00:00.000,2021-09-16 10:11:33.897
13603,0,1331,검역,3,0,3,4181,2020-08-27 09:00:00.000,2021-09-16 10:11:33.897
13604,312,18264,합계,320,307,13,4180,2020-08-26 09:00:00.000,2021-09-16 10:11:33.897
13605,17,3233,서울,111,109,2,4179,2020-08-26 09:00:00.000,2021-09-16 10:11:33.897
13606,3,269,부산,4,4,0,4178,2020-08-26 09:00:00.000,2021-09-16 10:11:33.897
13607,191,6986,대구,3,2,1,4177,2020-08-26 09:00:00.000,2021-09-16 10:11:33.897
13608,3,583,인천,27,27,0,4176,2020-08-26 09:00:00.000,2021-09-16 10:11:33.897
13609,2,291,광주,7,7,0,4175,2020-08-26 09:00:00.000,2021-09-16 10:11:33.897
13610,2,233,대전,7,7,0,4174,2020-08-26 09:00:00.000,2021-09-16 10:11:33.897
13611,1,78,울산,2,2,0,4173,2020-08-26 09:00:00.000,2021-09-16 10:11:33.897
13612,0,63,세종,0,0,0,4172,2020-08-26 09:00:00.000,2021-09-16 10:11:33.897
13613,34,2782,경기,99,93,6,4171,2020-08-26 09:00:00.000,2021-09-16 10:11:33.897
13614,3,167,강원,18,18,0,4170,2020-08-26 09:00:00.000,2021-09-16 10:11:33.897
13615,1,110,충북,0,0,0,4169,2020-08-26 09:00:00.000,2021-09-16 10:11:33.897
13616,1,283,충남,12,12,0,4168,2020-08-26 09:00:00.000,2021-09-16 10:11:33.897
13617,0,82,전북,7,7,0,4167,2020-08-26 09:00:00.000,2021-09-16 10:11:33.897
13618,0,95,전남,13,12,1,4166,2020-08-26 09:00:00.000,2021-09-16 10:11:33.897
13619,54,1444,경북,0,0,0,4165,2020-08-26 09:00:00.000,2021-09-16 10:11:33.897
13620,0,204,경남,5,5,0,4164,2020-08-26 09:00:00.000,2021-09-16 10:11:33.897
13621,0,33,제주,2,2,0,4163,2020-08-26 09:00:00.000,2021-09-16 10:11:33.897
13622,0,1328,검역,3,0,3,4162,2020-08-26 09:00:00.000,2021-09-16 10:11:33.897
13623,310,17944,합계,280,264,16,4161,2020-08-25 09:00:00.000,2021-09-16 10:11:33.897
13624,16,3122,서울,135,135,0,4160,2020-08-25 09:00:00.000,2021-09-16 10:11:33.897
13625,3,265,부산,3,3,0,4159,2020-08-25 09:00:00.000,2021-09-16 10:11:33.897
13626,191,6983,대구,5,5,0,4158,2020-08-25 09:00:00.000,2021-09-16 10:11:33.897
13627,3,556,인천,14,14,0,4157,2020-08-25 09:00:00.000,2021-09-16 10:11:33.897
13628,2,284,광주,4,4,0,4156,2020-08-25 09:00:00.000,2021-09-16 10:11:33.897
13629,2,226,대전,11,10,1,4155,2020-08-25 09:00:00.000,2021-09-16 10:11:33.897
13630,1,76,울산,0,0,0,4154,2020-08-25 09:00:00.000,2021-09-16 10:11:33.897
13631,0,63,세종,3,3,0,4153,2020-08-25 09:00:00.000,2021-09-16 10:11:33.897
13632,33,2683,경기,72,63,9,4152,2020-08-25 09:00:00.000,2021-09-16 10:11:33.897
13633,3,149,강원,8,8,0,4151,2020-08-25 09:00:00.000,2021-09-16 10:11:33.897
13634,1,110,충북,2,0,2,4150,2020-08-25 09:00:00.000,2021-09-16 10:11:33.897
13635,1,271,충남,9,9,0,4149,2020-08-25 09:00:00.000,2021-09-16 10:11:33.897
13636,0,75,전북,4,4,0,4148,2020-08-25 09:00:00.000,2021-09-16 10:11:33.897
13637,0,82,전남,1,1,0,4147,2020-08-25 09:00:00.000,2021-09-16 10:11:33.897
13638,54,1444,경북,1,0,1,4146,2020-08-25 09:00:00.000,2021-09-16 10:11:33.897
13639,0,199,경남,2,2,0,4145,2020-08-25 09:00:00.000,2021-09-16 10:11:33.897
13640,0,31,제주,3,3,0,4144,2020-08-25 09:00:00.000,2021-09-16 10:11:33.897
13641,0,1325,검역,3,0,3,4143,2020-08-25 09:00:00.000,2021-09-16 10:11:33.897
13642,309,17664,합계,266,258,8,4142,2020-08-24 09:00:00.000,2021-09-16 10:11:33.897
13643,16,2987,서울,97,97,0,4141,2020-08-24 09:00:00.000,2021-09-16 10:11:33.897
13644,3,262,부산,3,3,0,4140,2020-08-24 09:00:00.000,2021-09-16 10:11:33.897
13645,191,6978,대구,0,0,0,4139,2020-08-24 09:00:00.000,2021-09-16 10:11:33.897
13646,3,542,인천,20,20,0,4138,2020-08-24 09:00:00.000,2021-09-16 10:11:33.897
13647,2,280,광주,1,1,0,4137,2020-08-24 09:00:00.000,2021-09-16 10:11:33.897
13648,2,215,대전,10,10,0,4136,2020-08-24 09:00:00.000,2021-09-16 10:11:33.897
13649,1,76,울산,1,1,0,4135,2020-08-24 09:00:00.000,2021-09-16 10:11:33.897
13650,0,60,세종,3,1,2,4134,2020-08-24 09:00:00.000,2021-09-16 10:11:33.897
13651,33,2611,경기,85,84,1,4133,2020-08-24 09:00:00.000,2021-09-16 10:11:33.897
13652,3,141,강원,6,6,0,4132,2020-08-24 09:00:00.000,2021-09-16 10:11:33.897
13653,0,108,충북,10,10,0,4131,2020-08-24 09:00:00.000,2021-09-16 10:11:33.897
13654,1,262,충남,8,7,1,4130,2020-08-24 09:00:00.000,2021-09-16 10:11:33.897
13655,0,71,전북,4,4,0,4129,2020-08-24 09:00:00.000,2021-09-16 10:11:33.897
13656,0,81,전남,7,7,0,4128,2020-08-24 09:00:00.000,2021-09-16 10:11:33.897
13657,54,1443,경북,6,6,0,4127,2020-08-24 09:00:00.000,2021-09-16 10:11:33.897
13658,0,197,경남,1,1,0,4126,2020-08-24 09:00:00.000,2021-09-16 10:11:33.897
13659,0,28,제주,0,0,0,4125,2020-08-24 09:00:00.000,2021-09-16 10:11:33.897
13660,0,1322,검역,4,0,4,4124,2020-08-24 09:00:00.000,2021-09-16 10:11:33.897
13661,309,17398,합계,396,386,10,4123,2020-08-23 09:00:00.000,2021-09-16 10:11:33.897
13662,16,2890,서울,140,138,2,4122,2020-08-23 09:00:00.000,2021-09-16 10:11:33.897
13663,3,259,부산,2,2,0,4121,2020-08-23 09:00:00.000,2021-09-16 10:11:33.897
13664,191,6978,대구,6,6,0,4120,2020-08-23 09:00:00.000,2021-09-16 10:11:33.897
13665,3,522,인천,32,32,0,4119,2020-08-23 09:00:00.000,2021-09-16 10:11:33.897
13666,2,279,광주,17,15,2,4118,2020-08-23 09:00:00.000,2021-09-16 10:11:33.897
13667,2,205,대전,15,15,0,4117,2020-08-23 09:00:00.000,2021-09-16 10:11:33.897
13668,1,75,울산,3,3,0,4116,2020-08-23 09:00:00.000,2021-09-16 10:11:33.897
13669,0,57,세종,0,0,0,4115,2020-08-23 09:00:00.000,2021-09-16 10:11:33.897
13670,33,2526,경기,124,123,1,4114,2020-08-23 09:00:00.000,2021-09-16 10:11:33.897
13671,3,135,강원,15,15,0,4113,2020-08-23 09:00:00.000,2021-09-16 10:11:33.897
13672,0,98,충북,3,3,0,4112,2020-08-23 09:00:00.000,2021-09-16 10:11:33.897
13673,1,254,충남,10,10,0,4111,2020-08-23 09:00:00.000,2021-09-16 10:11:33.897
13674,0,67,전북,0,0,0,4110,2020-08-23 09:00:00.000,2021-09-16 10:11:33.897
13675,0,74,전남,14,14,0,4109,2020-08-23 09:00:00.000,2021-09-16 10:11:33.897
13676,54,1437,경북,2,2,0,4108,2020-08-23 09:00:00.000,2021-09-16 10:11:33.897
13677,0,196,경남,9,8,1,4107,2020-08-23 09:00:00.000,2021-09-16 10:11:33.897
13678,0,28,제주,0,0,0,4106,2020-08-23 09:00:00.000,2021-09-16 10:11:33.897
13679,0,1318,검역,4,0,4,4105,2020-08-23 09:00:00.000,2021-09-16 10:11:33.897
13680,309,17002,합계,332,315,17,4104,2020-08-22 09:00:00.000,2021-09-16 10:11:33.897
13681,16,2750,서울,129,128,1,4103,2020-08-22 09:00:00.000,2021-09-16 10:11:33.897
13682,3,257,부산,3,3,0,4102,2020-08-22 09:00:00.000,2021-09-16 10:11:33.897
13683,191,6972,대구,9,9,0,4101,2020-08-22 09:00:00.000,2021-09-16 10:11:33.897
13684,3,490,인천,21,20,1,4100,2020-08-22 09:00:00.000,2021-09-16 10:11:33.897
13685,2,262,광주,11,9,2,4099,2020-08-22 09:00:00.000,2021-09-16 10:11:33.897
13686,2,190,대전,5,4,1,4098,2020-08-22 09:00:00.000,2021-09-16 10:11:33.897
13687,1,72,울산,3,1,2,4097,2020-08-22 09:00:00.000,2021-09-16 10:11:33.897
13688,0,57,세종,1,1,0,4096,2020-08-22 09:00:00.000,2021-09-16 10:11:33.897
13689,33,2402,경기,95,91,4,4095,2020-08-22 09:00:00.000,2021-09-16 10:11:33.897
13690,3,120,강원,16,16,0,4094,2020-08-22 09:00:00.000,2021-09-16 10:11:33.897
13691,0,95,충북,2,2,0,4093,2020-08-22 09:00:00.000,2021-09-16 10:11:33.897
13692,1,244,충남,7,6,1,4092,2020-08-22 09:00:00.000,2021-09-16 10:11:33.897
13693,0,67,전북,4,4,0,4091,2020-08-22 09:00:00.000,2021-09-16 10:11:33.897
13694,0,60,전남,7,7,0,4090,2020-08-22 09:00:00.000,2021-09-16 10:11:33.897
13695,54,1435,경북,4,4,0,4089,2020-08-22 09:00:00.000,2021-09-16 10:11:33.897
13696,0,187,경남,9,8,1,4088,2020-08-22 09:00:00.000,2021-09-16 10:11:33.897
13697,0,28,제주,2,2,0,4087,2020-08-22 09:00:00.000,2021-09-16 10:11:33.897
13698,0,1314,검역,4,0,4,4086,2020-08-22 09:00:00.000,2021-09-16 10:11:33.897
13699,309,16670,합계,324,315,9,4085,2020-08-21 09:00:00.000,2021-09-16 10:11:33.897
13700,16,2621,서울,126,125,1,4084,2020-08-21 09:00:00.000,2021-09-16 10:11:33.897
13701,3,254,부산,8,8,0,4083,2020-08-21 09:00:00.000,2021-09-16 10:11:33.897
13702,191,6963,대구,4,4,0,4082,2020-08-21 09:00:00.000,2021-09-16 10:11:33.897
13703,3,469,인천,18,17,1,4081,2020-08-21 09:00:00.000,2021-09-16 10:11:33.897
13704,2,251,광주,5,5,0,4080,2020-08-21 09:00:00.000,2021-09-16 10:11:33.897
13705,2,185,대전,7,6,1,4079,2020-08-21 09:00:00.000,2021-09-16 10:11:33.897
13706,1,69,울산,1,1,0,4078,2020-08-21 09:00:00.000,2021-09-16 10:11:33.897
13707,0,56,세종,3,3,0,4077,2020-08-21 09:00:00.000,2021-09-16 10:11:33.897
13708,33,2307,경기,103,102,1,4076,2020-08-21 09:00:00.000,2021-09-16 10:11:33.897
13709,3,104,강원,9,9,0,4075,2020-08-21 09:00:00.000,2021-09-16 10:11:33.897
13710,0,93,충북,3,3,0,4074,2020-08-21 09:00:00.000,2021-09-16 10:11:33.897
13711,1,237,충남,13,11,2,4073,2020-08-21 09:00:00.000,2021-09-16 10:11:33.897
13712,0,63,전북,5,5,0,4072,2020-08-21 09:00:00.000,2021-09-16 10:11:33.897
13713,0,53,전남,6,6,0,4071,2020-08-21 09:00:00.000,2021-09-16 10:11:33.897
13714,54,1431,경북,6,6,0,4070,2020-08-21 09:00:00.000,2021-09-16 10:11:33.897
13715,0,178,경남,4,4,0,4069,2020-08-21 09:00:00.000,2021-09-16 10:11:33.897
13716,0,26,제주,0,0,0,4068,2020-08-21 09:00:00.000,2021-09-16 10:11:33.897
13717,0,1310,검역,3,0,3,4067,2020-08-21 09:00:00.000,2021-09-16 10:11:33.897
13718,307,16346,합계,288,276,12,4066,2020-08-20 09:00:00.000,2021-09-16 10:11:33.897
13719,15,2495,서울,135,135,0,4065,2020-08-20 09:00:00.000,2021-09-16 10:11:33.897
13720,3,246,부산,15,15,0,4064,2020-08-20 09:00:00.000,2021-09-16 10:11:33.897
13721,191,6959,대구,3,2,1,4063,2020-08-20 09:00:00.000,2021-09-16 10:11:33.897
13722,3,451,인천,10,10,0,4062,2020-08-20 09:00:00.000,2021-09-16 10:11:33.897
13723,2,246,광주,1,1,0,4061,2020-08-20 09:00:00.000,2021-09-16 10:11:33.897
13724,2,178,대전,8,8,0,4060,2020-08-20 09:00:00.000,2021-09-16 10:11:33.897
13725,1,68,울산,0,0,0,4059,2020-08-20 09:00:00.000,2021-09-16 10:11:33.897
13726,0,53,세종,1,0,1,4058,2020-08-20 09:00:00.000,2021-09-16 10:11:33.897
13727,32,2204,경기,85,81,4,4057,2020-08-20 09:00:00.000,2021-09-16 10:11:33.897
13728,3,95,강원,5,5,0,4056,2020-08-20 09:00:00.000,2021-09-16 10:11:33.897
13729,0,90,충북,1,1,0,4055,2020-08-20 09:00:00.000,2021-09-16 10:11:33.897
13730,1,224,충남,5,4,1,4054,2020-08-20 09:00:00.000,2021-09-16 10:11:33.897
13731,0,58,전북,6,5,1,4053,2020-08-20 09:00:00.000,2021-09-16 10:11:33.897
13732,0,47,전남,3,2,1,4052,2020-08-20 09:00:00.000,2021-09-16 10:11:33.897
13733,54,1425,경북,5,5,0,4051,2020-08-20 09:00:00.000,2021-09-16 10:11:33.897
13734,0,174,경남,3,2,1,4050,2020-08-20 09:00:00.000,2021-09-16 10:11:33.897
13735,0,26,제주,0,0,0,4049,2020-08-20 09:00:00.000,2021-09-16 10:11:33.897
13736,0,1307,검역,2,0,2,4048,2020-08-20 09:00:00.000,2021-09-16 10:11:33.897
13737,306,16058,합계,297,283,14,4047,2020-08-19 09:00:00.000,2021-09-16 10:11:33.897
13738,14,2360,서울,151,150,1,4046,2020-08-19 09:00:00.000,2021-09-16 10:11:33.897
13739,3,231,부산,9,9,0,4045,2020-08-19 09:00:00.000,2021-09-16 10:11:33.897
13740,191,6956,대구,2,2,0,4044,2020-08-19 09:00:00.000,2021-09-16 10:11:33.897
13741,3,441,인천,8,8,0,4043,2020-08-19 09:00:00.000,2021-09-16 10:11:33.897
13742,2,245,광주,6,4,2,4042,2020-08-19 09:00:00.000,2021-09-16 10:11:33.897
13743,2,170,대전,0,0,0,4041,2020-08-19 09:00:00.000,2021-09-16 10:11:33.897
13744,1,68,울산,0,0,0,4040,2020-08-19 09:00:00.000,2021-09-16 10:11:33.897
13745,0,52,세종,2,1,1,4039,2020-08-19 09:00:00.000,2021-09-16 10:11:33.897
13746,32,2119,경기,99,94,5,4038,2020-08-19 09:00:00.000,2021-09-16 10:11:33.897
13747,3,90,강원,6,5,1,4037,2020-08-19 09:00:00.000,2021-09-16 10:11:33.897
13748,0,89,충북,2,1,1,4036,2020-08-19 09:00:00.000,2021-09-16 10:11:33.897
13749,1,219,충남,3,3,0,4035,2020-08-19 09:00:00.000,2021-09-16 10:11:33.897
13750,0,52,전북,1,1,0,4034,2020-08-19 09:00:00.000,2021-09-16 10:11:33.897
13751,0,44,전남,2,2,0,4033,2020-08-19 09:00:00.000,2021-09-16 10:11:33.897
13752,54,1420,경북,3,3,0,4032,2020-08-19 09:00:00.000,2021-09-16 10:11:33.897
13753,0,171,경남,1,0,1,4031,2020-08-19 09:00:00.000,2021-09-16 10:11:33.897
13754,0,26,제주,0,0,0,4030,2020-08-19 09:00:00.000,2021-09-16 10:11:33.897
13755,0,1305,검역,2,0,2,4029,2020-08-19 09:00:00.000,2021-09-16 10:11:33.897
13756,306,15761,합계,246,235,11,4028,2020-08-18 09:00:00.000,2021-09-16 10:11:33.897
13757,14,2209,서울,132,131,1,4027,2020-08-18 09:00:00.000,2021-09-16 10:11:33.897
13758,3,222,부산,7,7,0,4026,2020-08-18 09:00:00.000,2021-09-16 10:11:33.897
13759,191,6954,대구,6,6,0,4025,2020-08-18 09:00:00.000,2021-09-16 10:11:33.897
13760,3,433,인천,18,18,0,4024,2020-08-18 09:00:00.000,2021-09-16 10:11:33.897
13761,2,239,광주,4,3,1,4023,2020-08-18 09:00:00.000,2021-09-16 10:11:33.897
13762,2,170,대전,0,0,0,4022,2020-08-18 09:00:00.000,2021-09-16 10:11:33.897
13763,1,68,울산,3,2,1,4021,2020-08-18 09:00:00.000,2021-09-16 10:11:33.897
13764,0,50,세종,0,0,0,4020,2020-08-18 09:00:00.000,2021-09-16 10:11:33.897
13765,32,2020,경기,52,52,0,4019,2020-08-18 09:00:00.000,2021-09-16 10:11:33.897
13766,3,84,강원,2,2,0,4018,2020-08-18 09:00:00.000,2021-09-16 10:11:33.897
13767,0,87,충북,1,1,0,4017,2020-08-18 09:00:00.000,2021-09-16 10:11:33.897
13768,1,216,충남,5,4,1,4016,2020-08-18 09:00:00.000,2021-09-16 10:11:33.897
13769,0,51,전북,7,6,1,4015,2020-08-18 09:00:00.000,2021-09-16 10:11:33.897
13770,0,42,전남,0,0,0,4014,2020-08-18 09:00:00.000,2021-09-16 10:11:33.897
13771,54,1417,경북,3,3,0,4013,2020-08-18 09:00:00.000,2021-09-16 10:11:33.897
13772,0,170,경남,0,0,0,4012,2020-08-18 09:00:00.000,2021-09-16 10:11:33.897
13773,0,26,제주,0,0,0,4011,2020-08-18 09:00:00.000,2021-09-16 10:11:33.897
13774,0,1303,검역,6,0,6,4010,2020-08-18 09:00:00.000,2021-09-16 10:11:33.897
13775,305,15515,합계,197,188,9,4009,2020-08-17 09:00:00.000,2021-09-16 10:11:33.897
13776,13,2077,서울,90,89,1,4008,2020-08-17 09:00:00.000,2021-09-16 10:11:33.897
13777,3,215,부산,7,7,0,4007,2020-08-17 09:00:00.000,2021-09-16 10:11:33.897
13778,191,6948,대구,1,1,0,4006,2020-08-17 09:00:00.000,2021-09-16 10:11:33.897
13779,3,415,인천,7,7,0,4005,2020-08-17 09:00:00.000,2021-09-16 10:11:33.897
13780,2,235,광주,7,7,0,4004,2020-08-17 09:00:00.000,2021-09-16 10:11:33.897
13781,2,170,대전,2,2,0,4003,2020-08-17 09:00:00.000,2021-09-16 10:11:33.897
13782,1,65,울산,0,0,0,4002,2020-08-17 09:00:00.000,2021-09-16 10:11:33.897
13783,0,50,세종,0,0,0,4001,2020-08-17 09:00:00.000,2021-09-16 10:11:33.897
13784,32,1968,경기,70,67,3,4000,2020-08-17 09:00:00.000,2021-09-16 10:11:33.897
13785,3,82,강원,1,1,0,3999,2020-08-17 09:00:00.000,2021-09-16 10:11:33.897
13786,0,86,충북,3,2,1,3998,2020-08-17 09:00:00.000,2021-09-16 10:11:33.897
13787,1,211,충남,4,3,1,3997,2020-08-17 09:00:00.000,2021-09-16 10:11:33.897
13788,0,44,전북,1,1,0,3996,2020-08-17 09:00:00.000,2021-09-16 10:11:33.897
13789,0,42,전남,0,0,0,3995,2020-08-17 09:00:00.000,2021-09-16 10:11:33.897
13790,54,1414,경북,2,1,1,3994,2020-08-17 09:00:00.000,2021-09-16 10:11:33.897
13791,0,170,경남,0,0,0,3993,2020-08-17 09:00:00.000,2021-09-16 10:11:33.897
13792,0,26,제주,0,0,0,3992,2020-08-17 09:00:00.000,2021-09-16 10:11:33.897
13793,0,1297,검역,2,0,2,3991,2020-08-17 09:00:00.000,2021-09-16 10:11:33.897
13794,305,15318,합계,279,267,12,3990,2020-08-16 09:00:00.000,2021-09-16 10:11:33.897
13795,13,1987,서울,146,141,5,3989,2020-08-16 09:00:00.000,2021-09-16 10:11:33.897
13796,3,208,부산,7,6,1,3988,2020-08-16 09:00:00.000,2021-09-16 10:11:33.897
13797,191,6947,대구,1,1,0,3987,2020-08-16 09:00:00.000,2021-09-16 10:11:33.897
13798,3,408,인천,9,8,1,3986,2020-08-16 09:00:00.000,2021-09-16 10:11:33.897
13799,2,228,광주,7,7,0,3985,2020-08-16 09:00:00.000,2021-09-16 10:11:33.897
13800,2,168,대전,0,0,0,3984,2020-08-16 09:00:00.000,2021-09-16 10:11:33.897
13801,1,65,울산,3,1,2,3983,2020-08-16 09:00:00.000,2021-09-16 10:11:33.897
13802,0,50,세종,0,0,0,3982,2020-08-16 09:00:00.000,2021-09-16 10:11:33.897
13803,32,1898,경기,98,96,2,3981,2020-08-16 09:00:00.000,2021-09-16 10:11:33.897
13804,3,81,강원,0,0,0,3980,2020-08-16 09:00:00.000,2021-09-16 10:11:33.897
13805,0,83,충북,1,1,0,3979,2020-08-16 09:00:00.000,2021-09-16 10:11:33.897
13806,1,207,충남,5,5,0,3978,2020-08-16 09:00:00.000,2021-09-16 10:11:33.897
13807,0,43,전북,0,0,0,3977,2020-08-16 09:00:00.000,2021-09-16 10:11:33.897
13808,0,42,전남,0,0,0,3976,2020-08-16 09:00:00.000,2021-09-16 10:11:33.897
13809,54,1412,경북,0,0,0,3975,2020-08-16 09:00:00.000,2021-09-16 10:11:33.897
13810,0,170,경남,2,1,1,3974,2020-08-16 09:00:00.000,2021-09-16 10:11:33.897
13811,0,26,제주,0,0,0,3973,2020-08-16 09:00:00.000,2021-09-16 10:11:33.897
13812,0,1295,검역,0,0,0,3972,2020-08-16 09:00:00.000,2021-09-16 10:11:33.897
13813,305,15039,합계,166,154,12,3971,2020-08-15 09:00:00.000,2021-09-16 10:11:33.897
13814,13,1841,서울,74,71,3,3970,2020-08-15 09:00:00.000,2021-09-16 10:11:33.897
13815,3,201,부산,3,3,0,3969,2020-08-15 09:00:00.000,2021-09-16 10:11:33.897
13816,191,6946,대구,0,0,0,3968,2020-08-15 09:00:00.000,2021-09-16 10:11:33.897
13817,3,399,인천,6,6,0,3967,2020-08-15 09:00:00.000,2021-09-16 10:11:33.897
13818,2,221,광주,1,1,0,3966,2020-08-15 09:00:00.000,2021-09-16 10:11:33.897
13819,2,168,대전,1,1,0,3965,2020-08-15 09:00:00.000,2021-09-16 10:11:33.897
13820,1,62,울산,0,0,0,3964,2020-08-15 09:00:00.000,2021-09-16 10:11:33.897
13821,0,50,세종,0,0,0,3963,2020-08-15 09:00:00.000,2021-09-16 10:11:33.897
13822,32,1800,경기,72,67,5,3962,2020-08-15 09:00:00.000,2021-09-16 10:11:33.897
13823,3,81,강원,3,3,0,3961,2020-08-15 09:00:00.000,2021-09-16 10:11:33.897
13824,0,82,충북,0,0,0,3960,2020-08-15 09:00:00.000,2021-09-16 10:11:33.897
13825,1,202,충남,2,1,1,3959,2020-08-15 09:00:00.000,2021-09-16 10:11:33.897
13826,0,43,전북,1,0,1,3958,2020-08-15 09:00:00.000,2021-09-16 10:11:33.897
13827,0,42,전남,0,0,0,3957,2020-08-15 09:00:00.000,2021-09-16 10:11:33.897
13828,54,1412,경북,0,0,0,3956,2020-08-15 09:00:00.000,2021-09-16 10:11:33.897
13829,0,168,경남,1,1,0,3955,2020-08-15 09:00:00.000,2021-09-16 10:11:33.897
13830,0,26,제주,0,0,0,3954,2020-08-15 09:00:00.000,2021-09-16 10:11:33.897
13831,0,1295,검역,2,0,2,3953,2020-08-15 09:00:00.000,2021-09-16 10:11:33.897
13832,305,14873,합계,103,85,18,3952,2020-08-14 09:00:00.000,2021-09-16 10:11:33.897
13833,13,1767,서울,32,31,1,3951,2020-08-14 09:00:00.000,2021-09-16 10:11:33.897
13834,3,198,부산,5,5,0,3950,2020-08-14 09:00:00.000,2021-09-16 10:11:33.897
13835,191,6946,대구,0,0,0,3949,2020-08-14 09:00:00.000,2021-09-16 10:11:33.897
13836,3,393,인천,4,3,1,3948,2020-08-14 09:00:00.000,2021-09-16 10:11:33.897
13837,2,220,광주,2,2,0,3947,2020-08-14 09:00:00.000,2021-09-16 10:11:33.897
13838,2,167,대전,0,0,0,3946,2020-08-14 09:00:00.000,2021-09-16 10:11:33.897
13839,1,62,울산,1,1,0,3945,2020-08-14 09:00:00.000,2021-09-16 10:11:33.897
13840,0,50,세종,0,0,0,3944,2020-08-14 09:00:00.000,2021-09-16 10:11:33.897
13841,32,1728,경기,47,38,9,3943,2020-08-14 09:00:00.000,2021-09-16 10:11:33.897
13842,3,78,강원,1,1,0,3942,2020-08-14 09:00:00.000,2021-09-16 10:11:33.897
13843,0,82,충북,0,0,0,3941,2020-08-14 09:00:00.000,2021-09-16 10:11:33.897
13844,1,200,충남,3,3,0,3940,2020-08-14 09:00:00.000,2021-09-16 10:11:33.897
13845,0,42,전북,0,0,0,3939,2020-08-14 09:00:00.000,2021-09-16 10:11:33.897
13846,0,42,전남,0,0,0,3938,2020-08-14 09:00:00.000,2021-09-16 10:11:33.897
13847,54,1412,경북,1,1,0,3937,2020-08-14 09:00:00.000,2021-09-16 10:11:33.897
13848,0,167,경남,0,0,0,3936,2020-08-14 09:00:00.000,2021-09-16 10:11:33.897
13849,0,26,제주,0,0,0,3935,2020-08-14 09:00:00.000,2021-09-16 10:11:33.897
13850,0,1293,검역,7,0,7,3934,2020-08-14 09:00:00.000,2021-09-16 10:11:33.897
13851,305,14770,합계,56,47,9,3933,2020-08-13 09:00:00.000,2021-09-16 10:11:33.897
13852,13,1735,서울,26,25,1,3932,2020-08-13 09:00:00.000,2021-09-16 10:11:33.897
13853,3,193,부산,2,2,0,3931,2020-08-13 09:00:00.000,2021-09-16 10:11:33.897
13854,191,6946,대구,1,0,1,3930,2020-08-13 09:00:00.000,2021-09-16 10:11:33.897
13855,3,389,인천,0,0,0,3929,2020-08-13 09:00:00.000,2021-09-16 10:11:33.897
13856,2,218,광주,2,1,1,3928,2020-08-13 09:00:00.000,2021-09-16 10:11:33.897
13857,2,167,대전,0,0,0,3927,2020-08-13 09:00:00.000,2021-09-16 10:11:33.897
13858,1,61,울산,1,1,0,3926,2020-08-13 09:00:00.000,2021-09-16 10:11:33.897
13859,0,50,세종,0,0,0,3925,2020-08-13 09:00:00.000,2021-09-16 10:11:33.897
13860,32,1681,경기,17,16,1,3924,2020-08-13 09:00:00.000,2021-09-16 10:11:33.897
13861,3,77,강원,0,0,0,3923,2020-08-13 09:00:00.000,2021-09-16 10:11:33.897
13862,0,82,충북,0,0,0,3922,2020-08-13 09:00:00.000,2021-09-16 10:11:33.897
13863,1,197,충남,1,1,0,3921,2020-08-13 09:00:00.000,2021-09-16 10:11:33.897
13864,0,42,전북,2,0,2,3920,2020-08-13 09:00:00.000,2021-09-16 10:11:33.897
13865,0,42,전남,0,0,0,3919,2020-08-13 09:00:00.000,2021-09-16 10:11:33.897
13866,54,1411,경북,0,0,0,3918,2020-08-13 09:00:00.000,2021-09-16 10:11:33.897
13867,0,167,경남,1,1,0,3917,2020-08-13 09:00:00.000,2021-09-16 10:11:33.897
13868,0,26,제주,0,0,0,3916,2020-08-13 09:00:00.000,2021-09-16 10:11:33.897
13869,0,1286,검역,3,0,3,3915,2020-08-13 09:00:00.000,2021-09-16 10:11:33.897
13870,305,14714,합계,54,35,19,3914,2020-08-12 09:00:00.000,2021-09-16 10:11:33.897
13871,13,1709,서울,15,13,2,3913,2020-08-12 09:00:00.000,2021-09-16 10:11:33.897
13872,3,191,부산,4,3,1,3912,2020-08-12 09:00:00.000,2021-09-16 10:11:33.897
13873,191,6945,대구,0,0,0,3911,2020-08-12 09:00:00.000,2021-09-16 10:11:33.897
13874,3,389,인천,0,0,0,3910,2020-08-12 09:00:00.000,2021-09-16 10:11:33.897
13875,2,216,광주,6,0,6,3909,2020-08-12 09:00:00.000,2021-09-16 10:11:33.897
13876,2,167,대전,1,0,1,3908,2020-08-12 09:00:00.000,2021-09-16 10:11:33.897
13877,1,60,울산,0,0,0,3907,2020-08-12 09:00:00.000,2021-09-16 10:11:33.897
13878,0,50,세종,0,0,0,3906,2020-08-12 09:00:00.000,2021-09-16 10:11:33.897
13879,32,1664,경기,19,19,0,3905,2020-08-12 09:00:00.000,2021-09-16 10:11:33.897
13880,3,77,강원,0,0,0,3904,2020-08-12 09:00:00.000,2021-09-16 10:11:33.897
13881,0,82,충북,0,0,0,3903,2020-08-12 09:00:00.000,2021-09-16 10:11:33.897
13882,1,196,충남,1,0,1,3902,2020-08-12 09:00:00.000,2021-09-16 10:11:33.897
13883,0,40,전북,0,0,0,3901,2020-08-12 09:00:00.000,2021-09-16 10:11:33.897
13884,0,42,전남,0,0,0,3900,2020-08-12 09:00:00.000,2021-09-16 10:11:33.897
13885,54,1411,경북,0,0,0,3899,2020-08-12 09:00:00.000,2021-09-16 10:11:33.897
13886,0,166,경남,0,0,0,3898,2020-08-12 09:00:00.000,2021-09-16 10:11:33.897
13887,0,26,제주,0,0,0,3897,2020-08-12 09:00:00.000,2021-09-16 10:11:33.897
13888,0,1283,검역,8,0,8,3896,2020-08-12 09:00:00.000,2021-09-16 10:11:33.897
13889,305,14660,합계,34,23,11,3895,2020-08-11 09:00:00.000,2021-09-16 10:11:33.897
13890,13,1694,서울,6,6,0,3894,2020-08-11 09:00:00.000,2021-09-16 10:11:33.897
13891,3,187,부산,9,9,0,3893,2020-08-11 09:00:00.000,2021-09-16 10:11:33.897
13892,191,6945,대구,0,0,0,3892,2020-08-11 09:00:00.000,2021-09-16 10:11:33.897
13893,3,389,인천,0,0,0,3891,2020-08-11 09:00:00.000,2021-09-16 10:11:33.897
13894,2,210,광주,0,0,0,3890,2020-08-11 09:00:00.000,2021-09-16 10:11:33.897
13895,2,166,대전,0,0,0,3889,2020-08-11 09:00:00.000,2021-09-16 10:11:33.897
13896,1,60,울산,0,0,0,3888,2020-08-11 09:00:00.000,2021-09-16 10:11:33.897
13897,0,50,세종,0,0,0,3887,2020-08-11 09:00:00.000,2021-09-16 10:11:33.897
13898,32,1645,경기,13,7,6,3886,2020-08-11 09:00:00.000,2021-09-16 10:11:33.897
13899,3,77,강원,0,0,0,3885,2020-08-11 09:00:00.000,2021-09-16 10:11:33.897
13900,0,82,충북,0,0,0,3884,2020-08-11 09:00:00.000,2021-09-16 10:11:33.897
13901,1,195,충남,2,1,1,3883,2020-08-11 09:00:00.000,2021-09-16 10:11:33.897
13902,0,40,전북,1,0,1,3882,2020-08-11 09:00:00.000,2021-09-16 10:11:33.897
13903,0,42,전남,0,0,0,3881,2020-08-11 09:00:00.000,2021-09-16 10:11:33.897
13904,54,1411,경북,0,0,0,3880,2020-08-11 09:00:00.000,2021-09-16 10:11:33.897
13905,0,166,경남,0,0,0,3879,2020-08-11 09:00:00.000,2021-09-16 10:11:33.897
13906,0,26,제주,0,0,0,3878,2020-08-11 09:00:00.000,2021-09-16 10:11:33.897
13907,0,1275,검역,3,0,3,3877,2020-08-11 09:00:00.000,2021-09-16 10:11:33.897
13908,305,14626,합계,28,17,11,3876,2020-08-10 09:00:00.000,2021-09-16 10:11:33.897
13909,13,1688,서울,13,11,2,3875,2020-08-10 09:00:00.000,2021-09-16 10:11:33.897
13910,3,178,부산,1,1,0,3874,2020-08-10 09:00:00.000,2021-09-16 10:11:33.897
13911,191,6945,대구,0,0,0,3873,2020-08-10 09:00:00.000,2021-09-16 10:11:33.897
13912,3,389,인천,0,0,0,3872,2020-08-10 09:00:00.000,2021-09-16 10:11:33.897
13913,2,210,광주,0,0,0,3871,2020-08-10 09:00:00.000,2021-09-16 10:11:33.897
13914,2,166,대전,0,0,0,3870,2020-08-10 09:00:00.000,2021-09-16 10:11:33.897
13915,1,60,울산,0,0,0,3869,2020-08-10 09:00:00.000,2021-09-16 10:11:33.897
13916,0,50,세종,0,0,0,3868,2020-08-10 09:00:00.000,2021-09-16 10:11:33.897
13917,32,1632,경기,6,5,1,3867,2020-08-10 09:00:00.000,2021-09-16 10:11:33.897
13918,3,77,강원,0,0,0,3866,2020-08-10 09:00:00.000,2021-09-16 10:11:33.897
13919,0,82,충북,0,0,0,3865,2020-08-10 09:00:00.000,2021-09-16 10:11:33.897
13920,1,193,충남,0,0,0,3864,2020-08-10 09:00:00.000,2021-09-16 10:11:33.897
13921,0,39,전북,0,0,0,3863,2020-08-10 09:00:00.000,2021-09-16 10:11:33.897
13922,0,42,전남,1,0,1,3862,2020-08-10 09:00:00.000,2021-09-16 10:11:33.897
13923,54,1411,경북,1,0,1,3861,2020-08-10 09:00:00.000,2021-09-16 10:11:33.897
13924,0,166,경남,0,0,0,3860,2020-08-10 09:00:00.000,2021-09-16 10:11:33.897
13925,0,26,제주,0,0,0,3859,2020-08-10 09:00:00.000,2021-09-16 10:11:33.897
13926,0,1272,검역,6,0,6,3858,2020-08-10 09:00:00.000,2021-09-16 10:11:33.897
13927,305,14598,합계,36,30,6,3857,2020-08-09 09:00:00.000,2021-09-16 10:11:33.897
13928,13,1675,서울,13,11,2,3856,2020-08-09 09:00:00.000,2021-09-16 10:11:33.897
13929,3,177,부산,0,0,0,3855,2020-08-09 09:00:00.000,2021-09-16 10:11:33.897
13930,191,6945,대구,1,0,1,3854,2020-08-09 09:00:00.000,2021-09-16 10:11:33.897
13931,3,389,인천,1,1,0,3853,2020-08-09 09:00:00.000,2021-09-16 10:11:33.897
13932,2,210,광주,2,2,0,3852,2020-08-09 09:00:00.000,2021-09-16 10:11:33.897
13933,2,166,대전,0,0,0,3851,2020-08-09 09:00:00.000,2021-09-16 10:11:33.897
13934,1,60,울산,1,0,1,3850,2020-08-09 09:00:00.000,2021-09-16 10:11:33.897
13935,0,50,세종,0,0,0,3849,2020-08-09 09:00:00.000,2021-09-16 10:11:33.897
13936,32,1626,경기,15,14,1,3848,2020-08-09 09:00:00.000,2021-09-16 10:11:33.897
13937,3,77,강원,0,0,0,3847,2020-08-09 09:00:00.000,2021-09-16 10:11:33.897
13938,0,82,충북,1,1,0,3846,2020-08-09 09:00:00.000,2021-09-16 10:11:33.897
13939,1,193,충남,1,1,0,3845,2020-08-09 09:00:00.000,2021-09-16 10:11:33.897
13940,0,39,전북,0,0,0,3844,2020-08-09 09:00:00.000,2021-09-16 10:11:33.897
13941,0,41,전남,0,0,0,3843,2020-08-09 09:00:00.000,2021-09-16 10:11:33.897
13942,54,1410,경북,0,0,0,3842,2020-08-09 09:00:00.000,2021-09-16 10:11:33.897
13943,0,166,경남,0,0,0,3841,2020-08-09 09:00:00.000,2021-09-16 10:11:33.897
13944,0,26,제주,0,0,0,3840,2020-08-09 09:00:00.000,2021-09-16 10:11:33.897
13945,0,1266,검역,1,0,1,3839,2020-08-09 09:00:00.000,2021-09-16 10:11:33.897
13946,304,14562,합계,43,30,13,3838,2020-08-08 09:00:00.000,2021-09-16 10:11:33.897
13947,13,1662,서울,17,16,1,3837,2020-08-08 09:00:00.000,2021-09-16 10:11:33.897
13948,3,177,부산,0,0,0,3836,2020-08-08 09:00:00.000,2021-09-16 10:11:33.897
13949,191,6944,대구,1,0,1,3835,2020-08-08 09:00:00.000,2021-09-16 10:11:33.897
13950,2,388,인천,2,2,0,3834,2020-08-08 09:00:00.000,2021-09-16 10:11:33.897
13951,2,208,광주,0,0,0,3833,2020-08-08 09:00:00.000,2021-09-16 10:11:33.897
13952,2,166,대전,0,0,0,3832,2020-08-08 09:00:00.000,2021-09-16 10:11:33.897
13953,1,59,울산,0,0,0,3831,2020-08-08 09:00:00.000,2021-09-16 10:11:33.897
13954,0,50,세종,0,0,0,3830,2020-08-08 09:00:00.000,2021-09-16 10:11:33.897
13955,32,1611,경기,18,12,6,3829,2020-08-08 09:00:00.000,2021-09-16 10:11:33.897
13956,3,77,강원,0,0,0,3828,2020-08-08 09:00:00.000,2021-09-16 10:11:33.897
13957,0,81,충북,0,0,0,3827,2020-08-08 09:00:00.000,2021-09-16 10:11:33.897
13958,1,192,충남,0,0,0,3826,2020-08-08 09:00:00.000,2021-09-16 10:11:33.897
13959,0,39,전북,0,0,0,3825,2020-08-08 09:00:00.000,2021-09-16 10:11:33.897
13960,0,41,전남,0,0,0,3824,2020-08-08 09:00:00.000,2021-09-16 10:11:33.897
13961,54,1410,경북,0,0,0,3823,2020-08-08 09:00:00.000,2021-09-16 10:11:33.897
13962,0,166,경남,0,0,0,3822,2020-08-08 09:00:00.000,2021-09-16 10:11:33.897
13963,0,26,제주,0,0,0,3821,2020-08-08 09:00:00.000,2021-09-16 10:11:33.897
13964,0,1265,검역,5,0,5,3820,2020-08-08 09:00:00.000,2021-09-16 10:11:33.897
13965,303,14519,합계,20,9,11,3819,2020-08-07 09:00:00.000,2021-09-16 10:11:33.897
13966,13,1645,서울,9,6,3,3818,2020-08-07 09:00:00.000,2021-09-16 10:11:33.897
13967,3,177,부산,0,0,0,3817,2020-08-07 09:00:00.000,2021-09-16 10:11:33.897
13968,191,6943,대구,0,0,0,3816,2020-08-07 09:00:00.000,2021-09-16 10:11:33.897
13969,2,386,인천,0,0,0,3815,2020-08-07 09:00:00.000,2021-09-16 10:11:33.897
13970,2,208,광주,0,0,0,3814,2020-08-07 09:00:00.000,2021-09-16 10:11:33.897
13971,2,166,대전,0,0,0,3813,2020-08-07 09:00:00.000,2021-09-16 10:11:33.897
13972,1,59,울산,0,0,0,3812,2020-08-07 09:00:00.000,2021-09-16 10:11:33.897
13973,0,50,세종,0,0,0,3811,2020-08-07 09:00:00.000,2021-09-16 10:11:33.897
13974,31,1593,경기,5,3,2,3810,2020-08-07 09:00:00.000,2021-09-16 10:11:33.897
13975,3,77,강원,0,0,0,3809,2020-08-07 09:00:00.000,2021-09-16 10:11:33.897
13976,0,81,충북,0,0,0,3808,2020-08-07 09:00:00.000,2021-09-16 10:11:33.897
13977,1,192,충남,0,0,0,3807,2020-08-07 09:00:00.000,2021-09-16 10:11:33.897
13978,0,39,전북,0,0,0,3806,2020-08-07 09:00:00.000,2021-09-16 10:11:33.897
13979,0,41,전남,0,0,0,3805,2020-08-07 09:00:00.000,2021-09-16 10:11:33.897
13980,54,1410,경북,1,0,1,3804,2020-08-07 09:00:00.000,2021-09-16 10:11:33.897
13981,0,166,경남,0,0,0,3803,2020-08-07 09:00:00.000,2021-09-16 10:11:33.897
13982,0,26,제주,0,0,0,3802,2020-08-07 09:00:00.000,2021-09-16 10:11:33.897
13983,0,1260,검역,5,0,5,3801,2020-08-07 09:00:00.000,2021-09-16 10:11:33.897
13984,302,14499,합계,43,23,20,3800,2020-08-06 09:00:00.000,2021-09-16 10:11:33.897
13985,12,1636,서울,9,5,4,3799,2020-08-06 09:00:00.000,2021-09-16 10:11:33.897
13986,3,177,부산,3,3,0,3798,2020-08-06 09:00:00.000,2021-09-16 10:11:33.897
13987,191,6943,대구,0,0,0,3797,2020-08-06 09:00:00.000,2021-09-16 10:11:33.897
13988,2,386,인천,0,0,0,3796,2020-08-06 09:00:00.000,2021-09-16 10:11:33.897
13989,2,208,광주,0,0,0,3795,2020-08-06 09:00:00.000,2021-09-16 10:11:33.897
13990,2,166,대전,0,0,0,3794,2020-08-06 09:00:00.000,2021-09-16 10:11:33.897
13991,1,59,울산,0,0,0,3793,2020-08-06 09:00:00.000,2021-09-16 10:11:33.897
13992,0,50,세종,0,0,0,3792,2020-08-06 09:00:00.000,2021-09-16 10:11:33.897
13993,31,1588,경기,13,11,2,3791,2020-08-06 09:00:00.000,2021-09-16 10:11:33.897
13994,3,77,강원,2,0,2,3790,2020-08-06 09:00:00.000,2021-09-16 10:11:33.897
13995,0,81,충북,1,0,1,3789,2020-08-06 09:00:00.000,2021-09-16 10:11:33.897
13996,1,192,충남,2,1,1,3788,2020-08-06 09:00:00.000,2021-09-16 10:11:33.897
13997,0,39,전북,0,0,0,3787,2020-08-06 09:00:00.000,2021-09-16 10:11:33.897
13998,0,41,전남,2,1,1,3786,2020-08-06 09:00:00.000,2021-09-16 10:11:33.897
13999,54,1409,경북,4,2,2,3785,2020-08-06 09:00:00.000,2021-09-16 10:11:33.897
14000,0,166,경남,1,0,1,3784,2020-08-06 09:00:00.000,2021-09-16 10:11:33.897
14001,0,26,제주,0,0,0,3783,2020-08-06 09:00:00.000,2021-09-16 10:11:33.897
14002,0,1255,검역,6,0,6,3782,2020-08-06 09:00:00.000,2021-09-16 10:11:33.897
14003,302,14456,합계,33,13,20,3781,2020-08-05 09:00:00.000,2021-09-16 10:11:33.897
14004,12,1627,서울,6,5,1,3780,2020-08-05 09:00:00.000,2021-09-16 10:11:33.897
14005,3,174,부산,0,0,0,3779,2020-08-05 09:00:00.000,2021-09-16 10:11:33.897
14006,191,6943,대구,1,0,1,3778,2020-08-05 09:00:00.000,2021-09-16 10:11:33.897
14007,2,386,인천,1,1,0,3777,2020-08-05 09:00:00.000,2021-09-16 10:11:33.897
14008,2,208,광주,1,0,1,3776,2020-08-05 09:00:00.000,2021-09-16 10:11:33.897
14009,2,166,대전,0,0,0,3775,2020-08-05 09:00:00.000,2021-09-16 10:11:33.897
14010,1,59,울산,0,0,0,3774,2020-08-05 09:00:00.000,2021-09-16 10:11:33.897
14011,0,50,세종,0,0,0,3773,2020-08-05 09:00:00.000,2021-09-16 10:11:33.897
14012,31,1575,경기,7,2,5,3772,2020-08-05 09:00:00.000,2021-09-16 10:11:33.897
14013,3,75,강원,1,0,1,3771,2020-08-05 09:00:00.000,2021-09-16 10:11:33.897
14014,0,80,충북,6,5,1,3770,2020-08-05 09:00:00.000,2021-09-16 10:11:33.897
14015,1,190,충남,0,0,0,3769,2020-08-05 09:00:00.000,2021-09-16 10:11:33.897
14016,0,39,전북,0,0,0,3768,2020-08-05 09:00:00.000,2021-09-16 10:11:33.897
14017,0,39,전남,0,0,0,3767,2020-08-05 09:00:00.000,2021-09-16 10:11:33.897
14018,54,1405,경북,0,0,0,3766,2020-08-05 09:00:00.000,2021-09-16 10:11:33.897
14019,0,165,경남,4,0,4,3765,2020-08-05 09:00:00.000,2021-09-16 10:11:33.897
14020,0,26,제주,0,0,0,3764,2020-08-05 09:00:00.000,2021-09-16 10:11:33.897
14021,0,1249,검역,6,0,6,3763,2020-08-05 09:00:00.000,2021-09-16 10:11:33.897
14022,301,14423,합계,34,13,21,3762,2020-08-04 09:00:00.000,2021-09-16 10:11:33.897
14023,11,1621,서울,9,6,3,3761,2020-08-04 09:00:00.000,2021-09-16 10:11:33.897
14024,3,174,부산,1,1,0,3760,2020-08-04 09:00:00.000,2021-09-16 10:11:33.897
14025,191,6942,대구,0,0,0,3759,2020-08-04 09:00:00.000,2021-09-16 10:11:33.897
14026,2,385,인천,1,1,0,3758,2020-08-04 09:00:00.000,2021-09-16 10:11:33.897
14027,2,207,광주,2,1,1,3757,2020-08-04 09:00:00.000,2021-09-16 10:11:33.897
14028,2,166,대전,0,0,0,3756,2020-08-04 09:00:00.000,2021-09-16 10:11:33.897
14029,1,59,울산,0,0,0,3755,2020-08-04 09:00:00.000,2021-09-16 10:11:33.897
14030,0,50,세종,0,0,0,3754,2020-08-04 09:00:00.000,2021-09-16 10:11:33.897
14031,31,1568,경기,11,3,8,3753,2020-08-04 09:00:00.000,2021-09-16 10:11:33.897
14032,3,74,강원,0,0,0,3752,2020-08-04 09:00:00.000,2021-09-16 10:11:33.897
14033,0,74,충북,1,0,1,3751,2020-08-04 09:00:00.000,2021-09-16 10:11:33.897
14034,1,190,충남,0,0,0,3750,2020-08-04 09:00:00.000,2021-09-16 10:11:33.897
14035,0,39,전북,0,0,0,3749,2020-08-04 09:00:00.000,2021-09-16 10:11:33.897
14036,0,39,전남,1,0,1,3748,2020-08-04 09:00:00.000,2021-09-16 10:11:33.897
14037,54,1405,경북,1,1,0,3747,2020-08-04 09:00:00.000,2021-09-16 10:11:33.897
14038,0,161,경남,0,0,0,3746,2020-08-04 09:00:00.000,2021-09-16 10:11:33.897
14039,0,26,제주,0,0,0,3745,2020-08-04 09:00:00.000,2021-09-16 10:11:33.897
14040,0,1243,검역,7,0,7,3744,2020-08-04 09:00:00.000,2021-09-16 10:11:33.897
14041,301,14389,합계,23,3,20,3743,2020-08-03 09:00:00.000,2021-09-16 10:11:33.897
14042,11,1612,서울,5,2,3,3742,2020-08-03 09:00:00.000,2021-09-16 10:11:33.897
14043,3,173,부산,0,0,0,3741,2020-08-03 09:00:00.000,2021-09-16 10:11:33.897
14044,191,6942,대구,0,0,0,3740,2020-08-03 09:00:00.000,2021-09-16 10:11:33.897
14045,2,384,인천,0,0,0,3739,2020-08-03 09:00:00.000,2021-09-16 10:11:33.897
14046,2,205,광주,0,0,0,3738,2020-08-03 09:00:00.000,2021-09-16 10:11:33.897
14047,2,166,대전,0,0,0,3737,2020-08-03 09:00:00.000,2021-09-16 10:11:33.897
14048,1,59,울산,0,0,0,3736,2020-08-03 09:00:00.000,2021-09-16 10:11:33.897
14049,0,50,세종,0,0,0,3735,2020-08-03 09:00:00.000,2021-09-16 10:11:33.897
14050,31,1557,경기,1,1,0,3734,2020-08-03 09:00:00.000,2021-09-16 10:11:33.897
14051,3,74,강원,0,0,0,3733,2020-08-03 09:00:00.000,2021-09-16 10:11:33.897
14052,0,73,충북,0,0,0,3732,2020-08-03 09:00:00.000,2021-09-16 10:11:33.897
14053,1,190,충남,0,0,0,3731,2020-08-03 09:00:00.000,2021-09-16 10:11:33.897
14054,0,39,전북,0,0,0,3730,2020-08-03 09:00:00.000,2021-09-16 10:11:33.897
14055,0,38,전남,0,0,0,3729,2020-08-03 09:00:00.000,2021-09-16 10:11:33.897
14056,54,1404,경북,1,0,1,3728,2020-08-03 09:00:00.000,2021-09-16 10:11:33.897
14057,0,161,경남,2,0,2,3727,2020-08-03 09:00:00.000,2021-09-16 10:11:33.897
14058,0,26,제주,0,0,0,3726,2020-08-03 09:00:00.000,2021-09-16 10:11:33.897
14059,0,1236,검역,14,0,14,3725,2020-08-03 09:00:00.000,2021-09-16 10:11:33.897
14060,301,14366,합계,30,8,22,3724,2020-08-02 09:00:00.000,2021-09-16 10:11:33.897
14061,11,1607,서울,5,5,0,3723,2020-08-02 09:00:00.000,2021-09-16 10:11:33.897
14062,3,173,부산,1,1,0,3722,2020-08-02 09:00:00.000,2021-09-16 10:11:33.897
14063,191,6942,대구,2,0,2,3721,2020-08-02 09:00:00.000,2021-09-16 10:11:33.897
14064,2,384,인천,0,0,0,3720,2020-08-02 09:00:00.000,2021-09-16 10:11:33.897
14065,2,205,광주,1,0,1,3719,2020-08-02 09:00:00.000,2021-09-16 10:11:33.897
14066,2,166,대전,0,0,0,3718,2020-08-02 09:00:00.000,2021-09-16 10:11:33.897
14067,1,59,울산,0,0,0,3717,2020-08-02 09:00:00.000,2021-09-16 10:11:33.897
14068,0,50,세종,0,0,0,3716,2020-08-02 09:00:00.000,2021-09-16 10:11:33.897
14069,31,1556,경기,3,1,2,3715,2020-08-02 09:00:00.000,2021-09-16 10:11:33.897
14070,3,74,강원,0,0,0,3714,2020-08-02 09:00:00.000,2021-09-16 10:11:33.897
14071,0,73,충북,0,0,0,3713,2020-08-02 09:00:00.000,2021-09-16 10:11:33.897
14072,1,190,충남,0,0,0,3712,2020-08-02 09:00:00.000,2021-09-16 10:11:33.897
14073,0,39,전북,0,0,0,3711,2020-08-02 09:00:00.000,2021-09-16 10:11:33.897
14074,0,38,전남,0,0,0,3710,2020-08-02 09:00:00.000,2021-09-16 10:11:33.897
14075,54,1403,경북,1,1,0,3709,2020-08-02 09:00:00.000,2021-09-16 10:11:33.897
14076,0,159,경남,0,0,0,3708,2020-08-02 09:00:00.000,2021-09-16 10:11:33.897
14077,0,26,제주,0,0,0,3707,2020-08-02 09:00:00.000,2021-09-16 10:11:33.897
14078,0,1222,검역,17,0,17,3706,2020-08-02 09:00:00.000,2021-09-16 10:11:33.897
14079,301,14336,합계,31,8,23,3705,2020-08-01 09:00:00.000,2021-09-16 10:11:33.897
14080,11,1602,서울,2,2,0,3704,2020-08-01 09:00:00.000,2021-09-16 10:11:33.897
14081,3,172,부산,1,0,1,3703,2020-08-01 09:00:00.000,2021-09-16 10:11:33.897
14082,191,6940,대구,0,0,0,3702,2020-08-01 09:00:00.000,2021-09-16 10:11:33.897
14083,2,384,인천,1,0,1,3701,2020-08-01 09:00:00.000,2021-09-16 10:11:33.897
14084,2,204,광주,0,0,0,3700,2020-08-01 09:00:00.000,2021-09-16 10:11:33.897
14085,2,166,대전,0,0,0,3699,2020-08-01 09:00:00.000,2021-09-16 10:11:33.897
14086,1,59,울산,0,0,0,3698,2020-08-01 09:00:00.000,2021-09-16 10:11:33.897
14087,0,50,세종,0,0,0,3697,2020-08-01 09:00:00.000,2021-09-16 10:11:33.897
14088,31,1553,경기,7,5,2,3696,2020-08-01 09:00:00.000,2021-09-16 10:11:33.897
14089,3,74,강원,0,0,0,3695,2020-08-01 09:00:00.000,2021-09-16 10:11:33.897
14090,0,73,충북,0,0,0,3694,2020-08-01 09:00:00.000,2021-09-16 10:11:33.897
14091,1,190,충남,0,0,0,3693,2020-08-01 09:00:00.000,2021-09-16 10:11:33.897
14092,0,39,전북,0,0,0,3692,2020-08-01 09:00:00.000,2021-09-16 10:11:33.897
14093,0,38,전남,0,0,0,3691,2020-08-01 09:00:00.000,2021-09-16 10:11:33.897
14094,54,1402,경북,1,1,0,3690,2020-08-01 09:00:00.000,2021-09-16 10:11:33.897
14095,0,159,경남,0,0,0,3689,2020-08-01 09:00:00.000,2021-09-16 10:11:33.897
14096,0,26,제주,0,0,0,3688,2020-08-01 09:00:00.000,2021-09-16 10:11:33.897
14097,0,1205,검역,19,0,19,3687,2020-08-01 09:00:00.000,2021-09-16 10:11:33.897
14098,301,14305,합계,36,14,22,3686,2020-07-31 09:00:00.000,2021-09-16 10:11:33.897
14099,11,1600,서울,8,8,0,3685,2020-07-31 09:00:00.000,2021-09-16 10:11:33.897
14100,3,171,부산,0,0,0,3684,2020-07-31 09:00:00.000,2021-09-16 10:11:33.897
14101,191,6940,대구,1,0,1,3683,2020-07-31 09:00:00.000,2021-09-16 10:11:33.897
14102,2,383,인천,0,0,0,3682,2020-07-31 09:00:00.000,2021-09-16 10:11:33.897
14103,2,204,광주,0,0,0,3681,2020-07-31 09:00:00.000,2021-09-16 10:11:33.897
14104,2,166,대전,0,0,0,3680,2020-07-31 09:00:00.000,2021-09-16 10:11:33.897
14105,1,59,울산,0,0,0,3679,2020-07-31 09:00:00.000,2021-09-16 10:11:33.897
14106,0,50,세종,0,0,0,3678,2020-07-31 09:00:00.000,2021-09-16 10:11:33.897
14107,31,1546,경기,10,4,6,3677,2020-07-31 09:00:00.000,2021-09-16 10:11:33.897
14108,3,74,강원,2,2,0,3676,2020-07-31 09:00:00.000,2021-09-16 10:11:33.897
14109,0,73,충북,0,0,0,3675,2020-07-31 09:00:00.000,2021-09-16 10:11:33.897
14110,1,190,충남,1,0,1,3674,2020-07-31 09:00:00.000,2021-09-16 10:11:33.897
14111,0,39,전북,0,0,0,3673,2020-07-31 09:00:00.000,2021-09-16 10:11:33.897
14112,0,38,전남,0,0,0,3672,2020-07-31 09:00:00.000,2021-09-16 10:11:33.897
14113,54,1401,경북,2,0,2,3671,2020-07-31 09:00:00.000,2021-09-16 10:11:33.897
14114,0,159,경남,0,0,0,3670,2020-07-31 09:00:00.000,2021-09-16 10:11:33.897
14115,0,26,제주,0,0,0,3669,2020-07-31 09:00:00.000,2021-09-16 10:11:33.897
14116,0,1186,검역,12,0,12,3668,2020-07-31 09:00:00.000,2021-09-16 10:11:33.897
14117,300,14269,합계,18,7,11,3667,2020-07-30 09:00:00.000,2021-09-16 10:11:33.897
14118,11,1592,서울,3,3,0,3666,2020-07-30 09:00:00.000,2021-09-16 10:11:33.897
14119,3,171,부산,0,0,0,3665,2020-07-30 09:00:00.000,2021-09-16 10:11:33.897
14120,191,6939,대구,0,0,0,3664,2020-07-30 09:00:00.000,2021-09-16 10:11:33.897
14121,2,383,인천,0,0,0,3663,2020-07-30 09:00:00.000,2021-09-16 10:11:33.897
14122,2,204,광주,0,0,0,3662,2020-07-30 09:00:00.000,2021-09-16 10:11:33.897
14123,2,166,대전,0,0,0,3661,2020-07-30 09:00:00.000,2021-09-16 10:11:33.897
14124,1,59,울산,0,0,0,3660,2020-07-30 09:00:00.000,2021-09-16 10:11:33.897
14125,0,50,세종,0,0,0,3659,2020-07-30 09:00:00.000,2021-09-16 10:11:33.897
14126,30,1536,경기,5,4,1,3658,2020-07-30 09:00:00.000,2021-09-16 10:11:33.897
14127,3,72,강원,0,0,0,3657,2020-07-30 09:00:00.000,2021-09-16 10:11:33.897
14128,0,73,충북,0,0,0,3656,2020-07-30 09:00:00.000,2021-09-16 10:11:33.897
14129,1,189,충남,0,0,0,3655,2020-07-30 09:00:00.000,2021-09-16 10:11:33.897
14130,0,39,전북,0,0,0,3654,2020-07-30 09:00:00.000,2021-09-16 10:11:33.897
14131,0,38,전남,0,0,0,3653,2020-07-30 09:00:00.000,2021-09-16 10:11:33.897
14132,54,1399,경북,1,0,1,3652,2020-07-30 09:00:00.000,2021-09-16 10:11:33.897
14133,0,159,경남,1,0,1,3651,2020-07-30 09:00:00.000,2021-09-16 10:11:33.897
14134,0,26,제주,0,0,0,3650,2020-07-30 09:00:00.000,2021-09-16 10:11:33.897
14135,0,1174,검역,8,0,8,3649,2020-07-30 09:00:00.000,2021-09-16 10:11:33.897
14136,300,14251,합계,48,14,34,3648,2020-07-29 09:00:00.000,2021-09-16 10:11:33.897
14137,11,1589,서울,9,7,2,3647,2020-07-29 09:00:00.000,2021-09-16 10:11:33.897
14138,3,171,부산,1,1,0,3646,2020-07-29 09:00:00.000,2021-09-16 10:11:33.897
14139,191,6939,대구,0,0,0,3645,2020-07-29 09:00:00.000,2021-09-16 10:11:33.897
14140,2,383,인천,3,1,2,3644,2020-07-29 09:00:00.000,2021-09-16 10:11:33.897
14141,2,204,광주,1,0,1,3643,2020-07-29 09:00:00.000,2021-09-16 10:11:33.897
14142,2,166,대전,0,0,0,3642,2020-07-29 09:00:00.000,2021-09-16 10:11:33.897
14143,1,59,울산,1,0,1,3641,2020-07-29 09:00:00.000,2021-09-16 10:11:33.897
14144,0,50,세종,0,0,0,3640,2020-07-29 09:00:00.000,2021-09-16 10:11:33.897
14145,30,1531,경기,11,5,6,3639,2020-07-29 09:00:00.000,2021-09-16 10:11:33.897
14146,3,72,강원,0,0,0,3638,2020-07-29 09:00:00.000,2021-09-16 10:11:33.897
14147,0,73,충북,0,0,0,3637,2020-07-29 09:00:00.000,2021-09-16 10:11:33.897
14148,1,189,충남,0,0,0,3636,2020-07-29 09:00:00.000,2021-09-16 10:11:33.897
14149,0,39,전북,0,0,0,3635,2020-07-29 09:00:00.000,2021-09-16 10:11:33.897
14150,0,38,전남,0,0,0,3634,2020-07-29 09:00:00.000,2021-09-16 10:11:33.897
14151,54,1398,경북,1,0,1,3633,2020-07-29 09:00:00.000,2021-09-16 10:11:33.897
14152,0,158,경남,0,0,0,3632,2020-07-29 09:00:00.000,2021-09-16 10:11:33.897
14153,0,26,제주,0,0,0,3631,2020-07-29 09:00:00.000,2021-09-16 10:11:33.897
14154,0,1166,검역,21,0,21,3630,2020-07-29 09:00:00.000,2021-09-16 10:11:33.897
14155,300,14203,합계,28,5,23,3629,2020-07-28 09:00:00.000,2021-09-16 10:11:33.897
14156,11,1580,서울,6,3,3,3628,2020-07-28 09:00:00.000,2021-09-16 10:11:33.897
14157,3,170,부산,2,1,1,3627,2020-07-28 09:00:00.000,2021-09-16 10:11:33.897
14158,191,6939,대구,0,0,0,3626,2020-07-28 09:00:00.000,2021-09-16 10:11:33.897
14159,2,380,인천,0,0,0,3625,2020-07-28 09:00:00.000,2021-09-16 10:11:33.897
14160,2,203,광주,0,0,0,3624,2020-07-28 09:00:00.000,2021-09-16 10:11:33.897
14161,2,166,대전,0,0,0,3623,2020-07-28 09:00:00.000,2021-09-16 10:11:33.897
14162,1,58,울산,0,0,0,3622,2020-07-28 09:00:00.000,2021-09-16 10:11:33.897
14163,0,50,세종,0,0,0,3621,2020-07-28 09:00:00.000,2021-09-16 10:11:33.897
14164,30,1520,경기,6,1,5,3620,2020-07-28 09:00:00.000,2021-09-16 10:11:33.897
14165,3,72,강원,0,0,0,3619,2020-07-28 09:00:00.000,2021-09-16 10:11:33.897
14166,0,73,충북,0,0,0,3618,2020-07-28 09:00:00.000,2021-09-16 10:11:33.897
14167,1,189,충남,1,0,1,3617,2020-07-28 09:00:00.000,2021-09-16 10:11:33.897
14168,0,39,전북,0,0,0,3616,2020-07-28 09:00:00.000,2021-09-16 10:11:33.897
14169,0,38,전남,2,0,2,3615,2020-07-28 09:00:00.000,2021-09-16 10:11:33.897
14170,54,1397,경북,1,0,1,3614,2020-07-28 09:00:00.000,2021-09-16 10:11:33.897
14171,0,158,경남,0,0,0,3613,2020-07-28 09:00:00.000,2021-09-16 10:11:33.897
14172,0,26,제주,0,0,0,3612,2020-07-28 09:00:00.000,2021-09-16 10:11:33.897
14173,0,1145,검역,10,0,10,3611,2020-07-28 09:00:00.000,2021-09-16 10:11:33.897
14174,299,14175,합계,25,9,16,3610,2020-07-27 09:00:00.000,2021-09-16 10:11:33.897
14175,11,1574,서울,9,6,3,3609,2020-07-27 09:00:00.000,2021-09-16 10:11:33.897
14176,3,168,부산,1,1,0,3608,2020-07-27 09:00:00.000,2021-09-16 10:11:33.897
14177,191,6939,대구,0,0,0,3607,2020-07-27 09:00:00.000,2021-09-16 10:11:33.897
14178,2,380,인천,0,0,0,3606,2020-07-27 09:00:00.000,2021-09-16 10:11:33.897
14179,2,203,광주,0,0,0,3605,2020-07-27 09:00:00.000,2021-09-16 10:11:33.897
14180,2,166,대전,0,0,0,3604,2020-07-27 09:00:00.000,2021-09-16 10:11:33.897
14181,1,58,울산,0,0,0,3603,2020-07-27 09:00:00.000,2021-09-16 10:11:33.897
14182,0,50,세종,0,0,0,3602,2020-07-27 09:00:00.000,2021-09-16 10:11:33.897
14183,29,1514,경기,6,2,4,3601,2020-07-27 09:00:00.000,2021-09-16 10:11:33.897
14184,3,72,강원,0,0,0,3600,2020-07-27 09:00:00.000,2021-09-16 10:11:33.897
14185,0,73,충북,1,0,1,3599,2020-07-27 09:00:00.000,2021-09-16 10:11:33.897
14186,1,188,충남,1,0,1,3598,2020-07-27 09:00:00.000,2021-09-16 10:11:33.897
14187,0,39,전북,0,0,0,3597,2020-07-27 09:00:00.000,2021-09-16 10:11:33.897
14188,0,36,전남,0,0,0,3596,2020-07-27 09:00:00.000,2021-09-16 10:11:33.897
14189,54,1396,경북,0,0,0,3595,2020-07-27 09:00:00.000,2021-09-16 10:11:33.897
14190,0,158,경남,0,0,0,3594,2020-07-27 09:00:00.000,2021-09-16 10:11:33.897
14191,0,26,제주,0,0,0,3593,2020-07-27 09:00:00.000,2021-09-16 10:11:33.897
14192,0,1135,검역,7,0,7,3592,2020-07-27 09:00:00.000,2021-09-16 10:11:33.897
14193,298,14150,합계,58,12,46,3591,2020-07-26 09:00:00.000,2021-09-16 10:11:33.897
14194,11,1565,서울,7,5,2,3590,2020-07-26 09:00:00.000,2021-09-16 10:11:33.897
14195,3,167,부산,1,1,0,3589,2020-07-26 09:00:00.000,2021-09-16 10:11:33.897
14196,191,6939,대구,0,0,0,3588,2020-07-26 09:00:00.000,2021-09-16 10:11:33.897
14197,2,380,인천,0,0,0,3587,2020-07-26 09:00:00.000,2021-09-16 10:11:33.897
14198,2,203,광주,1,1,0,3586,2020-07-26 09:00:00.000,2021-09-16 10:11:33.897
14199,2,166,대전,0,0,0,3585,2020-07-26 09:00:00.000,2021-09-16 10:11:33.897
14200,1,58,울산,0,0,0,3584,2020-07-26 09:00:00.000,2021-09-16 10:11:33.897
14201,0,50,세종,0,0,0,3583,2020-07-26 09:00:00.000,2021-09-16 10:11:33.897
14202,29,1508,경기,7,5,2,3582,2020-07-26 09:00:00.000,2021-09-16 10:11:33.897
14203,3,72,강원,0,0,0,3581,2020-07-26 09:00:00.000,2021-09-16 10:11:33.897
14204,0,72,충북,0,0,0,3580,2020-07-26 09:00:00.000,2021-09-16 10:11:33.897
14205,0,187,충남,0,0,0,3579,2020-07-26 09:00:00.000,2021-09-16 10:11:33.897
14206,0,39,전북,0,0,0,3578,2020-07-26 09:00:00.000,2021-09-16 10:11:33.897
14207,0,36,전남,0,0,0,3577,2020-07-26 09:00:00.000,2021-09-16 10:11:33.897
14208,54,1396,경북,0,0,0,3576,2020-07-26 09:00:00.000,2021-09-16 10:11:33.897
14209,0,158,경남,0,0,0,3575,2020-07-26 09:00:00.000,2021-09-16 10:11:33.897
14210,0,26,제주,0,0,0,3574,2020-07-26 09:00:00.000,2021-09-16 10:11:33.897
14211,0,1128,검역,42,0,42,3573,2020-07-26 09:00:00.000,2021-09-16 10:11:33.897
14212,298,14092,합계,113,27,86,3572,2020-07-25 09:00:00.000,2021-09-16 10:11:33.897
14213,11,1558,서울,11,11,0,3571,2020-07-25 09:00:00.000,2021-09-16 10:11:33.897
14214,3,166,부산,5,5,0,3570,2020-07-25 09:00:00.000,2021-09-16 10:11:33.897
14215,191,6939,대구,0,0,0,3569,2020-07-25 09:00:00.000,2021-09-16 10:11:33.897
14216,2,380,인천,0,0,0,3568,2020-07-25 09:00:00.000,2021-09-16 10:11:33.897
14217,2,202,광주,0,0,0,3567,2020-07-25 09:00:00.000,2021-09-16 10:11:33.897
14218,2,166,대전,0,0,0,3566,2020-07-25 09:00:00.000,2021-09-16 10:11:33.897
14219,1,58,울산,1,0,1,3565,2020-07-25 09:00:00.000,2021-09-16 10:11:33.897
14220,0,50,세종,0,0,0,3564,2020-07-25 09:00:00.000,2021-09-16 10:11:33.897
14221,29,1501,경기,14,11,3,3563,2020-07-25 09:00:00.000,2021-09-16 10:11:33.897
14222,3,72,강원,0,0,0,3562,2020-07-25 09:00:00.000,2021-09-16 10:11:33.897
14223,0,72,충북,0,0,0,3561,2020-07-25 09:00:00.000,2021-09-16 10:11:33.897
14224,0,187,충남,0,0,0,3560,2020-07-25 09:00:00.000,2021-09-16 10:11:33.897
14225,0,39,전북,0,0,0,3559,2020-07-25 09:00:00.000,2021-09-16 10:11:33.897
14226,0,36,전남,1,0,1,3558,2020-07-25 09:00:00.000,2021-09-16 10:11:33.897
14227,54,1396,경북,0,0,0,3557,2020-07-25 09:00:00.000,2021-09-16 10:11:33.897
14228,0,158,경남,0,0,0,3556,2020-07-25 09:00:00.000,2021-09-16 10:11:33.897
14229,0,26,제주,0,0,0,3555,2020-07-25 09:00:00.000,2021-09-16 10:11:33.897
14230,0,1086,검역,81,0,81,3554,2020-07-25 09:00:00.000,2021-09-16 10:11:33.897
14231,298,13979,합계,41,28,13,3553,2020-07-24 09:00:00.000,2021-09-16 10:11:33.897
14232,11,1547,서울,21,19,2,3552,2020-07-24 09:00:00.000,2021-09-16 10:11:33.897
14233,3,161,부산,2,2,0,3551,2020-07-24 09:00:00.000,2021-09-16 10:11:33.897
14234,191,6939,대구,2,0,2,3550,2020-07-24 09:00:00.000,2021-09-16 10:11:33.897
14235,2,380,인천,0,0,0,3549,2020-07-24 09:00:00.000,2021-09-16 10:11:33.897
14236,2,202,광주,2,2,0,3548,2020-07-24 09:00:00.000,2021-09-16 10:11:33.897
14237,2,166,대전,0,0,0,3547,2020-07-24 09:00:00.000,2021-09-16 10:11:33.897
14238,1,57,울산,0,0,0,3546,2020-07-24 09:00:00.000,2021-09-16 10:11:33.897
14239,0,50,세종,0,0,0,3545,2020-07-24 09:00:00.000,2021-09-16 10:11:33.897
14240,29,1487,경기,8,5,3,3544,2020-07-24 09:00:00.000,2021-09-16 10:11:33.897
14241,3,72,강원,0,0,0,3543,2020-07-24 09:00:00.000,2021-09-16 10:11:33.897
14242,0,72,충북,0,0,0,3542,2020-07-24 09:00:00.000,2021-09-16 10:11:33.897
14243,0,187,충남,0,0,0,3541,2020-07-24 09:00:00.000,2021-09-16 10:11:33.897
14244,0,39,전북,0,0,0,3540,2020-07-24 09:00:00.000,2021-09-16 10:11:33.897
14245,0,35,전남,0,0,0,3539,2020-07-24 09:00:00.000,2021-09-16 10:11:33.897
14246,54,1396,경북,1,0,1,3538,2020-07-24 09:00:00.000,2021-09-16 10:11:33.897
14247,0,158,경남,2,0,2,3537,2020-07-24 09:00:00.000,2021-09-16 10:11:33.897
14248,0,26,제주,0,0,0,3536,2020-07-24 09:00:00.000,2021-09-16 10:11:33.897
14249,0,1005,검역,3,0,3,3535,2020-07-24 09:00:00.000,2021-09-16 10:11:33.897
14250,297,13938,합계,59,39,20,3534,2020-07-23 09:00:00.000,2021-09-16 10:11:33.897
14251,11,1526,서울,12,11,1,3533,2020-07-23 09:00:00.000,2021-09-16 10:11:33.897
14252,3,159,부산,2,0,2,3532,2020-07-23 09:00:00.000,2021-09-16 10:11:33.897
14253,190,6937,대구,0,0,0,3531,2020-07-23 09:00:00.000,2021-09-16 10:11:33.897
14254,2,380,인천,3,2,1,3530,2020-07-23 09:00:00.000,2021-09-16 10:11:33.897
14255,2,200,광주,9,9,0,3529,2020-07-23 09:00:00.000,2021-09-16 10:11:33.897
14256,2,166,대전,0,0,0,3528,2020-07-23 09:00:00.000,2021-09-16 10:11:33.897
14257,1,57,울산,0,0,0,3527,2020-07-23 09:00:00.000,2021-09-16 10:11:33.897
14258,0,50,세종,0,0,0,3526,2020-07-23 09:00:00.000,2021-09-16 10:11:33.897
14259,29,1479,경기,28,17,11,3525,2020-07-23 09:00:00.000,2021-09-16 10:11:33.897
14260,3,72,강원,0,0,0,3524,2020-07-23 09:00:00.000,2021-09-16 10:11:33.897
14261,0,72,충북,0,0,0,3523,2020-07-23 09:00:00.000,2021-09-16 10:11:33.897
14262,0,187,충남,0,0,0,3522,2020-07-23 09:00:00.000,2021-09-16 10:11:33.897
14263,0,39,전북,0,0,0,3521,2020-07-23 09:00:00.000,2021-09-16 10:11:33.897
14264,0,35,전남,0,0,0,3520,2020-07-23 09:00:00.000,2021-09-16 10:11:33.897
14265,54,1395,경북,0,0,0,3519,2020-07-23 09:00:00.000,2021-09-16 10:11:33.897
14266,0,156,경남,0,0,0,3518,2020-07-23 09:00:00.000,2021-09-16 10:11:33.897
14267,0,26,제주,0,0,0,3517,2020-07-23 09:00:00.000,2021-09-16 10:11:33.897
14268,0,1002,검역,5,0,5,3516,2020-07-23 09:00:00.000,2021-09-16 10:11:33.897
14269,297,13879,합계,63,29,34,3515,2020-07-22 09:00:00.000,2021-09-16 10:11:33.897
14270,11,1514,서울,16,16,0,3514,2020-07-22 09:00:00.000,2021-09-16 10:11:33.897
14271,3,157,부산,0,0,0,3513,2020-07-22 09:00:00.000,2021-09-16 10:11:33.897
14272,190,6937,대구,1,0,1,3512,2020-07-22 09:00:00.000,2021-09-16 10:11:33.897
14273,2,377,인천,5,4,1,3511,2020-07-22 09:00:00.000,2021-09-16 10:11:33.897
14274,2,191,광주,4,1,3,3510,2020-07-22 09:00:00.000,2021-09-16 10:11:33.897
14275,2,166,대전,0,0,0,3509,2020-07-22 09:00:00.000,2021-09-16 10:11:33.897
14276,1,57,울산,0,0,0,3508,2020-07-22 09:00:00.000,2021-09-16 10:11:33.897
14277,0,50,세종,0,0,0,3507,2020-07-22 09:00:00.000,2021-09-16 10:11:33.897
14278,29,1451,경기,15,8,7,3506,2020-07-22 09:00:00.000,2021-09-16 10:11:33.897
14279,3,72,강원,0,0,0,3505,2020-07-22 09:00:00.000,2021-09-16 10:11:33.897
14280,0,72,충북,1,0,1,3504,2020-07-22 09:00:00.000,2021-09-16 10:11:33.897
14281,0,187,충남,1,0,1,3503,2020-07-22 09:00:00.000,2021-09-16 10:11:33.897
14282,0,39,전북,0,0,0,3502,2020-07-22 09:00:00.000,2021-09-16 10:11:33.897
14283,0,35,전남,0,0,0,3501,2020-07-22 09:00:00.000,2021-09-16 10:11:33.897
14284,54,1395,경북,0,0,0,3500,2020-07-22 09:00:00.000,2021-09-16 10:11:33.897
14285,0,156,경남,1,0,1,3499,2020-07-22 09:00:00.000,2021-09-16 10:11:33.897
14286,0,26,제주,0,0,0,3498,2020-07-22 09:00:00.000,2021-09-16 10:11:33.897
14287,0,997,검역,19,0,19,3497,2020-07-22 09:00:00.000,2021-09-16 10:11:33.897
14288,296,13816,합계,45,20,25,3496,2020-07-21 09:00:00.000,2021-09-16 10:11:33.897
14289,10,1498,서울,21,18,3,3495,2020-07-21 09:00:00.000,2021-09-16 10:11:33.897
14290,3,157,부산,0,0,0,3494,2020-07-21 09:00:00.000,2021-09-16 10:11:33.897
14291,190,6936,대구,2,0,2,3493,2020-07-21 09:00:00.000,2021-09-16 10:11:33.897
14292,2,372,인천,0,0,0,3492,2020-07-21 09:00:00.000,2021-09-16 10:11:33.897
14293,2,187,광주,0,0,0,3491,2020-07-21 09:00:00.000,2021-09-16 10:11:33.897
14294,2,166,대전,0,0,0,3490,2020-07-21 09:00:00.000,2021-09-16 10:11:33.897
14295,1,57,울산,0,0,0,3489,2020-07-21 09:00:00.000,2021-09-16 10:11:33.897
14296,0,50,세종,0,0,0,3488,2020-07-21 09:00:00.000,2021-09-16 10:11:33.897
14297,29,1436,경기,2,1,1,3487,2020-07-21 09:00:00.000,2021-09-16 10:11:33.897
14298,3,72,강원,0,0,0,3486,2020-07-21 09:00:00.000,2021-09-16 10:11:33.897
14299,0,71,충북,0,0,0,3485,2020-07-21 09:00:00.000,2021-09-16 10:11:33.897
14300,0,186,충남,0,0,0,3484,2020-07-21 09:00:00.000,2021-09-16 10:11:33.897
14301,0,39,전북,0,0,0,3483,2020-07-21 09:00:00.000,2021-09-16 10:11:33.897
14302,0,35,전남,0,0,0,3482,2020-07-21 09:00:00.000,2021-09-16 10:11:33.897
14303,54,1395,경북,1,0,1,3481,2020-07-21 09:00:00.000,2021-09-16 10:11:33.897
14304,0,155,경남,0,0,0,3480,2020-07-21 09:00:00.000,2021-09-16 10:11:33.897
14305,0,26,제주,1,1,0,3479,2020-07-21 09:00:00.000,2021-09-16 10:11:33.897
14306,0,978,검역,18,0,18,3478,2020-07-21 09:00:00.000,2021-09-16 10:11:33.897
14307,296,13771,합계,26,4,22,3477,2020-07-20 09:00:00.000,2021-09-16 10:11:33.897
14308,10,1477,서울,3,2,1,3476,2020-07-20 09:00:00.000,2021-09-16 10:11:33.897
14309,3,157,부산,0,0,0,3475,2020-07-20 09:00:00.000,2021-09-16 10:11:33.897
14310,190,6934,대구,2,0,2,3474,2020-07-20 09:00:00.000,2021-09-16 10:11:33.897
14311,2,372,인천,2,0,2,3473,2020-07-20 09:00:00.000,2021-09-16 10:11:33.897
14312,2,187,광주,1,1,0,3472,2020-07-20 09:00:00.000,2021-09-16 10:11:33.897
14313,2,166,대전,0,0,0,3471,2020-07-20 09:00:00.000,2021-09-16 10:11:33.897
14314,1,57,울산,0,0,0,3470,2020-07-20 09:00:00.000,2021-09-16 10:11:33.897
14315,0,50,세종,0,0,0,3469,2020-07-20 09:00:00.000,2021-09-16 10:11:33.897
14316,29,1434,경기,1,0,1,3468,2020-07-20 09:00:00.000,2021-09-16 10:11:33.897
14317,3,72,강원,0,0,0,3467,2020-07-20 09:00:00.000,2021-09-16 10:11:33.897
14318,0,71,충북,0,0,0,3466,2020-07-20 09:00:00.000,2021-09-16 10:11:33.897
14319,0,186,충남,1,0,1,3465,2020-07-20 09:00:00.000,2021-09-16 10:11:33.897
14320,0,39,전북,1,0,1,3464,2020-07-20 09:00:00.000,2021-09-16 10:11:33.897
14321,0,35,전남,2,1,1,3463,2020-07-20 09:00:00.000,2021-09-16 10:11:33.897
14322,54,1394,경북,1,0,1,3462,2020-07-20 09:00:00.000,2021-09-16 10:11:33.897
14323,0,155,경남,2,0,2,3461,2020-07-20 09:00:00.000,2021-09-16 10:11:33.897
14324,0,25,제주,0,0,0,3460,2020-07-20 09:00:00.000,2021-09-16 10:11:33.897
14325,0,960,검역,10,0,10,3459,2020-07-20 09:00:00.000,2021-09-16 10:11:33.897
14326,295,13745,합계,34,21,13,3458,2020-07-19 09:00:00.000,2021-09-16 10:11:33.897
14327,10,1474,서울,10,10,0,3457,2020-07-19 09:00:00.000,2021-09-16 10:11:33.897
14328,3,157,부산,0,0,0,3456,2020-07-19 09:00:00.000,2021-09-16 10:11:33.897
14329,190,6932,대구,0,0,0,3455,2020-07-19 09:00:00.000,2021-09-16 10:11:33.897
14330,2,370,인천,1,0,1,3454,2020-07-19 09:00:00.000,2021-09-16 10:11:33.897
14331,1,186,광주,10,10,0,3453,2020-07-19 09:00:00.000,2021-09-16 10:11:33.897
14332,2,166,대전,1,1,0,3452,2020-07-19 09:00:00.000,2021-09-16 10:11:33.897
14333,1,57,울산,0,0,0,3451,2020-07-19 09:00:00.000,2021-09-16 10:11:33.897
14334,0,50,세종,0,0,0,3450,2020-07-19 09:00:00.000,2021-09-16 10:11:33.897
14335,29,1433,경기,4,0,4,3449,2020-07-19 09:00:00.000,2021-09-16 10:11:33.897
14336,3,72,강원,0,0,0,3448,2020-07-19 09:00:00.000,2021-09-16 10:11:33.897
14337,0,71,충북,0,0,0,3447,2020-07-19 09:00:00.000,2021-09-16 10:11:33.897
14338,0,185,충남,0,0,0,3446,2020-07-19 09:00:00.000,2021-09-16 10:11:33.897
14339,0,38,전북,0,0,0,3445,2020-07-19 09:00:00.000,2021-09-16 10:11:33.897
14340,0,33,전남,0,0,0,3444,2020-07-19 09:00:00.000,2021-09-16 10:11:33.897
14341,54,1393,경북,0,0,0,3443,2020-07-19 09:00:00.000,2021-09-16 10:11:33.897
14342,0,153,경남,0,0,0,3442,2020-07-19 09:00:00.000,2021-09-16 10:11:33.897
14343,0,25,제주,1,0,1,3441,2020-07-19 09:00:00.000,2021-09-16 10:11:33.897
14344,0,950,검역,7,0,7,3440,2020-07-19 09:00:00.000,2021-09-16 10:11:33.897
14345,294,13711,합계,39,11,28,3439,2020-07-18 09:00:00.000,2021-09-16 10:11:33.897
14346,9,1464,서울,6,6,0,3438,2020-07-18 09:00:00.000,2021-09-16 10:11:33.897
14347,3,157,부산,1,0,1,3437,2020-07-18 09:00:00.000,2021-09-16 10:11:33.897
14348,190,6932,대구,3,0,3,3436,2020-07-18 09:00:00.000,2021-09-16 10:11:33.897
14349,2,369,인천,2,1,1,3435,2020-07-18 09:00:00.000,2021-09-16 10:11:33.897
14350,1,176,광주,0,0,0,3434,2020-07-18 09:00:00.000,2021-09-16 10:11:33.897
14351,2,165,대전,0,0,0,3433,2020-07-18 09:00:00.000,2021-09-16 10:11:33.897
14352,1,57,울산,1,1,0,3432,2020-07-18 09:00:00.000,2021-09-16 10:11:33.897
14353,0,50,세종,0,0,0,3431,2020-07-18 09:00:00.000,2021-09-16 10:11:33.897
14354,29,1429,경기,10,2,8,3430,2020-07-18 09:00:00.000,2021-09-16 10:11:33.897
14355,3,72,강원,0,0,0,3429,2020-07-18 09:00:00.000,2021-09-16 10:11:33.897
14356,0,71,충북,0,0,0,3428,2020-07-18 09:00:00.000,2021-09-16 10:11:33.897
14357,0,185,충남,0,0,0,3427,2020-07-18 09:00:00.000,2021-09-16 10:11:33.897
14358,0,38,전북,0,0,0,3426,2020-07-18 09:00:00.000,2021-09-16 10:11:33.897
14359,0,33,전남,1,0,1,3425,2020-07-18 09:00:00.000,2021-09-16 10:11:33.897
14360,54,1393,경북,0,0,0,3424,2020-07-18 09:00:00.000,2021-09-16 10:11:33.897
14361,0,153,경남,2,0,2,3423,2020-07-18 09:00:00.000,2021-09-16 10:11:33.897
14362,0,24,제주,1,1,0,3422,2020-07-18 09:00:00.000,2021-09-16 10:11:33.897
14363,0,943,검역,12,0,12,3421,2020-07-18 09:00:00.000,2021-09-16 10:11:33.897
14364,293,13672,합계,60,21,39,3420,2020-07-17 09:00:00.000,2021-09-16 10:11:33.897
14365,9,1458,서울,9,7,2,3419,2020-07-17 09:00:00.000,2021-09-16 10:11:33.897
14366,3,156,부산,0,0,0,3418,2020-07-17 09:00:00.000,2021-09-16 10:11:33.897
14367,189,6929,대구,0,0,0,3417,2020-07-17 09:00:00.000,2021-09-16 10:11:33.897
14368,2,367,인천,0,0,0,3416,2020-07-17 09:00:00.000,2021-09-16 10:11:33.897
14369,1,176,광주,5,5,0,3415,2020-07-17 09:00:00.000,2021-09-16 10:11:33.897
14370,2,165,대전,1,1,0,3414,2020-07-17 09:00:00.000,2021-09-16 10:11:33.897
14371,1,56,울산,0,0,0,3413,2020-07-17 09:00:00.000,2021-09-16 10:11:33.897
14372,0,50,세종,0,0,0,3412,2020-07-17 09:00:00.000,2021-09-16 10:11:33.897
14373,29,1419,경기,15,5,10,3411,2020-07-17 09:00:00.000,2021-09-16 10:11:33.897
14374,3,72,강원,0,0,0,3410,2020-07-17 09:00:00.000,2021-09-16 10:11:33.897
14375,0,71,충북,0,0,0,3409,2020-07-17 09:00:00.000,2021-09-16 10:11:33.897
14376,0,185,충남,0,0,0,3408,2020-07-17 09:00:00.000,2021-09-16 10:11:33.897
14377,0,38,전북,0,0,0,3407,2020-07-17 09:00:00.000,2021-09-16 10:11:33.897
14378,0,32,전남,0,0,0,3406,2020-07-17 09:00:00.000,2021-09-16 10:11:33.897
14379,54,1393,경북,0,0,0,3405,2020-07-17 09:00:00.000,2021-09-16 10:11:33.897
14380,0,151,경남,2,0,2,3404,2020-07-17 09:00:00.000,2021-09-16 10:11:33.897
14381,0,23,제주,3,3,0,3403,2020-07-17 09:00:00.000,2021-09-16 10:11:33.897
14382,0,931,검역,25,0,25,3402,2020-07-17 09:00:00.000,2021-09-16 10:11:33.897
14383,291,13612,합계,61,14,47,3401,2020-07-16 09:00:00.000,2021-09-16 10:11:33.897
14384,9,1449,서울,7,6,1,3400,2020-07-16 09:00:00.000,2021-09-16 10:11:33.897
14385,3,156,부산,0,0,0,3399,2020-07-16 09:00:00.000,2021-09-16 10:11:33.897
14386,189,6929,대구,2,0,2,3398,2020-07-16 09:00:00.000,2021-09-16 10:11:33.897
14387,2,367,인천,3,2,1,3397,2020-07-16 09:00:00.000,2021-09-16 10:11:33.897
14388,0,171,광주,1,1,0,3396,2020-07-16 09:00:00.000,2021-09-16 10:11:33.897
14389,2,164,대전,1,1,0,3395,2020-07-16 09:00:00.000,2021-09-16 10:11:33.897
14390,1,56,울산,1,0,1,3394,2020-07-16 09:00:00.000,2021-09-16 10:11:33.897
14391,0,50,세종,0,0,0,3393,2020-07-16 09:00:00.000,2021-09-16 10:11:33.897
14392,28,1404,경기,21,3,18,3392,2020-07-16 09:00:00.000,2021-09-16 10:11:33.897
14393,3,72,강원,3,1,2,3391,2020-07-16 09:00:00.000,2021-09-16 10:11:33.897
14394,0,71,충북,1,0,1,3390,2020-07-16 09:00:00.000,2021-09-16 10:11:33.897
14395,0,185,충남,0,0,0,3389,2020-07-16 09:00:00.000,2021-09-16 10:11:33.897
14396,0,38,전북,0,0,0,3388,2020-07-16 09:00:00.000,2021-09-16 10:11:33.897
14397,0,32,전남,0,0,0,3387,2020-07-16 09:00:00.000,2021-09-16 10:11:33.897
14398,54,1393,경북,0,0,0,3386,2020-07-16 09:00:00.000,2021-09-16 10:11:33.897
14399,0,149,경남,1,0,1,3385,2020-07-16 09:00:00.000,2021-09-16 10:11:33.897
14400,0,20,제주,0,0,0,3384,2020-07-16 09:00:00.000,2021-09-16 10:11:33.897
14401,0,906,검역,20,0,20,3383,2020-07-16 09:00:00.000,2021-09-16 10:11:33.897
14402,289,13551,합계,39,11,28,3382,2020-07-15 09:00:00.000,2021-09-16 10:11:33.897
14403,9,1442,서울,6,6,0,3381,2020-07-15 09:00:00.000,2021-09-16 10:11:33.897
14404,3,156,부산,0,0,0,3380,2020-07-15 09:00:00.000,2021-09-16 10:11:33.897
14405,189,6927,대구,0,0,0,3379,2020-07-15 09:00:00.000,2021-09-16 10:11:33.897
14406,2,364,인천,1,0,1,3378,2020-07-15 09:00:00.000,2021-09-16 10:11:33.897
14407,0,170,광주,1,1,0,3377,2020-07-15 09:00:00.000,2021-09-16 10:11:33.897
14408,2,163,대전,3,1,2,3376,2020-07-15 09:00:00.000,2021-09-16 10:11:33.897
14409,1,55,울산,0,0,0,3375,2020-07-15 09:00:00.000,2021-09-16 10:11:33.897
14410,0,50,세종,0,0,0,3374,2020-07-15 09:00:00.000,2021-09-16 10:11:33.897
14411,26,1383,경기,5,3,2,3373,2020-07-15 09:00:00.000,2021-09-16 10:11:33.897
14412,3,69,강원,0,0,0,3372,2020-07-15 09:00:00.000,2021-09-16 10:11:33.897
14413,0,70,충북,0,0,0,3371,2020-07-15 09:00:00.000,2021-09-16 10:11:33.897
14414,0,185,충남,0,0,0,3370,2020-07-15 09:00:00.000,2021-09-16 10:11:33.897
14415,0,38,전북,0,0,0,3369,2020-07-15 09:00:00.000,2021-09-16 10:11:33.897
14416,0,32,전남,0,0,0,3368,2020-07-15 09:00:00.000,2021-09-16 10:11:33.897
14417,54,1393,경북,0,0,0,3367,2020-07-15 09:00:00.000,2021-09-16 10:11:33.897
14418,0,148,경남,0,0,0,3366,2020-07-15 09:00:00.000,2021-09-16 10:11:33.897
14419,0,20,제주,0,0,0,3365,2020-07-15 09:00:00.000,2021-09-16 10:11:33.897
14420,0,886,검역,23,0,23,3364,2020-07-15 09:00:00.000,2021-09-16 10:11:33.897
14421,289,13512,합계,33,14,19,3363,2020-07-14 09:00:00.000,2021-09-16 10:11:33.897
14422,9,1436,서울,7,7,0,3362,2020-07-14 09:00:00.000,2021-09-16 10:11:33.897
14423,3,156,부산,0,0,0,3361,2020-07-14 09:00:00.000,2021-09-16 10:11:33.897
14424,189,6927,대구,0,0,0,3360,2020-07-14 09:00:00.000,2021-09-16 10:11:33.897
14425,2,363,인천,0,0,0,3359,2020-07-14 09:00:00.000,2021-09-16 10:11:33.897
14426,0,169,광주,1,0,1,3358,2020-07-14 09:00:00.000,2021-09-16 10:11:33.897
14427,2,160,대전,1,0,1,3357,2020-07-14 09:00:00.000,2021-09-16 10:11:33.897
14428,1,55,울산,0,0,0,3356,2020-07-14 09:00:00.000,2021-09-16 10:11:33.897
14429,0,50,세종,0,0,0,3355,2020-07-14 09:00:00.000,2021-09-16 10:11:33.897
14430,26,1378,경기,9,4,5,3354,2020-07-14 09:00:00.000,2021-09-16 10:11:33.897
14431,3,69,강원,0,0,0,3353,2020-07-14 09:00:00.000,2021-09-16 10:11:33.897
14432,0,70,충북,1,1,0,3352,2020-07-14 09:00:00.000,2021-09-16 10:11:33.897
14433,0,185,충남,0,0,0,3351,2020-07-14 09:00:00.000,2021-09-16 10:11:33.897
14434,0,38,전북,2,2,0,3350,2020-07-14 09:00:00.000,2021-09-16 10:11:33.897
14435,0,32,전남,0,0,0,3349,2020-07-14 09:00:00.000,2021-09-16 10:11:33.897
14436,54,1393,경북,0,0,0,3348,2020-07-14 09:00:00.000,2021-09-16 10:11:33.897
14437,0,148,경남,0,0,0,3347,2020-07-14 09:00:00.000,2021-09-16 10:11:33.897
14438,0,20,제주,0,0,0,3346,2020-07-14 09:00:00.000,2021-09-16 10:11:33.897
14439,0,863,검역,12,0,12,3345,2020-07-14 09:00:00.000,2021-09-16 10:11:33.897
14440,289,13479,합계,62,19,43,3344,2020-07-13 09:00:00.000,2021-09-16 10:11:33.897
14441,9,1429,서울,13,10,3,3343,2020-07-13 09:00:00.000,2021-09-16 10:11:33.897
14442,3,156,부산,0,0,0,3342,2020-07-13 09:00:00.000,2021-09-16 10:11:33.897
14443,189,6927,대구,1,0,1,3341,2020-07-13 09:00:00.000,2021-09-16 10:11:33.897
14444,2,363,인천,3,0,3,3340,2020-07-13 09:00:00.000,2021-09-16 10:11:33.897
14445,0,168,광주,7,6,1,3339,2020-07-13 09:00:00.000,2021-09-16 10:11:33.897
14446,2,159,대전,0,0,0,3338,2020-07-13 09:00:00.000,2021-09-16 10:11:33.897
14447,1,55,울산,0,0,0,3337,2020-07-13 09:00:00.000,2021-09-16 10:11:33.897
14448,0,50,세종,0,0,0,3336,2020-07-13 09:00:00.000,2021-09-16 10:11:33.897
14449,26,1369,경기,11,3,8,3335,2020-07-13 09:00:00.000,2021-09-16 10:11:33.897
14450,3,69,강원,2,0,2,3334,2020-07-13 09:00:00.000,2021-09-16 10:11:33.897
14451,0,69,충북,1,0,1,3333,2020-07-13 09:00:00.000,2021-09-16 10:11:33.897
14452,0,185,충남,4,0,4,3332,2020-07-13 09:00:00.000,2021-09-16 10:11:33.897
14453,0,36,전북,0,0,0,3331,2020-07-13 09:00:00.000,2021-09-16 10:11:33.897
14454,0,32,전남,0,0,0,3330,2020-07-13 09:00:00.000,2021-09-16 10:11:33.897
14455,54,1393,경북,0,0,0,3329,2020-07-13 09:00:00.000,2021-09-16 10:11:33.897
14456,0,148,경남,2,0,2,3328,2020-07-13 09:00:00.000,2021-09-16 10:11:33.897
14457,0,20,제주,0,0,0,3327,2020-07-13 09:00:00.000,2021-09-16 10:11:33.897
14458,0,851,검역,18,0,18,3326,2020-07-13 09:00:00.000,2021-09-16 10:11:33.897
14459,289,13417,합계,44,21,23,3325,2020-07-12 09:00:00.000,2021-09-16 10:11:33.897
14460,9,1416,서울,7,7,0,3324,2020-07-12 09:00:00.000,2021-09-16 10:11:33.897
14461,3,156,부산,0,0,0,3323,2020-07-12 09:00:00.000,2021-09-16 10:11:33.897
14462,189,6926,대구,0,0,0,3322,2020-07-12 09:00:00.000,2021-09-16 10:11:33.897
14463,2,360,인천,0,0,0,3321,2020-07-12 09:00:00.000,2021-09-16 10:11:33.897
14464,0,161,광주,5,5,0,3320,2020-07-12 09:00:00.000,2021-09-16 10:11:33.897
14465,2,159,대전,1,1,0,3319,2020-07-12 09:00:00.000,2021-09-16 10:11:33.897
14466,1,55,울산,0,0,0,3318,2020-07-12 09:00:00.000,2021-09-16 10:11:33.897
14467,0,50,세종,0,0,0,3317,2020-07-12 09:00:00.000,2021-09-16 10:11:33.897
14468,26,1358,경기,17,8,9,3316,2020-07-12 09:00:00.000,2021-09-16 10:11:33.897
14469,3,67,강원,0,0,0,3315,2020-07-12 09:00:00.000,2021-09-16 10:11:33.897
14470,0,68,충북,0,0,0,3314,2020-07-12 09:00:00.000,2021-09-16 10:11:33.897
14471,0,181,충남,0,0,0,3313,2020-07-12 09:00:00.000,2021-09-16 10:11:33.897
14472,0,36,전북,1,0,1,3312,2020-07-12 09:00:00.000,2021-09-16 10:11:33.897
14473,0,32,전남,0,0,0,3311,2020-07-12 09:00:00.000,2021-09-16 10:11:33.897
14474,54,1393,경북,0,0,0,3310,2020-07-12 09:00:00.000,2021-09-16 10:11:33.897
14475,0,146,경남,1,0,1,3309,2020-07-12 09:00:00.000,2021-09-16 10:11:33.897
14476,0,20,제주,0,0,0,3308,2020-07-12 09:00:00.000,2021-09-16 10:11:33.897
14477,0,833,검역,12,0,12,3307,2020-07-12 09:00:00.000,2021-09-16 10:11:33.897
14478,288,13373,합계,35,20,15,3306,2020-07-11 09:00:00.000,2021-09-16 10:11:33.897
14479,9,1409,서울,8,6,2,3305,2020-07-11 09:00:00.000,2021-09-16 10:11:33.897
14480,3,156,부산,0,0,0,3304,2020-07-11 09:00:00.000,2021-09-16 10:11:33.897
14481,189,6926,대구,0,0,0,3303,2020-07-11 09:00:00.000,2021-09-16 10:11:33.897
14482,2,360,인천,1,1,0,3302,2020-07-11 09:00:00.000,2021-09-16 10:11:33.897
14483,0,156,광주,9,9,0,3301,2020-07-11 09:00:00.000,2021-09-16 10:11:33.897
14484,2,158,대전,2,2,0,3300,2020-07-11 09:00:00.000,2021-09-16 10:11:33.897
14485,1,55,울산,0,0,0,3299,2020-07-11 09:00:00.000,2021-09-16 10:11:33.897
14486,0,50,세종,0,0,0,3298,2020-07-11 09:00:00.000,2021-09-16 10:11:33.897
14487,25,1341,경기,4,2,2,3297,2020-07-11 09:00:00.000,2021-09-16 10:11:33.897
14488,3,67,강원,0,0,0,3296,2020-07-11 09:00:00.000,2021-09-16 10:11:33.897
14489,0,68,충북,0,0,0,3295,2020-07-11 09:00:00.000,2021-09-16 10:11:33.897
14490,0,181,충남,1,0,1,3294,2020-07-11 09:00:00.000,2021-09-16 10:11:33.897
14491,0,35,전북,2,0,2,3293,2020-07-11 09:00:00.000,2021-09-16 10:11:33.897
14492,0,32,전남,0,0,0,3292,2020-07-11 09:00:00.000,2021-09-16 10:11:33.897
14493,54,1393,경북,0,0,0,3291,2020-07-11 09:00:00.000,2021-09-16 10:11:33.897
14494,0,145,경남,0,0,0,3290,2020-07-11 09:00:00.000,2021-09-16 10:11:33.897
14495,0,20,제주,0,0,0,3289,2020-07-11 09:00:00.000,2021-09-16 10:11:33.897
14496,0,821,검역,8,0,8,3288,2020-07-11 09:00:00.000,2021-09-16 10:11:33.897
14497,288,13338,합계,45,23,22,3287,2020-07-10 09:00:00.000,2021-09-16 10:11:33.897
14498,9,1401,서울,8,7,1,3286,2020-07-10 09:00:00.000,2021-09-16 10:11:33.897
14499,3,156,부산,0,0,0,3285,2020-07-10 09:00:00.000,2021-09-16 10:11:33.897
14500,189,6926,대구,0,0,0,3284,2020-07-10 09:00:00.000,2021-09-16 10:11:33.897
14501,2,359,인천,1,0,1,3283,2020-07-10 09:00:00.000,2021-09-16 10:11:33.897
14502,0,147,광주,3,3,0,3282,2020-07-10 09:00:00.000,2021-09-16 10:11:33.897
14503,2,156,대전,7,7,0,3281,2020-07-10 09:00:00.000,2021-09-16 10:11:33.897
14504,1,55,울산,0,0,0,3280,2020-07-10 09:00:00.000,2021-09-16 10:11:33.897
14505,0,50,세종,0,0,0,3279,2020-07-10 09:00:00.000,2021-09-16 10:11:33.897
14506,25,1337,경기,14,4,10,3278,2020-07-10 09:00:00.000,2021-09-16 10:11:33.897
14507,3,67,강원,0,0,0,3277,2020-07-10 09:00:00.000,2021-09-16 10:11:33.897
14508,0,68,충북,2,0,2,3276,2020-07-10 09:00:00.000,2021-09-16 10:11:33.897
14509,0,180,충남,0,0,0,3275,2020-07-10 09:00:00.000,2021-09-16 10:11:33.897
14510,0,33,전북,0,0,0,3274,2020-07-10 09:00:00.000,2021-09-16 10:11:33.897
14511,0,32,전남,3,2,1,3273,2020-07-10 09:00:00.000,2021-09-16 10:11:33.897
14512,54,1393,경북,0,0,0,3272,2020-07-10 09:00:00.000,2021-09-16 10:11:33.897
14513,0,145,경남,3,0,3,3271,2020-07-10 09:00:00.000,2021-09-16 10:11:33.897
14514,0,20,제주,0,0,0,3270,2020-07-10 09:00:00.000,2021-09-16 10:11:33.897
14515,0,813,검역,4,0,4,3269,2020-07-10 09:00:00.000,2021-09-16 10:11:33.897
14516,287,13293,합계,50,28,22,3268,2020-07-09 09:00:00.000,2021-09-16 10:11:33.897
14517,9,1393,서울,8,4,4,3267,2020-07-09 09:00:00.000,2021-09-16 10:11:33.897
14518,3,156,부산,0,0,0,3266,2020-07-09 09:00:00.000,2021-09-16 10:11:33.897
14519,189,6926,대구,0,0,0,3265,2020-07-09 09:00:00.000,2021-09-16 10:11:33.897
14520,1,358,인천,3,2,1,3264,2020-07-09 09:00:00.000,2021-09-16 10:11:33.897
14521,0,144,광주,15,15,0,3263,2020-07-09 09:00:00.000,2021-09-16 10:11:33.897
14522,2,149,대전,6,6,0,3262,2020-07-09 09:00:00.000,2021-09-16 10:11:33.897
14523,1,55,울산,0,0,0,3261,2020-07-09 09:00:00.000,2021-09-16 10:11:33.897
14524,0,50,세종,0,0,0,3260,2020-07-09 09:00:00.000,2021-09-16 10:11:33.897
14525,25,1323,경기,8,1,7,3259,2020-07-09 09:00:00.000,2021-09-16 10:11:33.897
14526,3,67,강원,0,0,0,3258,2020-07-09 09:00:00.000,2021-09-16 10:11:33.897
14527,0,66,충북,0,0,0,3257,2020-07-09 09:00:00.000,2021-09-16 10:11:33.897
14528,0,180,충남,1,0,1,3256,2020-07-09 09:00:00.000,2021-09-16 10:11:33.897
14529,0,33,전북,1,0,1,3255,2020-07-09 09:00:00.000,2021-09-16 10:11:33.897
14530,0,29,전남,1,0,1,3254,2020-07-09 09:00:00.000,2021-09-16 10:11:33.897
14531,54,1393,경북,0,0,0,3253,2020-07-09 09:00:00.000,2021-09-16 10:11:33.897
14532,0,142,경남,2,0,2,3252,2020-07-09 09:00:00.000,2021-09-16 10:11:33.897
14533,0,20,제주,0,0,0,3251,2020-07-09 09:00:00.000,2021-09-16 10:11:33.897
14534,0,809,검역,5,0,5,3250,2020-07-09 09:00:00.000,2021-09-16 10:11:33.897
14535,285,13243,합계,62,30,32,3249,2020-07-08 09:00:00.000,2021-09-16 10:11:33.897
14536,8,1385,서울,10,5,5,3248,2020-07-08 09:00:00.000,2021-09-16 10:11:33.897
14537,3,156,부산,0,0,0,3247,2020-07-08 09:00:00.000,2021-09-16 10:11:33.897
14538,189,6926,대구,1,0,1,3246,2020-07-08 09:00:00.000,2021-09-16 10:11:33.897
14539,1,355,인천,1,1,0,3245,2020-07-08 09:00:00.000,2021-09-16 10:11:33.897
14540,0,129,광주,8,7,1,3244,2020-07-08 09:00:00.000,2021-09-16 10:11:33.897
14541,2,143,대전,2,2,0,3243,2020-07-08 09:00:00.000,2021-09-16 10:11:33.897
14542,1,55,울산,0,0,0,3242,2020-07-08 09:00:00.000,2021-09-16 10:11:33.897
14543,0,50,세종,0,0,0,3241,2020-07-08 09:00:00.000,2021-09-16 10:11:33.897
14544,24,1315,경기,18,11,7,3240,2020-07-08 09:00:00.000,2021-09-16 10:11:33.897
14545,3,67,강원,0,0,0,3239,2020-07-08 09:00:00.000,2021-09-16 10:11:33.897
14546,0,66,충북,0,0,0,3238,2020-07-08 09:00:00.000,2021-09-16 10:11:33.897
14547,0,179,충남,6,3,3,3237,2020-07-08 09:00:00.000,2021-09-16 10:11:33.897
14548,0,32,전북,2,0,2,3236,2020-07-08 09:00:00.000,2021-09-16 10:11:33.897
14549,0,28,전남,1,1,0,3235,2020-07-08 09:00:00.000,2021-09-16 10:11:33.897
14550,54,1393,경북,0,0,0,3234,2020-07-08 09:00:00.000,2021-09-16 10:11:33.897
14551,0,140,경남,2,0,2,3233,2020-07-08 09:00:00.000,2021-09-16 10:11:33.897
14552,0,20,제주,0,0,0,3232,2020-07-08 09:00:00.000,2021-09-16 10:11:33.897
14553,0,804,검역,11,0,11,3231,2020-07-08 09:00:00.000,2021-09-16 10:11:33.897
14554,285,13181,합계,44,20,24,3230,2020-07-07 09:00:00.000,2021-09-16 10:11:33.897
14555,8,1375,서울,3,3,0,3229,2020-07-07 09:00:00.000,2021-09-16 10:11:33.897
14556,3,156,부산,0,0,0,3228,2020-07-07 09:00:00.000,2021-09-16 10:11:33.897
14557,189,6925,대구,1,0,1,3227,2020-07-07 09:00:00.000,2021-09-16 10:11:33.897
14558,1,354,인천,2,2,0,3226,2020-07-07 09:00:00.000,2021-09-16 10:11:33.897
14559,0,121,광주,6,6,0,3225,2020-07-07 09:00:00.000,2021-09-16 10:11:33.897
14560,2,141,대전,2,2,0,3224,2020-07-07 09:00:00.000,2021-09-16 10:11:33.897
14561,1,55,울산,0,0,0,3223,2020-07-07 09:00:00.000,2021-09-16 10:11:33.897
14562,0,50,세종,0,0,0,3222,2020-07-07 09:00:00.000,2021-09-16 10:11:33.897
14563,24,1297,경기,13,7,6,3221,2020-07-07 09:00:00.000,2021-09-16 10:11:33.897
14564,3,67,강원,0,0,0,3220,2020-07-07 09:00:00.000,2021-09-16 10:11:33.897
14565,0,66,충북,0,0,0,3219,2020-07-07 09:00:00.000,2021-09-16 10:11:33.897
14566,0,173,충남,0,0,0,3218,2020-07-07 09:00:00.000,2021-09-16 10:11:33.897
14567,0,30,전북,1,0,1,3217,2020-07-07 09:00:00.000,2021-09-16 10:11:33.897
14568,0,27,전남,0,0,0,3216,2020-07-07 09:00:00.000,2021-09-16 10:11:33.897
14569,54,1393,경북,0,0,0,3215,2020-07-07 09:00:00.000,2021-09-16 10:11:33.897
14570,0,138,경남,0,0,0,3214,2020-07-07 09:00:00.000,2021-09-16 10:11:33.897
14571,0,20,제주,0,0,0,3213,2020-07-07 09:00:00.000,2021-09-16 10:11:33.897
14572,0,793,검역,16,0,16,3212,2020-07-07 09:00:00.000,2021-09-16 10:11:33.897
14573,284,13137,합계,48,24,24,3211,2020-07-06 09:00:00.000,2021-09-16 10:11:33.897
14574,8,1372,서울,3,2,1,3210,2020-07-06 09:00:00.000,2021-09-16 10:11:33.897
14575,3,156,부산,1,0,1,3209,2020-07-06 09:00:00.000,2021-09-16 10:11:33.897
14576,189,6924,대구,2,0,2,3208,2020-07-06 09:00:00.000,2021-09-16 10:11:33.897
14577,1,352,인천,6,5,1,3207,2020-07-06 09:00:00.000,2021-09-16 10:11:33.897
14578,0,115,광주,7,7,0,3206,2020-07-06 09:00:00.000,2021-09-16 10:11:33.897
14579,2,139,대전,2,2,0,3205,2020-07-06 09:00:00.000,2021-09-16 10:11:33.897
14580,1,55,울산,0,0,0,3204,2020-07-06 09:00:00.000,2021-09-16 10:11:33.897
14581,0,50,세종,0,0,0,3203,2020-07-06 09:00:00.000,2021-09-16 10:11:33.897
14582,23,1284,경기,6,5,1,3202,2020-07-06 09:00:00.000,2021-09-16 10:11:33.897
14583,3,67,강원,1,0,1,3201,2020-07-06 09:00:00.000,2021-09-16 10:11:33.897
14584,0,66,충북,0,0,0,3200,2020-07-06 09:00:00.000,2021-09-16 10:11:33.897
14585,0,173,충남,1,1,0,3199,2020-07-06 09:00:00.000,2021-09-16 10:11:33.897
14586,0,29,전북,0,0,0,3198,2020-07-06 09:00:00.000,2021-09-16 10:11:33.897
14587,0,27,전남,2,2,0,3197,2020-07-06 09:00:00.000,2021-09-16 10:11:33.897
14588,54,1393,경북,1,0,1,3196,2020-07-06 09:00:00.000,2021-09-16 10:11:33.897
14589,0,138,경남,1,0,1,3195,2020-07-06 09:00:00.000,2021-09-16 10:11:33.897
14590,0,20,제주,0,0,0,3194,2020-07-06 09:00:00.000,2021-09-16 10:11:33.897
14591,0,777,검역,15,0,15,3193,2020-07-06 09:00:00.000,2021-09-16 10:11:33.897
14592,283,13089,합계,61,43,18,3192,2020-07-05 09:00:00.000,2021-09-16 10:11:33.897
14593,8,1369,서울,16,14,2,3191,2020-07-05 09:00:00.000,2021-09-16 10:11:33.897
14594,3,155,부산,0,0,0,3190,2020-07-05 09:00:00.000,2021-09-16 10:11:33.897
14595,189,6922,대구,0,0,0,3189,2020-07-05 09:00:00.000,2021-09-16 10:11:33.897
14596,1,346,인천,0,0,0,3188,2020-07-05 09:00:00.000,2021-09-16 10:11:33.897
14597,0,108,광주,16,15,1,3187,2020-07-05 09:00:00.000,2021-09-16 10:11:33.897
14598,1,137,대전,8,8,0,3186,2020-07-05 09:00:00.000,2021-09-16 10:11:33.897
14599,1,55,울산,0,0,0,3185,2020-07-05 09:00:00.000,2021-09-16 10:11:33.897
14600,0,50,세종,0,0,0,3184,2020-07-05 09:00:00.000,2021-09-16 10:11:33.897
14601,23,1278,경기,8,4,4,3183,2020-07-05 09:00:00.000,2021-09-16 10:11:33.897
14602,3,66,강원,1,1,0,3182,2020-07-05 09:00:00.000,2021-09-16 10:11:33.897
14603,0,66,충북,0,0,0,3181,2020-07-05 09:00:00.000,2021-09-16 10:11:33.897
14604,0,172,충남,0,0,0,3180,2020-07-05 09:00:00.000,2021-09-16 10:11:33.897
14605,0,29,전북,1,0,1,3179,2020-07-05 09:00:00.000,2021-09-16 10:11:33.897
14606,0,25,전남,0,0,0,3178,2020-07-05 09:00:00.000,2021-09-16 10:11:33.897
14607,54,1392,경북,1,1,0,3177,2020-07-05 09:00:00.000,2021-09-16 10:11:33.897
14608,0,137,경남,0,0,0,3176,2020-07-05 09:00:00.000,2021-09-16 10:11:33.897
14609,0,20,제주,1,0,1,3175,2020-07-05 09:00:00.000,2021-09-16 10:11:33.897
14610,0,762,검역,9,0,9,3174,2020-07-05 09:00:00.000,2021-09-16 10:11:33.897
14611,283,13028,합계,63,36,27,3173,2020-07-04 09:00:00.000,2021-09-16 10:11:33.897
14612,8,1353,서울,7,6,1,3172,2020-07-04 09:00:00.000,2021-09-16 10:11:33.897
14613,3,155,부산,1,0,1,3171,2020-07-04 09:00:00.000,2021-09-16 10:11:33.897
14614,189,6922,대구,1,1,0,3170,2020-07-04 09:00:00.000,2021-09-16 10:11:33.897
14615,1,346,인천,2,0,2,3169,2020-07-04 09:00:00.000,2021-09-16 10:11:33.897
14616,0,92,광주,8,8,0,3168,2020-07-04 09:00:00.000,2021-09-16 10:11:33.897
14617,1,129,대전,3,3,0,3167,2020-07-04 09:00:00.000,2021-09-16 10:11:33.897
14618,1,55,울산,0,0,0,3166,2020-07-04 09:00:00.000,2021-09-16 10:11:33.897
14619,0,50,세종,0,0,0,3165,2020-07-04 09:00:00.000,2021-09-16 10:11:33.897
14620,23,1270,경기,19,15,4,3164,2020-07-04 09:00:00.000,2021-09-16 10:11:33.897
14621,3,65,강원,0,0,0,3163,2020-07-04 09:00:00.000,2021-09-16 10:11:33.897
14622,0,66,충북,2,2,0,3162,2020-07-04 09:00:00.000,2021-09-16 10:11:33.897
14623,0,172,충남,0,0,0,3161,2020-07-04 09:00:00.000,2021-09-16 10:11:33.897
14624,0,28,전북,0,0,0,3160,2020-07-04 09:00:00.000,2021-09-16 10:11:33.897
14625,0,25,전남,0,0,0,3159,2020-07-04 09:00:00.000,2021-09-16 10:11:33.897
14626,54,1391,경북,1,1,0,3158,2020-07-04 09:00:00.000,2021-09-16 10:11:33.897
14627,0,137,경남,1,0,1,3157,2020-07-04 09:00:00.000,2021-09-16 10:11:33.897
14628,0,19,제주,0,0,0,3156,2020-07-04 09:00:00.000,2021-09-16 10:11:33.897
14629,0,753,검역,18,0,18,3155,2020-07-04 09:00:00.000,2021-09-16 10:11:33.897
14630,282,12965,합계,61,49,12,3154,2020-07-03 09:00:00.000,2021-09-16 10:11:33.897
14631,7,1346,서울,12,12,0,3153,2020-07-03 09:00:00.000,2021-09-16 10:11:33.897
14632,3,154,부산,0,0,0,3152,2020-07-03 09:00:00.000,2021-09-16 10:11:33.897
14633,189,6921,대구,11,8,3,3151,2020-07-03 09:00:00.000,2021-09-16 10:11:33.897
14634,1,344,인천,1,1,0,3150,2020-07-03 09:00:00.000,2021-09-16 10:11:33.897
14635,0,84,광주,6,6,0,3149,2020-07-03 09:00:00.000,2021-09-16 10:11:33.897
14636,1,126,대전,4,4,0,3148,2020-07-03 09:00:00.000,2021-09-16 10:11:33.897
14637,1,55,울산,0,0,0,3147,2020-07-03 09:00:00.000,2021-09-16 10:11:33.897
14638,0,50,세종,0,0,0,3146,2020-07-03 09:00:00.000,2021-09-16 10:11:33.897
14639,23,1251,경기,18,16,2,3145,2020-07-03 09:00:00.000,2021-09-16 10:11:33.897
14640,3,65,강원,0,0,0,3144,2020-07-03 09:00:00.000,2021-09-16 10:11:33.897
14641,0,64,충북,0,0,0,3143,2020-07-03 09:00:00.000,2021-09-16 10:11:33.897
14642,0,172,충남,1,1,0,3142,2020-07-03 09:00:00.000,2021-09-16 10:11:33.897
14643,0,28,전북,1,1,0,3141,2020-07-03 09:00:00.000,2021-09-16 10:11:33.897
14644,0,25,전남,0,0,0,3140,2020-07-03 09:00:00.000,2021-09-16 10:11:33.897
14645,54,1390,경북,1,0,1,3139,2020-07-03 09:00:00.000,2021-09-16 10:11:33.897
14646,0,136,경남,2,0,2,3138,2020-07-03 09:00:00.000,2021-09-16 10:11:33.897
14647,0,19,제주,0,0,0,3137,2020-07-03 09:00:00.000,2021-09-16 10:11:33.897
14648,0,735,검역,4,0,4,3136,2020-07-03 09:00:00.000,2021-09-16 10:11:33.897
14649,282,12904,합계,54,44,10,3135,2020-07-02 09:00:00.000,2021-09-16 10:11:33.897
14650,7,1334,서울,13,13,0,3134,2020-07-02 09:00:00.000,2021-09-16 10:11:33.897
14651,3,154,부산,0,0,0,3133,2020-07-02 09:00:00.000,2021-09-16 10:11:33.897
14652,189,6910,대구,3,1,2,3132,2020-07-02 09:00:00.000,2021-09-16 10:11:33.897
14653,1,343,인천,0,0,0,3131,2020-07-02 09:00:00.000,2021-09-16 10:11:33.897
14654,0,78,광주,22,22,0,3130,2020-07-02 09:00:00.000,2021-09-16 10:11:33.897
14655,1,122,대전,1,1,0,3129,2020-07-02 09:00:00.000,2021-09-16 10:11:33.897
14656,1,55,울산,0,0,0,3128,2020-07-02 09:00:00.000,2021-09-16 10:11:33.897
14657,0,50,세종,0,0,0,3127,2020-07-02 09:00:00.000,2021-09-16 10:11:33.897
14658,23,1233,경기,10,5,5,3126,2020-07-02 09:00:00.000,2021-09-16 10:11:33.897
14659,3,65,강원,0,0,0,3125,2020-07-02 09:00:00.000,2021-09-16 10:11:33.897
14660,0,64,충북,0,0,0,3124,2020-07-02 09:00:00.000,2021-09-16 10:11:33.897
14661,0,171,충남,3,2,1,3123,2020-07-02 09:00:00.000,2021-09-16 10:11:33.897
14662,0,27,전북,0,0,0,3122,2020-07-02 09:00:00.000,2021-09-16 10:11:33.897
14663,0,25,전남,0,0,0,3121,2020-07-02 09:00:00.000,2021-09-16 10:11:33.897
14664,54,1389,경북,0,0,0,3120,2020-07-02 09:00:00.000,2021-09-16 10:11:33.897
14665,0,134,경남,0,0,0,3119,2020-07-02 09:00:00.000,2021-09-16 10:11:33.897
14666,0,19,제주,0,0,0,3118,2020-07-02 09:00:00.000,2021-09-16 10:11:33.897
14667,0,731,검역,2,0,2,3117,2020-07-02 09:00:00.000,2021-09-16 10:11:33.897
14668,282,12850,합계,51,36,15,3116,2020-07-01 09:00:00.000,2021-09-16 10:11:33.897
14669,7,1321,서울,9,9,0,3115,2020-07-01 09:00:00.000,2021-09-16 10:11:33.897
14670,3,154,부산,0,0,0,3114,2020-07-01 09:00:00.000,2021-09-16 10:11:33.897
14671,189,6907,대구,1,1,0,3113,2020-07-01 09:00:00.000,2021-09-16 10:11:33.897
14672,1,343,인천,2,0,2,3112,2020-07-01 09:00:00.000,2021-09-16 10:11:33.897
14673,0,56,광주,12,12,0,3111,2020-07-01 09:00:00.000,2021-09-16 10:11:33.897
14674,1,121,대전,4,3,1,3110,2020-07-01 09:00:00.000,2021-09-16 10:11:33.897
14675,1,55,울산,0,0,0,3109,2020-07-01 09:00:00.000,2021-09-16 10:11:33.897
14676,0,50,세종,0,0,0,3108,2020-07-01 09:00:00.000,2021-09-16 10:11:33.897
14677,23,1223,경기,16,11,5,3107,2020-07-01 09:00:00.000,2021-09-16 10:11:33.897
14678,3,65,강원,0,0,0,3106,2020-07-01 09:00:00.000,2021-09-16 10:11:33.897
14679,0,64,충북,0,0,0,3105,2020-07-01 09:00:00.000,2021-09-16 10:11:33.897
14680,0,168,충남,1,0,1,3104,2020-07-01 09:00:00.000,2021-09-16 10:11:33.897
14681,0,27,전북,0,0,0,3103,2020-07-01 09:00:00.000,2021-09-16 10:11:33.897
14682,0,25,전남,1,0,1,3102,2020-07-01 09:00:00.000,2021-09-16 10:11:33.897
14683,54,1389,경북,0,0,0,3101,2020-07-01 09:00:00.000,2021-09-16 10:11:33.897
14684,0,134,경남,0,0,0,3100,2020-07-01 09:00:00.000,2021-09-16 10:11:33.897
14685,0,19,제주,0,0,0,3099,2020-07-01 09:00:00.000,2021-09-16 10:11:33.897
14686,0,729,검역,5,0,5,3098,2020-07-01 09:00:00.000,2021-09-16 10:11:33.897
14687,282,12799,합계,42,22,20,3097,2020-06-30 09:00:00.000,2021-09-16 10:11:33.897
14688,7,1312,서울,7,6,1,3096,2020-06-30 09:00:00.000,2021-09-16 10:11:33.897
14689,3,154,부산,1,0,1,3095,2020-06-30 09:00:00.000,2021-09-16 10:11:33.897
14690,189,6906,대구,0,0,0,3094,2020-06-30 09:00:00.000,2021-09-16 10:11:33.897
14691,1,341,인천,3,0,3,3093,2020-06-30 09:00:00.000,2021-09-16 10:11:33.897
14692,0,44,광주,3,3,0,3092,2020-06-30 09:00:00.000,2021-09-16 10:11:33.897
14693,1,117,대전,5,5,0,3091,2020-06-30 09:00:00.000,2021-09-16 10:11:33.897
14694,1,55,울산,0,0,0,3090,2020-06-30 09:00:00.000,2021-09-16 10:11:33.897
14695,0,50,세종,1,0,1,3089,2020-06-30 09:00:00.000,2021-09-16 10:11:33.897
14696,23,1207,경기,7,7,0,3088,2020-06-30 09:00:00.000,2021-09-16 10:11:33.897
14697,3,65,강원,1,1,0,3087,2020-06-30 09:00:00.000,2021-09-16 10:11:33.897
14698,0,64,충북,0,0,0,3086,2020-06-30 09:00:00.000,2021-09-16 10:11:33.897
14699,0,167,충남,0,0,0,3085,2020-06-30 09:00:00.000,2021-09-16 10:11:33.897
14700,0,27,전북,0,0,0,3084,2020-06-30 09:00:00.000,2021-09-16 10:11:33.897
14701,0,24,전남,0,0,0,3083,2020-06-30 09:00:00.000,2021-09-16 10:11:33.897
14702,54,1389,경북,1,0,1,3082,2020-06-30 09:00:00.000,2021-09-16 10:11:33.897
14703,0,134,경남,0,0,0,3081,2020-06-30 09:00:00.000,2021-09-16 10:11:33.897
14704,0,19,제주,0,0,0,3080,2020-06-30 09:00:00.000,2021-09-16 10:11:33.897
14705,0,724,검역,13,0,13,3079,2020-06-30 09:00:00.000,2021-09-16 10:11:33.897
14706,282,12757,합계,42,30,12,3078,2020-06-29 09:00:00.000,2021-09-16 10:11:33.897
14707,7,1305,서울,7,6,1,3077,2020-06-29 09:00:00.000,2021-09-16 10:11:33.897
14708,3,153,부산,1,1,0,3076,2020-06-29 09:00:00.000,2021-09-16 10:11:33.897
14709,189,6906,대구,2,2,0,3075,2020-06-29 09:00:00.000,2021-09-16 10:11:33.897
14710,1,338,인천,1,1,0,3074,2020-06-29 09:00:00.000,2021-09-16 10:11:33.897
14711,0,41,광주,4,3,1,3073,2020-06-29 09:00:00.000,2021-09-16 10:11:33.897
14712,1,112,대전,2,2,0,3072,2020-06-29 09:00:00.000,2021-09-16 10:11:33.897
14713,1,55,울산,0,0,0,3071,2020-06-29 09:00:00.000,2021-09-16 10:11:33.897
14714,0,49,세종,0,0,0,3070,2020-06-29 09:00:00.000,2021-09-16 10:11:33.897
14715,23,1200,경기,16,14,2,3069,2020-06-29 09:00:00.000,2021-09-16 10:11:33.897
14716,3,64,강원,0,0,0,3068,2020-06-29 09:00:00.000,2021-09-16 10:11:33.897
14717,0,64,충북,0,0,0,3067,2020-06-29 09:00:00.000,2021-09-16 10:11:33.897
14718,0,167,충남,0,0,0,3066,2020-06-29 09:00:00.000,2021-09-16 10:11:33.897
14719,0,27,전북,1,1,0,3065,2020-06-29 09:00:00.000,2021-09-16 10:11:33.897
14720,0,24,전남,1,0,1,3064,2020-06-29 09:00:00.000,2021-09-16 10:11:33.897
14721,54,1388,경북,1,0,1,3063,2020-06-29 09:00:00.000,2021-09-16 10:11:33.897
14722,0,134,경남,1,0,1,3062,2020-06-29 09:00:00.000,2021-09-16 10:11:33.897
14723,0,19,제주,0,0,0,3061,2020-06-29 09:00:00.000,2021-09-16 10:11:33.897
14724,0,711,검역,5,0,5,3060,2020-06-29 09:00:00.000,2021-09-16 10:11:33.897
14725,282,12715,합계,62,40,22,3059,2020-06-28 09:00:00.000,2021-09-16 10:11:33.897
14726,7,1298,서울,14,13,1,3058,2020-06-28 09:00:00.000,2021-09-16 10:11:33.897
14727,3,152,부산,0,0,0,3057,2020-06-28 09:00:00.000,2021-09-16 10:11:33.897
14728,189,6904,대구,0,0,0,3056,2020-06-28 09:00:00.000,2021-09-16 10:11:33.897
14729,1,337,인천,0,0,0,3055,2020-06-28 09:00:00.000,2021-09-16 10:11:33.897
14730,0,37,광주,4,4,0,3054,2020-06-28 09:00:00.000,2021-09-16 10:11:33.897
14731,1,110,대전,6,6,0,3053,2020-06-28 09:00:00.000,2021-09-16 10:11:33.897
14732,1,55,울산,0,0,0,3052,2020-06-28 09:00:00.000,2021-09-16 10:11:33.897
14733,0,49,세종,0,0,0,3051,2020-06-28 09:00:00.000,2021-09-16 10:11:33.897
14734,23,1184,경기,17,13,4,3050,2020-06-28 09:00:00.000,2021-09-16 10:11:33.897
14735,3,64,강원,0,0,0,3049,2020-06-28 09:00:00.000,2021-09-16 10:11:33.897
14736,0,64,충북,1,1,0,3048,2020-06-28 09:00:00.000,2021-09-16 10:11:33.897
14737,0,167,충남,1,0,1,3047,2020-06-28 09:00:00.000,2021-09-16 10:11:33.897
14738,0,26,전북,0,0,0,3046,2020-06-28 09:00:00.000,2021-09-16 10:11:33.897
14739,0,23,전남,3,3,0,3045,2020-06-28 09:00:00.000,2021-09-16 10:11:33.897
14740,54,1387,경북,0,0,0,3044,2020-06-28 09:00:00.000,2021-09-16 10:11:33.897
14741,0,133,경남,0,0,0,3043,2020-06-28 09:00:00.000,2021-09-16 10:11:33.897
14742,0,19,제주,0,0,0,3042,2020-06-28 09:00:00.000,2021-09-16 10:11:33.897
14743,0,706,검역,16,0,16,3041,2020-06-28 09:00:00.000,2021-09-16 10:11:33.897
14744,282,12653,합계,51,31,20,3040,2020-06-27 09:00:00.000,2021-09-16 10:11:33.897
14745,7,1284,서울,17,15,2,3039,2020-06-27 09:00:00.000,2021-09-16 10:11:33.897
14746,3,152,부산,0,0,0,3038,2020-06-27 09:00:00.000,2021-09-16 10:11:33.897
14747,189,6904,대구,1,1,0,3037,2020-06-27 09:00:00.000,2021-09-16 10:11:33.897
14748,1,337,인천,1,0,1,3036,2020-06-27 09:00:00.000,2021-09-16 10:11:33.897
14749,0,33,광주,0,0,0,3035,2020-06-27 09:00:00.000,2021-09-16 10:11:33.897
14750,1,104,대전,2,2,0,3034,2020-06-27 09:00:00.000,2021-09-16 10:11:33.897
14751,1,55,울산,0,0,0,3033,2020-06-27 09:00:00.000,2021-09-16 10:11:33.897
14752,0,49,세종,0,0,0,3032,2020-06-27 09:00:00.000,2021-09-16 10:11:33.897
14753,23,1167,경기,17,12,5,3031,2020-06-27 09:00:00.000,2021-09-16 10:11:33.897
14754,3,64,강원,0,0,0,3030,2020-06-27 09:00:00.000,2021-09-16 10:11:33.897
14755,0,63,충북,1,0,1,3029,2020-06-27 09:00:00.000,2021-09-16 10:11:33.897
14756,0,166,충남,0,0,0,3028,2020-06-27 09:00:00.000,2021-09-16 10:11:33.897
14757,0,26,전북,1,1,0,3027,2020-06-27 09:00:00.000,2021-09-16 10:11:33.897
14758,0,20,전남,0,0,0,3026,2020-06-27 09:00:00.000,2021-09-16 10:11:33.897
14759,54,1387,경북,0,0,0,3025,2020-06-27 09:00:00.000,2021-09-16 10:11:33.897
14760,0,133,경남,0,0,0,3024,2020-06-27 09:00:00.000,2021-09-16 10:11:33.897
14761,0,19,제주,0,0,0,3023,2020-06-27 09:00:00.000,2021-09-16 10:11:33.897
14762,0,690,검역,11,0,11,3022,2020-06-27 09:00:00.000,2021-09-16 10:11:33.897
14763,282,12602,합계,39,26,13,3021,2020-06-26 09:00:00.000,2021-09-16 10:11:33.897
14764,7,1267,서울,17,16,1,3020,2020-06-26 09:00:00.000,2021-09-16 10:11:33.897
14765,3,152,부산,0,0,0,3019,2020-06-26 09:00:00.000,2021-09-16 10:11:33.897
14766,189,6903,대구,0,0,0,3018,2020-06-26 09:00:00.000,2021-09-16 10:11:33.897
14767,1,336,인천,2,0,2,3017,2020-06-26 09:00:00.000,2021-09-16 10:11:33.897
14768,0,33,광주,0,0,0,3016,2020-06-26 09:00:00.000,2021-09-16 10:11:33.897
14769,1,102,대전,4,4,0,3015,2020-06-26 09:00:00.000,2021-09-16 10:11:33.897
14770,1,55,울산,0,0,0,3014,2020-06-26 09:00:00.000,2021-09-16 10:11:33.897
14771,0,49,세종,0,0,0,3013,2020-06-26 09:00:00.000,2021-09-16 10:11:33.897
14772,23,1150,경기,4,2,2,3012,2020-06-26 09:00:00.000,2021-09-16 10:11:33.897
14773,3,64,강원,1,1,0,3011,2020-06-26 09:00:00.000,2021-09-16 10:11:33.897
14774,0,62,충북,0,0,0,3010,2020-06-26 09:00:00.000,2021-09-16 10:11:33.897
14775,0,166,충남,3,3,0,3009,2020-06-26 09:00:00.000,2021-09-16 10:11:33.897
14776,0,25,전북,0,0,0,3008,2020-06-26 09:00:00.000,2021-09-16 10:11:33.897
14777,0,20,전남,0,0,0,3007,2020-06-26 09:00:00.000,2021-09-16 10:11:33.897
14778,54,1387,경북,1,0,1,3006,2020-06-26 09:00:00.000,2021-09-16 10:11:33.897
14779,0,133,경남,0,0,0,3005,2020-06-26 09:00:00.000,2021-09-16 10:11:33.897
14780,0,19,제주,0,0,0,3004,2020-06-26 09:00:00.000,2021-09-16 10:11:33.897
14781,0,679,검역,7,0,7,3003,2020-06-26 09:00:00.000,2021-09-16 10:11:33.897
14782,282,12563,합계,28,23,5,3002,2020-06-25 09:00:00.000,2021-09-16 10:11:33.897
14783,7,1250,서울,9,8,1,3001,2020-06-25 09:00:00.000,2021-09-16 10:11:33.897
14784,3,152,부산,0,0,0,3000,2020-06-25 09:00:00.000,2021-09-16 10:11:33.897
14785,189,6903,대구,0,0,0,2999,2020-06-25 09:00:00.000,2021-09-16 10:11:33.897
14786,1,334,인천,1,1,0,2998,2020-06-25 09:00:00.000,2021-09-16 10:11:33.897
14787,0,33,광주,0,0,0,2997,2020-06-25 09:00:00.000,2021-09-16 10:11:33.897
14788,1,98,대전,4,4,0,2996,2020-06-25 09:00:00.000,2021-09-16 10:11:33.897
14789,1,55,울산,0,0,0,2995,2020-06-25 09:00:00.000,2021-09-16 10:11:33.897
14790,0,49,세종,0,0,0,2994,2020-06-25 09:00:00.000,2021-09-16 10:11:33.897
14791,23,1146,경기,9,9,0,2993,2020-06-25 09:00:00.000,2021-09-16 10:11:33.897
14792,3,63,강원,0,0,0,2992,2020-06-25 09:00:00.000,2021-09-16 10:11:33.897
14793,0,62,충북,0,0,0,2991,2020-06-25 09:00:00.000,2021-09-16 10:11:33.897
14794,0,163,충남,1,1,0,2990,2020-06-25 09:00:00.000,2021-09-16 10:11:33.897
14795,0,25,전북,0,0,0,2989,2020-06-25 09:00:00.000,2021-09-16 10:11:33.897
14796,0,20,전남,0,0,0,2988,2020-06-25 09:00:00.000,2021-09-16 10:11:33.897
14797,54,1386,경북,0,0,0,2987,2020-06-25 09:00:00.000,2021-09-16 10:11:33.897
14798,0,133,경남,0,0,0,2986,2020-06-25 09:00:00.000,2021-09-16 10:11:33.897
14799,0,19,제주,0,0,0,2985,2020-06-25 09:00:00.000,2021-09-16 10:11:33.897
14800,0,672,검역,4,0,4,2984,2020-06-25 09:00:00.000,2021-09-16 10:11:33.897
14801,281,12535,합계,51,30,21,2983,2020-06-24 09:00:00.000,2021-09-16 10:11:33.897
14802,6,1241,서울,11,10,1,2982,2020-06-24 09:00:00.000,2021-09-16 10:11:33.897
14803,3,152,부산,2,0,2,2981,2020-06-24 09:00:00.000,2021-09-16 10:11:33.897
14804,189,6903,대구,2,0,2,2980,2020-06-24 09:00:00.000,2021-09-16 10:11:33.897
14805,1,333,인천,3,3,0,2979,2020-06-24 09:00:00.000,2021-09-16 10:11:33.897
14806,0,33,광주,0,0,0,2978,2020-06-24 09:00:00.000,2021-09-16 10:11:33.897
14807,1,94,대전,8,8,0,2977,2020-06-24 09:00:00.000,2021-09-16 10:11:33.897
14808,1,55,울산,2,2,0,2976,2020-06-24 09:00:00.000,2021-09-16 10:11:33.897
14809,0,49,세종,0,0,0,2975,2020-06-24 09:00:00.000,2021-09-16 10:11:33.897
14810,23,1137,경기,7,5,2,2974,2020-06-24 09:00:00.000,2021-09-16 10:11:33.897
14811,3,63,강원,1,1,0,2973,2020-06-24 09:00:00.000,2021-09-16 10:11:33.897
14812,0,62,충북,0,0,0,2972,2020-06-24 09:00:00.000,2021-09-16 10:11:33.897
14813,0,162,충남,1,1,0,2971,2020-06-24 09:00:00.000,2021-09-16 10:11:33.897
14814,0,25,전북,1,0,1,2970,2020-06-24 09:00:00.000,2021-09-16 10:11:33.897
14815,0,20,전남,0,0,0,2969,2020-06-24 09:00:00.000,2021-09-16 10:11:33.897
14816,54,1386,경북,1,0,1,2968,2020-06-24 09:00:00.000,2021-09-16 10:11:33.897
14817,0,133,경남,0,0,0,2967,2020-06-24 09:00:00.000,2021-09-16 10:11:33.897
14818,0,19,제주,0,0,0,2966,2020-06-24 09:00:00.000,2021-09-16 10:11:33.897
14819,0,668,검역,12,0,12,2965,2020-06-24 09:00:00.000,2021-09-16 10:11:33.897
14820,281,12484,합계,46,16,30,2964,2020-06-23 09:00:00.000,2021-09-16 10:11:33.897
14821,6,1230,서울,6,6,0,2963,2020-06-23 09:00:00.000,2021-09-16 10:11:33.897
14822,3,150,부산,0,0,0,2962,2020-06-23 09:00:00.000,2021-09-16 10:11:33.897
14823,189,6901,대구,1,1,0,2961,2020-06-23 09:00:00.000,2021-09-16 10:11:33.897
14824,1,330,인천,1,1,0,2960,2020-06-23 09:00:00.000,2021-09-16 10:11:33.897
14825,0,33,광주,0,0,0,2959,2020-06-23 09:00:00.000,2021-09-16 10:11:33.897
14826,1,86,대전,4,4,0,2958,2020-06-23 09:00:00.000,2021-09-16 10:11:33.897
14827,1,53,울산,0,0,0,2957,2020-06-23 09:00:00.000,2021-09-16 10:11:33.897
14828,0,49,세종,0,0,0,2956,2020-06-23 09:00:00.000,2021-09-16 10:11:33.897
14829,23,1130,경기,7,4,3,2955,2020-06-23 09:00:00.000,2021-09-16 10:11:33.897
14830,3,62,강원,0,0,0,2954,2020-06-23 09:00:00.000,2021-09-16 10:11:33.897
14831,0,62,충북,1,0,1,2953,2020-06-23 09:00:00.000,2021-09-16 10:11:33.897
14832,0,161,충남,0,0,0,2952,2020-06-23 09:00:00.000,2021-09-16 10:11:33.897
14833,0,24,전북,0,0,0,2951,2020-06-23 09:00:00.000,2021-09-16 10:11:33.897
14834,0,20,전남,0,0,0,2950,2020-06-23 09:00:00.000,2021-09-16 10:11:33.897
14835,54,1385,경북,0,0,0,2949,2020-06-23 09:00:00.000,2021-09-16 10:11:33.897
14836,0,133,경남,0,0,0,2948,2020-06-23 09:00:00.000,2021-09-16 10:11:33.897
14837,0,19,제주,0,0,0,2947,2020-06-23 09:00:00.000,2021-09-16 10:11:33.897
14838,0,656,검역,26,0,26,2946,2020-06-23 09:00:00.000,2021-09-16 10:11:33.897
14839,280,12438,합계,17,11,6,2945,2020-06-22 09:00:00.000,2021-09-16 10:11:33.897
14840,6,1224,서울,5,4,1,2944,2020-06-22 09:00:00.000,2021-09-16 10:11:33.897
14841,3,150,부산,0,0,0,2943,2020-06-22 09:00:00.000,2021-09-16 10:11:33.897
14842,189,6900,대구,1,1,0,2942,2020-06-22 09:00:00.000,2021-09-16 10:11:33.897
14843,1,329,인천,1,0,1,2941,2020-06-22 09:00:00.000,2021-09-16 10:11:33.897
14844,0,33,광주,0,0,0,2940,2020-06-22 09:00:00.000,2021-09-16 10:11:33.897
14845,1,82,대전,0,0,0,2939,2020-06-22 09:00:00.000,2021-09-16 10:11:33.897
14846,1,53,울산,0,0,0,2938,2020-06-22 09:00:00.000,2021-09-16 10:11:33.897
14847,0,49,세종,0,0,0,2937,2020-06-22 09:00:00.000,2021-09-16 10:11:33.897
14848,22,1123,경기,6,3,3,2936,2020-06-22 09:00:00.000,2021-09-16 10:11:33.897
14849,3,62,강원,0,0,0,2935,2020-06-22 09:00:00.000,2021-09-16 10:11:33.897
14850,0,61,충북,0,0,0,2934,2020-06-22 09:00:00.000,2021-09-16 10:11:33.897
14851,0,161,충남,2,2,0,2933,2020-06-22 09:00:00.000,2021-09-16 10:11:33.897
14852,0,24,전북,1,1,0,2932,2020-06-22 09:00:00.000,2021-09-16 10:11:33.897
14853,0,20,전남,0,0,0,2931,2020-06-22 09:00:00.000,2021-09-16 10:11:33.897
14854,54,1385,경북,1,0,1,2930,2020-06-22 09:00:00.000,2021-09-16 10:11:33.897
14855,0,133,경남,0,0,0,2929,2020-06-22 09:00:00.000,2021-09-16 10:11:33.897
14856,0,19,제주,0,0,0,2928,2020-06-22 09:00:00.000,2021-09-16 10:11:33.897
14857,0,630,검역,0,0,0,2927,2020-06-22 09:00:00.000,2021-09-16 10:11:33.897
14858,280,12421,합계,48,40,8,2926,2020-06-21 09:00:00.000,2021-09-16 10:11:33.897
14859,6,1219,서울,17,16,1,2925,2020-06-21 09:00:00.000,2021-09-16 10:11:33.897
14860,3,150,부산,0,0,0,2924,2020-06-21 09:00:00.000,2021-09-16 10:11:33.897
14861,189,6899,대구,1,1,0,2923,2020-06-21 09:00:00.000,2021-09-16 10:11:33.897
14862,1,328,인천,0,0,0,2922,2020-06-21 09:00:00.000,2021-09-16 10:11:33.897
14863,0,33,광주,1,1,0,2921,2020-06-21 09:00:00.000,2021-09-16 10:11:33.897
14864,1,82,대전,10,10,0,2920,2020-06-21 09:00:00.000,2021-09-16 10:11:33.897
14865,1,53,울산,0,0,0,2919,2020-06-21 09:00:00.000,2021-09-16 10:11:33.897
14866,0,49,세종,1,1,0,2918,2020-06-21 09:00:00.000,2021-09-16 10:11:33.897
14867,22,1117,경기,10,8,2,2917,2020-06-21 09:00:00.000,2021-09-16 10:11:33.897
14868,3,62,강원,2,2,0,2916,2020-06-21 09:00:00.000,2021-09-16 10:11:33.897
14869,0,61,충북,0,0,0,2915,2020-06-21 09:00:00.000,2021-09-16 10:11:33.897
14870,0,159,충남,1,1,0,2914,2020-06-21 09:00:00.000,2021-09-16 10:11:33.897
14871,0,23,전북,0,0,0,2913,2020-06-21 09:00:00.000,2021-09-16 10:11:33.897
14872,0,20,전남,0,0,0,2912,2020-06-21 09:00:00.000,2021-09-16 10:11:33.897
14873,54,1384,경북,0,0,0,2911,2020-06-21 09:00:00.000,2021-09-16 10:11:33.897
14874,0,133,경남,1,0,1,2910,2020-06-21 09:00:00.000,2021-09-16 10:11:33.897
14875,0,19,제주,0,0,0,2909,2020-06-21 09:00:00.000,2021-09-16 10:11:33.897
14876,0,630,검역,4,0,4,2908,2020-06-21 09:00:00.000,2021-09-16 10:11:33.897
14877,280,12373,합계,67,36,31,2907,2020-06-20 09:00:00.000,2021-09-16 10:11:33.897
14878,6,1202,서울,14,13,1,2906,2020-06-20 09:00:00.000,2021-09-16 10:11:33.897
14879,3,150,부산,2,0,2,2905,2020-06-20 09:00:00.000,2021-09-16 10:11:33.897
14880,189,6898,대구,2,2,0,2904,2020-06-20 09:00:00.000,2021-09-16 10:11:33.897
14881,1,328,인천,5,4,1,2903,2020-06-20 09:00:00.000,2021-09-16 10:11:33.897
14882,0,32,광주,0,0,0,2902,2020-06-20 09:00:00.000,2021-09-16 10:11:33.897
14883,1,72,대전,5,5,0,2901,2020-06-20 09:00:00.000,2021-09-16 10:11:33.897
14884,1,53,울산,0,0,0,2900,2020-06-20 09:00:00.000,2021-09-16 10:11:33.897
14885,0,48,세종,0,0,0,2899,2020-06-20 09:00:00.000,2021-09-16 10:11:33.897
14886,22,1107,경기,17,10,7,2898,2020-06-20 09:00:00.000,2021-09-16 10:11:33.897
14887,3,60,강원,0,0,0,2897,2020-06-20 09:00:00.000,2021-09-16 10:11:33.897
14888,0,61,충북,0,0,0,2896,2020-06-20 09:00:00.000,2021-09-16 10:11:33.897
14889,0,158,충남,2,2,0,2895,2020-06-20 09:00:00.000,2021-09-16 10:11:33.897
14890,0,23,전북,1,0,1,2894,2020-06-20 09:00:00.000,2021-09-16 10:11:33.897
14891,0,20,전남,0,0,0,2893,2020-06-20 09:00:00.000,2021-09-16 10:11:33.897
14892,54,1384,경북,1,0,1,2892,2020-06-20 09:00:00.000,2021-09-16 10:11:33.897
14893,0,132,경남,0,0,0,2891,2020-06-20 09:00:00.000,2021-09-16 10:11:33.897
14894,0,19,제주,0,0,0,2890,2020-06-20 09:00:00.000,2021-09-16 10:11:33.897
14895,0,626,검역,18,0,18,2889,2020-06-20 09:00:00.000,2021-09-16 10:11:33.897
14896,280,12306,합계,49,32,17,2888,2020-06-19 09:00:00.000,2021-09-16 10:11:33.897
14897,6,1188,서울,18,17,1,2887,2020-06-19 09:00:00.000,2021-09-16 10:11:33.897
14898,3,148,부산,0,0,0,2886,2020-06-19 09:00:00.000,2021-09-16 10:11:33.897
14899,189,6896,대구,0,0,0,2885,2020-06-19 09:00:00.000,2021-09-16 10:11:33.897
14900,1,323,인천,0,0,0,2884,2020-06-19 09:00:00.000,2021-09-16 10:11:33.897
14901,0,32,광주,0,0,0,2883,2020-06-19 09:00:00.000,2021-09-16 10:11:33.897
14902,1,67,대전,6,6,0,2882,2020-06-19 09:00:00.000,2021-09-16 10:11:33.897
14903,1,53,울산,0,0,0,2881,2020-06-19 09:00:00.000,2021-09-16 10:11:33.897
14904,0,48,세종,0,0,0,2880,2020-06-19 09:00:00.000,2021-09-16 10:11:33.897
14905,22,1090,경기,11,9,2,2879,2020-06-19 09:00:00.000,2021-09-16 10:11:33.897
14906,3,60,강원,0,0,0,2878,2020-06-19 09:00:00.000,2021-09-16 10:11:33.897
14907,0,61,충북,0,0,0,2877,2020-06-19 09:00:00.000,2021-09-16 10:11:33.897
14908,0,156,충남,0,0,0,2876,2020-06-19 09:00:00.000,2021-09-16 10:11:33.897
14909,0,22,전북,0,0,0,2875,2020-06-19 09:00:00.000,2021-09-16 10:11:33.897
14910,0,20,전남,0,0,0,2874,2020-06-19 09:00:00.000,2021-09-16 10:11:33.897
14911,54,1383,경북,0,0,0,2873,2020-06-19 09:00:00.000,2021-09-16 10:11:33.897
14912,0,132,경남,0,0,0,2872,2020-06-19 09:00:00.000,2021-09-16 10:11:33.897
14913,0,19,제주,3,0,3,2871,2020-06-19 09:00:00.000,2021-09-16 10:11:33.897
14914,0,608,검역,11,0,11,2870,2020-06-19 09:00:00.000,2021-09-16 10:11:33.897
14915,280,12257,합계,59,51,8,2869,2020-06-18 09:00:00.000,2021-09-16 10:11:33.897
14916,6,1170,서울,25,24,1,2868,2020-06-18 09:00:00.000,2021-09-16 10:11:33.897
14917,3,148,부산,0,0,0,2867,2020-06-18 09:00:00.000,2021-09-16 10:11:33.897
14918,189,6896,대구,1,0,1,2866,2020-06-18 09:00:00.000,2021-09-16 10:11:33.897
14919,1,323,인천,1,0,1,2865,2020-06-18 09:00:00.000,2021-09-16 10:11:33.897
14920,0,32,광주,0,0,0,2864,2020-06-18 09:00:00.000,2021-09-16 10:11:33.897
14921,1,61,대전,7,7,0,2863,2020-06-18 09:00:00.000,2021-09-16 10:11:33.897
14922,1,53,울산,0,0,0,2862,2020-06-18 09:00:00.000,2021-09-16 10:11:33.897
14923,0,48,세종,1,1,0,2861,2020-06-18 09:00:00.000,2021-09-16 10:11:33.897
14924,22,1079,경기,16,15,1,2860,2020-06-18 09:00:00.000,2021-09-16 10:11:33.897
14925,3,60,강원,0,0,0,2859,2020-06-18 09:00:00.000,2021-09-16 10:11:33.897
14926,0,61,충북,0,0,0,2858,2020-06-18 09:00:00.000,2021-09-16 10:11:33.897
14927,0,156,충남,3,3,0,2857,2020-06-18 09:00:00.000,2021-09-16 10:11:33.897
14928,0,22,전북,1,1,0,2856,2020-06-18 09:00:00.000,2021-09-16 10:11:33.897
14929,0,20,전남,0,0,0,2855,2020-06-18 09:00:00.000,2021-09-16 10:11:33.897
14930,54,1383,경북,0,0,0,2854,2020-06-18 09:00:00.000,2021-09-16 10:11:33.897
14931,0,132,경남,0,0,0,2853,2020-06-18 09:00:00.000,2021-09-16 10:11:33.897
14932,0,16,제주,0,0,0,2852,2020-06-18 09:00:00.000,2021-09-16 10:11:33.897
14933,0,597,검역,4,0,4,2851,2020-06-18 09:00:00.000,2021-09-16 10:11:33.897
14934,279,12198,합계,43,31,12,2850,2020-06-17 09:00:00.000,2021-09-16 10:11:33.897
14935,5,1145,서울,13,12,1,2849,2020-06-17 09:00:00.000,2021-09-16 10:11:33.897
14936,3,148,부산,0,0,0,2848,2020-06-17 09:00:00.000,2021-09-16 10:11:33.897
14937,189,6895,대구,1,0,1,2847,2020-06-17 09:00:00.000,2021-09-16 10:11:33.897
14938,1,322,인천,2,2,0,2846,2020-06-17 09:00:00.000,2021-09-16 10:11:33.897
14939,0,32,광주,0,0,0,2845,2020-06-17 09:00:00.000,2021-09-16 10:11:33.897
14940,1,54,대전,5,5,0,2844,2020-06-17 09:00:00.000,2021-09-16 10:11:33.897
14941,1,53,울산,0,0,0,2843,2020-06-17 09:00:00.000,2021-09-16 10:11:33.897
14942,0,47,세종,0,0,0,2842,2020-06-17 09:00:00.000,2021-09-16 10:11:33.897
14943,22,1063,경기,13,11,2,2841,2020-06-17 09:00:00.000,2021-09-16 10:11:33.897
14944,3,60,강원,0,0,0,2840,2020-06-17 09:00:00.000,2021-09-16 10:11:33.897
14945,0,61,충북,0,0,0,2839,2020-06-17 09:00:00.000,2021-09-16 10:11:33.897
14946,0,153,충남,1,1,0,2838,2020-06-17 09:00:00.000,2021-09-16 10:11:33.897
14947,0,21,전북,0,0,0,2837,2020-06-17 09:00:00.000,2021-09-16 10:11:33.897
14948,0,20,전남,0,0,0,2836,2020-06-17 09:00:00.000,2021-09-16 10:11:33.897
14949,54,1383,경북,0,0,0,2835,2020-06-17 09:00:00.000,2021-09-16 10:11:33.897
14950,0,132,경남,0,0,0,2834,2020-06-17 09:00:00.000,2021-09-16 10:11:33.897
14951,0,16,제주,1,0,1,2833,2020-06-17 09:00:00.000,2021-09-16 10:11:33.897
14952,0,593,검역,7,0,7,2832,2020-06-17 09:00:00.000,2021-09-16 10:11:33.897
14953,278,12155,합계,34,21,13,2831,2020-06-16 09:00:00.000,2021-09-16 10:11:33.897
14954,4,1132,서울,12,11,1,2830,2020-06-16 09:00:00.000,2021-09-16 10:11:33.897
14955,3,148,부산,1,0,1,2829,2020-06-16 09:00:00.000,2021-09-16 10:11:33.897
14956,189,6894,대구,0,0,0,2828,2020-06-16 09:00:00.000,2021-09-16 10:11:33.897
14957,1,320,인천,2,2,0,2827,2020-06-16 09:00:00.000,2021-09-16 10:11:33.897
14958,0,32,광주,0,0,0,2826,2020-06-16 09:00:00.000,2021-09-16 10:11:33.897
14959,1,49,대전,3,3,0,2825,2020-06-16 09:00:00.000,2021-09-16 10:11:33.897
14960,1,53,울산,0,0,0,2824,2020-06-16 09:00:00.000,2021-09-16 10:11:33.897
14961,0,47,세종,0,0,0,2823,2020-06-16 09:00:00.000,2021-09-16 10:11:33.897
14962,22,1050,경기,5,4,1,2822,2020-06-16 09:00:00.000,2021-09-16 10:11:33.897
14963,3,60,강원,0,0,0,2821,2020-06-16 09:00:00.000,2021-09-16 10:11:33.897
14964,0,61,충북,0,0,0,2820,2020-06-16 09:00:00.000,2021-09-16 10:11:33.897
14965,0,152,충남,0,0,0,2819,2020-06-16 09:00:00.000,2021-09-16 10:11:33.897
14966,0,21,전북,0,0,0,2818,2020-06-16 09:00:00.000,2021-09-16 10:11:33.897
14967,0,20,전남,0,0,0,2817,2020-06-16 09:00:00.000,2021-09-16 10:11:33.897
14968,54,1383,경북,0,0,0,2816,2020-06-16 09:00:00.000,2021-09-16 10:11:33.897
14969,0,132,경남,2,1,1,2815,2020-06-16 09:00:00.000,2021-09-16 10:11:33.897
14970,0,15,제주,0,0,0,2814,2020-06-16 09:00:00.000,2021-09-16 10:11:33.897
14971,0,586,검역,9,0,9,2813,2020-06-16 09:00:00.000,2021-09-16 10:11:33.897
14972,277,12121,합계,37,24,13,2812,2020-06-15 09:00:00.000,2021-09-16 10:11:33.897
14973,4,1120,서울,7,6,1,2811,2020-06-15 09:00:00.000,2021-09-16 10:11:33.897
14974,3,147,부산,0,0,0,2810,2020-06-15 09:00:00.000,2021-09-16 10:11:33.897
14975,189,6894,대구,0,0,0,2809,2020-06-15 09:00:00.000,2021-09-16 10:11:33.897
14976,0,318,인천,8,8,0,2808,2020-06-15 09:00:00.000,2021-09-16 10:11:33.897
14977,0,32,광주,0,0,0,2807,2020-06-15 09:00:00.000,2021-09-16 10:11:33.897
14978,1,46,대전,0,0,0,2806,2020-06-15 09:00:00.000,2021-09-16 10:11:33.897
14979,1,53,울산,0,0,0,2805,2020-06-15 09:00:00.000,2021-09-16 10:11:33.897
14980,0,47,세종,0,0,0,2804,2020-06-15 09:00:00.000,2021-09-16 10:11:33.897
14981,22,1045,경기,10,8,2,2803,2020-06-15 09:00:00.000,2021-09-16 10:11:33.897
14982,3,60,강원,0,0,0,2802,2020-06-15 09:00:00.000,2021-09-16 10:11:33.897
14983,0,61,충북,0,0,0,2801,2020-06-15 09:00:00.000,2021-09-16 10:11:33.897
14984,0,152,충남,2,2,0,2800,2020-06-15 09:00:00.000,2021-09-16 10:11:33.897
14985,0,21,전북,0,0,0,2799,2020-06-15 09:00:00.000,2021-09-16 10:11:33.897
14986,0,20,전남,0,0,0,2798,2020-06-15 09:00:00.000,2021-09-16 10:11:33.897
14987,54,1383,경북,0,0,0,2797,2020-06-15 09:00:00.000,2021-09-16 10:11:33.897
14988,0,130,경남,3,0,3,2796,2020-06-15 09:00:00.000,2021-09-16 10:11:33.897
14989,0,15,제주,0,0,0,2795,2020-06-15 09:00:00.000,2021-09-16 10:11:33.897
14990,0,577,검역,7,0,7,2794,2020-06-15 09:00:00.000,2021-09-16 10:11:33.897
14991,277,12084,합계,34,31,3,2793,2020-06-14 09:00:00.000,2021-09-16 10:11:33.897
14992,4,1113,서울,12,12,0,2792,2020-06-14 09:00:00.000,2021-09-16 10:11:33.897
14993,3,147,부산,0,0,0,2791,2020-06-14 09:00:00.000,2021-09-16 10:11:33.897
14994,189,6894,대구,2,1,1,2790,2020-06-14 09:00:00.000,2021-09-16 10:11:33.897
14995,0,310,인천,8,8,0,2789,2020-06-14 09:00:00.000,2021-09-16 10:11:33.897
14996,0,32,광주,0,0,0,2788,2020-06-14 09:00:00.000,2021-09-16 10:11:33.897
14997,1,46,대전,0,0,0,2787,2020-06-14 09:00:00.000,2021-09-16 10:11:33.897
14998,1,53,울산,0,0,0,2786,2020-06-14 09:00:00.000,2021-09-16 10:11:33.897
14999,0,47,세종,0,0,0,2785,2020-06-14 09:00:00.000,2021-09-16 10:11:33.897
15000,22,1035,경기,10,9,1,2784,2020-06-14 09:00:00.000,2021-09-16 10:11:33.897
15001,3,60,강원,1,1,0,2783,2020-06-14 09:00:00.000,2021-09-16 10:11:33.897
15002,0,61,충북,0,0,0,2782,2020-06-14 09:00:00.000,2021-09-16 10:11:33.897
15003,0,150,충남,0,0,0,2781,2020-06-14 09:00:00.000,2021-09-16 10:11:33.897
15004,0,21,전북,0,0,0,2780,2020-06-14 09:00:00.000,2021-09-16 10:11:33.897
15005,0,20,전남,0,0,0,2779,2020-06-14 09:00:00.000,2021-09-16 10:11:33.897
15006,54,1383,경북,0,0,0,2778,2020-06-14 09:00:00.000,2021-09-16 10:11:33.897
15007,0,127,경남,0,0,0,2777,2020-06-14 09:00:00.000,2021-09-16 10:11:33.897
15008,0,15,제주,0,0,0,2776,2020-06-14 09:00:00.000,2021-09-16 10:11:33.897
15009,0,570,검역,1,0,1,2775,2020-06-14 09:00:00.000,2021-09-16 10:11:33.897
15010,277,12050,합계,48,43,5,2774,2020-06-13 09:00:00.000,2021-09-16 10:11:33.897
15011,4,1101,서울,29,29,0,2773,2020-06-13 09:00:00.000,2021-09-16 10:11:33.897
15012,3,147,부산,0,0,0,2772,2020-06-13 09:00:00.000,2021-09-16 10:11:33.897
15013,189,6892,대구,3,0,3,2771,2020-06-13 09:00:00.000,2021-09-16 10:11:33.897
15014,0,302,인천,1,1,0,2770,2020-06-13 09:00:00.000,2021-09-16 10:11:33.897
15015,0,32,광주,0,0,0,2769,2020-06-13 09:00:00.000,2021-09-16 10:11:33.897
15016,1,46,대전,0,0,0,2768,2020-06-13 09:00:00.000,2021-09-16 10:11:33.897
15017,1,53,울산,0,0,0,2767,2020-06-13 09:00:00.000,2021-09-16 10:11:33.897
15018,0,47,세종,0,0,0,2766,2020-06-13 09:00:00.000,2021-09-16 10:11:33.897
15019,22,1025,경기,14,13,1,2765,2020-06-13 09:00:00.000,2021-09-16 10:11:33.897
15020,3,59,강원,0,0,0,2764,2020-06-13 09:00:00.000,2021-09-16 10:11:33.897
15021,0,61,충북,0,0,0,2763,2020-06-13 09:00:00.000,2021-09-16 10:11:33.897
15022,0,150,충남,0,0,0,2762,2020-06-13 09:00:00.000,2021-09-16 10:11:33.897
15023,0,21,전북,0,0,0,2761,2020-06-13 09:00:00.000,2021-09-16 10:11:33.897
15024,0,20,전남,0,0,0,2760,2020-06-13 09:00:00.000,2021-09-16 10:11:33.897
15025,54,1383,경북,0,0,0,2759,2020-06-13 09:00:00.000,2021-09-16 10:11:33.897
15026,0,127,경남,0,0,0,2758,2020-06-13 09:00:00.000,2021-09-16 10:11:33.897
15027,0,15,제주,0,0,0,2757,2020-06-13 09:00:00.000,2021-09-16 10:11:33.897
15028,0,569,검역,1,0,1,2756,2020-06-13 09:00:00.000,2021-09-16 10:11:33.897
15029,277,12002,합계,56,43,13,2755,2020-06-12 09:00:00.000,2021-09-16 10:11:33.897
15030,4,1072,서울,25,24,1,2754,2020-06-12 09:00:00.000,2021-09-16 10:11:33.897
15031,3,147,부산,0,0,0,2753,2020-06-12 09:00:00.000,2021-09-16 10:11:33.897
15032,189,6889,대구,1,1,0,2752,2020-06-12 09:00:00.000,2021-09-16 10:11:33.897
15033,0,301,인천,1,0,1,2751,2020-06-12 09:00:00.000,2021-09-16 10:11:33.897
15034,0,32,광주,0,0,0,2750,2020-06-12 09:00:00.000,2021-09-16 10:11:33.897
15035,1,46,대전,0,0,0,2749,2020-06-12 09:00:00.000,2021-09-16 10:11:33.897
15036,1,53,울산,0,0,0,2748,2020-06-12 09:00:00.000,2021-09-16 10:11:33.897
15037,0,47,세종,0,0,0,2747,2020-06-12 09:00:00.000,2021-09-16 10:11:33.897
15038,22,1011,경기,19,18,1,2746,2020-06-12 09:00:00.000,2021-09-16 10:11:33.897
15039,3,59,강원,0,0,0,2745,2020-06-12 09:00:00.000,2021-09-16 10:11:33.897
15040,0,61,충북,0,0,0,2744,2020-06-12 09:00:00.000,2021-09-16 10:11:33.897
15041,0,150,충남,0,0,0,2743,2020-06-12 09:00:00.000,2021-09-16 10:11:33.897
15042,0,21,전북,0,0,0,2742,2020-06-12 09:00:00.000,2021-09-16 10:11:33.897
15043,0,20,전남,0,0,0,2741,2020-06-12 09:00:00.000,2021-09-16 10:11:33.897
15044,54,1383,경북,0,0,0,2740,2020-06-12 09:00:00.000,2021-09-16 10:11:33.897
15045,0,127,경남,0,0,0,2739,2020-06-12 09:00:00.000,2021-09-16 10:11:33.897
15046,0,15,제주,0,0,0,2738,2020-06-12 09:00:00.000,2021-09-16 10:11:33.897
15047,0,568,검역,10,0,10,2737,2020-06-12 09:00:00.000,2021-09-16 10:11:33.897
15048,276,11946,합계,45,40,5,2736,2020-06-11 09:00:00.000,2021-09-16 10:11:33.897
15049,4,1047,서울,21,20,1,2735,2020-06-11 09:00:00.000,2021-09-16 10:11:33.897
15050,3,147,부산,0,0,0,2734,2020-06-11 09:00:00.000,2021-09-16 10:11:33.897
15051,188,6888,대구,0,0,0,2733,2020-06-11 09:00:00.000,2021-09-16 10:11:33.897
15052,0,300,인천,6,5,1,2732,2020-06-11 09:00:00.000,2021-09-16 10:11:33.897
15053,0,32,광주,0,0,0,2731,2020-06-11 09:00:00.000,2021-09-16 10:11:33.897
15054,1,46,대전,0,0,0,2730,2020-06-11 09:00:00.000,2021-09-16 10:11:33.897
15055,1,53,울산,0,0,0,2729,2020-06-11 09:00:00.000,2021-09-16 10:11:33.897
15056,0,47,세종,0,0,0,2728,2020-06-11 09:00:00.000,2021-09-16 10:11:33.897
15057,22,992,경기,16,15,1,2727,2020-06-11 09:00:00.000,2021-09-16 10:11:33.897
15058,3,59,강원,0,0,0,2726,2020-06-11 09:00:00.000,2021-09-16 10:11:33.897
15059,0,61,충북,0,0,0,2725,2020-06-11 09:00:00.000,2021-09-16 10:11:33.897
15060,0,150,충남,0,0,0,2724,2020-06-11 09:00:00.000,2021-09-16 10:11:33.897
15061,0,21,전북,0,0,0,2723,2020-06-11 09:00:00.000,2021-09-16 10:11:33.897
15062,0,20,전남,0,0,0,2722,2020-06-11 09:00:00.000,2021-09-16 10:11:33.897
15063,54,1383,경북,0,0,0,2721,2020-06-11 09:00:00.000,2021-09-16 10:11:33.897
15064,0,127,경남,0,0,0,2720,2020-06-11 09:00:00.000,2021-09-16 10:11:33.897
15065,0,15,제주,0,0,0,2719,2020-06-11 09:00:00.000,2021-09-16 10:11:33.897
15066,0,558,검역,2,0,2,2718,2020-06-11 09:00:00.000,2021-09-16 10:11:33.897
15067,276,11901,합계,50,43,7,2717,2020-06-10 09:00:00.000,2021-09-16 10:11:33.897
15068,4,1026,서울,12,12,0,2716,2020-06-10 09:00:00.000,2021-09-16 10:11:33.897
15069,3,147,부산,0,0,0,2715,2020-06-10 09:00:00.000,2021-09-16 10:11:33.897
15070,188,6888,대구,0,0,0,2714,2020-06-10 09:00:00.000,2021-09-16 10:11:33.897
15071,0,294,인천,8,8,0,2713,2020-06-10 09:00:00.000,2021-09-16 10:11:33.897
15072,0,32,광주,0,0,0,2712,2020-06-10 09:00:00.000,2021-09-16 10:11:33.897
15073,1,46,대전,0,0,0,2711,2020-06-10 09:00:00.000,2021-09-16 10:11:33.897
15074,1,53,울산,0,0,0,2710,2020-06-10 09:00:00.000,2021-09-16 10:11:33.897
15075,0,47,세종,0,0,0,2709,2020-06-10 09:00:00.000,2021-09-16 10:11:33.897
15076,22,976,경기,21,20,1,2708,2020-06-10 09:00:00.000,2021-09-16 10:11:33.897
15077,3,59,강원,1,1,0,2707,2020-06-10 09:00:00.000,2021-09-16 10:11:33.897
15078,0,61,충북,0,0,0,2706,2020-06-10 09:00:00.000,2021-09-16 10:11:33.897
15079,0,150,충남,0,0,0,2705,2020-06-10 09:00:00.000,2021-09-16 10:11:33.897
15080,0,21,전북,0,0,0,2704,2020-06-10 09:00:00.000,2021-09-16 10:11:33.897
15081,0,20,전남,0,0,0,2703,2020-06-10 09:00:00.000,2021-09-16 10:11:33.897
15082,54,1383,경북,0,0,0,2702,2020-06-10 09:00:00.000,2021-09-16 10:11:33.897
15083,0,127,경남,2,2,0,2701,2020-06-10 09:00:00.000,2021-09-16 10:11:33.897
15084,0,15,제주,0,0,0,2700,2020-06-10 09:00:00.000,2021-09-16 10:11:33.897
15085,0,556,검역,6,0,6,2699,2020-06-10 09:00:00.000,2021-09-16 10:11:33.897
15086,274,11851,합계,38,35,3,2698,2020-06-09 09:00:00.000,2021-09-16 10:11:33.897
15087,4,1014,서울,19,18,1,2697,2020-06-09 09:00:00.000,2021-09-16 10:11:33.897
15088,3,147,부산,0,0,0,2696,2020-06-09 09:00:00.000,2021-09-16 10:11:33.897
15089,188,6888,대구,0,0,0,2695,2020-06-09 09:00:00.000,2021-09-16 10:11:33.897
15090,0,286,인천,3,3,0,2694,2020-06-09 09:00:00.000,2021-09-16 10:11:33.897
15091,0,32,광주,0,0,0,2693,2020-06-09 09:00:00.000,2021-09-16 10:11:33.897
15092,1,46,대전,0,0,0,2692,2020-06-09 09:00:00.000,2021-09-16 10:11:33.897
15093,1,53,울산,0,0,0,2691,2020-06-09 09:00:00.000,2021-09-16 10:11:33.897
15094,0,47,세종,0,0,0,2690,2020-06-09 09:00:00.000,2021-09-16 10:11:33.897
15095,20,955,경기,13,12,1,2689,2020-06-09 09:00:00.000,2021-09-16 10:11:33.897
15096,3,58,강원,0,0,0,2688,2020-06-09 09:00:00.000,2021-09-16 10:11:33.897
15097,0,61,충북,0,0,0,2687,2020-06-09 09:00:00.000,2021-09-16 10:11:33.897
15098,0,150,충남,2,1,1,2686,2020-06-09 09:00:00.000,2021-09-16 10:11:33.897
15099,0,21,전북,0,0,0,2685,2020-06-09 09:00:00.000,2021-09-16 10:11:33.897
15100,0,20,전남,0,0,0,2684,2020-06-09 09:00:00.000,2021-09-16 10:11:33.897
15101,54,1383,경북,0,0,0,2683,2020-06-09 09:00:00.000,2021-09-16 10:11:33.897
15102,0,125,경남,1,1,0,2682,2020-06-09 09:00:00.000,2021-09-16 10:11:33.897
15103,0,15,제주,0,0,0,2681,2020-06-09 09:00:00.000,2021-09-16 10:11:33.897
15104,0,550,검역,0,0,0,2680,2020-06-09 09:00:00.000,2021-09-16 10:11:33.897
15105,273,11813,합계,37,32,5,2679,2020-06-08 09:00:00.000,2021-09-16 10:11:33.897
15106,4,995,서울,21,21,0,2678,2020-06-08 09:00:00.000,2021-09-16 10:11:33.897
15107,3,147,부산,0,0,0,2677,2020-06-08 09:00:00.000,2021-09-16 10:11:33.897
15108,188,6888,대구,1,0,1,2676,2020-06-08 09:00:00.000,2021-09-16 10:11:33.897
15109,0,283,인천,4,4,0,2675,2020-06-08 09:00:00.000,2021-09-16 10:11:33.897
15110,0,32,광주,0,0,0,2674,2020-06-08 09:00:00.000,2021-09-16 10:11:33.897
15111,1,46,대전,0,0,0,2673,2020-06-08 09:00:00.000,2021-09-16 10:11:33.897
15112,1,53,울산,0,0,0,2672,2020-06-08 09:00:00.000,2021-09-16 10:11:33.897
15113,0,47,세종,0,0,0,2671,2020-06-08 09:00:00.000,2021-09-16 10:11:33.897
15114,19,942,경기,8,7,1,2670,2020-06-08 09:00:00.000,2021-09-16 10:11:33.897
15115,3,58,강원,0,0,0,2669,2020-06-08 09:00:00.000,2021-09-16 10:11:33.897
15116,0,61,충북,0,0,0,2668,2020-06-08 09:00:00.000,2021-09-16 10:11:33.897
15117,0,148,충남,0,0,0,2667,2020-06-08 09:00:00.000,2021-09-16 10:11:33.897
15118,0,21,전북,0,0,0,2666,2020-06-08 09:00:00.000,2021-09-16 10:11:33.897
15119,0,20,전남,0,0,0,2665,2020-06-08 09:00:00.000,2021-09-16 10:11:33.897
15120,54,1383,경북,0,0,0,2664,2020-06-08 09:00:00.000,2021-09-16 10:11:33.897
15121,0,124,경남,0,0,0,2663,2020-06-08 09:00:00.000,2021-09-16 10:11:33.897
15122,0,15,제주,0,0,0,2662,2020-06-08 09:00:00.000,2021-09-16 10:11:33.897
15123,0,550,검역,3,0,3,2661,2020-06-08 09:00:00.000,2021-09-16 10:11:33.897
15124,273,11776,합계,57,53,4,2660,2020-06-07 09:00:00.000,2021-09-16 10:11:33.897
15125,4,974,서울,27,27,0,2659,2020-06-07 09:00:00.000,2021-09-16 10:11:33.897
15126,3,147,부산,0,0,0,2658,2020-06-07 09:00:00.000,2021-09-16 10:11:33.897
15127,188,6887,대구,1,1,0,2657,2020-06-07 09:00:00.000,2021-09-16 10:11:33.897
15128,0,279,인천,6,6,0,2656,2020-06-07 09:00:00.000,2021-09-16 10:11:33.897
15129,0,32,광주,0,0,0,2655,2020-06-07 09:00:00.000,2021-09-16 10:11:33.897
15130,1,46,대전,0,0,0,2654,2020-06-07 09:00:00.000,2021-09-16 10:11:33.897
15131,1,53,울산,1,0,1,2653,2020-06-07 09:00:00.000,2021-09-16 10:11:33.897
15132,0,47,세종,0,0,0,2652,2020-06-07 09:00:00.000,2021-09-16 10:11:33.897
15133,19,934,경기,19,19,0,2651,2020-06-07 09:00:00.000,2021-09-16 10:11:33.897
15134,3,58,강원,0,0,0,2650,2020-06-07 09:00:00.000,2021-09-16 10:11:33.897
15135,0,61,충북,1,0,1,2649,2020-06-07 09:00:00.000,2021-09-16 10:11:33.897
15136,0,148,충남,0,0,0,2648,2020-06-07 09:00:00.000,2021-09-16 10:11:33.897
15137,0,21,전북,0,0,0,2647,2020-06-07 09:00:00.000,2021-09-16 10:11:33.897
15138,0,20,전남,0,0,0,2646,2020-06-07 09:00:00.000,2021-09-16 10:11:33.897
15139,54,1383,경북,0,0,0,2645,2020-06-07 09:00:00.000,2021-09-16 10:11:33.897
15140,0,124,경남,0,0,0,2644,2020-06-07 09:00:00.000,2021-09-16 10:11:33.897
15141,0,15,제주,0,0,0,2643,2020-06-07 09:00:00.000,2021-09-16 10:11:33.897
15142,0,547,검역,2,0,2,2642,2020-06-07 09:00:00.000,2021-09-16 10:11:33.897
15143,273,11719,합계,51,43,8,2641,2020-06-06 09:00:00.000,2021-09-16 10:11:33.897
15144,4,947,서울,23,23,0,2640,2020-06-06 09:00:00.000,2021-09-16 10:11:33.897
15145,3,147,부산,0,0,0,2639,2020-06-06 09:00:00.000,2021-09-16 10:11:33.897
15146,188,6886,대구,0,0,0,2638,2020-06-06 09:00:00.000,2021-09-16 10:11:33.897
15147,0,273,인천,11,10,1,2637,2020-06-06 09:00:00.000,2021-09-16 10:11:33.897
15148,0,32,광주,0,0,0,2636,2020-06-06 09:00:00.000,2021-09-16 10:11:33.897
15149,1,46,대전,0,0,0,2635,2020-06-06 09:00:00.000,2021-09-16 10:11:33.897
15150,1,52,울산,0,0,0,2634,2020-06-06 09:00:00.000,2021-09-16 10:11:33.897
15151,0,47,세종,0,0,0,2633,2020-06-06 09:00:00.000,2021-09-16 10:11:33.897
15152,19,915,경기,8,7,1,2632,2020-06-06 09:00:00.000,2021-09-16 10:11:33.897
15153,3,58,강원,1,1,0,2631,2020-06-06 09:00:00.000,2021-09-16 10:11:33.897
15154,0,60,충북,0,0,0,2630,2020-06-06 09:00:00.000,2021-09-16 10:11:33.897
15155,0,148,충남,1,1,0,2629,2020-06-06 09:00:00.000,2021-09-16 10:11:33.897
15156,0,21,전북,0,0,0,2628,2020-06-06 09:00:00.000,2021-09-16 10:11:33.897
15157,0,20,전남,0,0,0,2627,2020-06-06 09:00:00.000,2021-09-16 10:11:33.897
15158,54,1383,경북,1,1,0,2626,2020-06-06 09:00:00.000,2021-09-16 10:11:33.897
15159,0,124,경남,1,0,1,2625,2020-06-06 09:00:00.000,2021-09-16 10:11:33.897
15160,0,15,제주,0,0,0,2624,2020-06-06 09:00:00.000,2021-09-16 10:11:33.897
15161,0,545,검역,5,0,5,2623,2020-06-06 09:00:00.000,2021-09-16 10:11:33.897
15162,273,11668,합계,39,34,5,2622,2020-06-05 09:00:00.000,2021-09-16 10:11:33.897
15163,4,924,서울,15,15,0,2621,2020-06-05 09:00:00.000,2021-09-16 10:11:33.897
15164,3,147,부산,0,0,0,2620,2020-06-05 09:00:00.000,2021-09-16 10:11:33.897
15165,188,6886,대구,1,1,0,2619,2020-06-05 09:00:00.000,2021-09-16 10:11:33.897
15166,0,262,인천,6,6,0,2618,2020-06-05 09:00:00.000,2021-09-16 10:11:33.897
15167,0,32,광주,0,0,0,2617,2020-06-05 09:00:00.000,2021-09-16 10:11:33.897
15168,1,46,대전,0,0,0,2616,2020-06-05 09:00:00.000,2021-09-16 10:11:33.897
15169,1,52,울산,0,0,0,2615,2020-06-05 09:00:00.000,2021-09-16 10:11:33.897
15170,0,47,세종,0,0,0,2614,2020-06-05 09:00:00.000,2021-09-16 10:11:33.897
15171,19,907,경기,13,10,3,2613,2020-06-05 09:00:00.000,2021-09-16 10:11:33.897
15172,3,57,강원,0,0,0,2612,2020-06-05 09:00:00.000,2021-09-16 10:11:33.897
15173,0,60,충북,0,0,0,2611,2020-06-05 09:00:00.000,2021-09-16 10:11:33.897
15174,0,147,충남,1,1,0,2610,2020-06-05 09:00:00.000,2021-09-16 10:11:33.897
15175,0,21,전북,0,0,0,2609,2020-06-05 09:00:00.000,2021-09-16 10:11:33.897
15176,0,20,전남,0,0,0,2608,2020-06-05 09:00:00.000,2021-09-16 10:11:33.897
15177,54,1382,경북,2,1,1,2607,2020-06-05 09:00:00.000,2021-09-16 10:11:33.897
15178,0,123,경남,0,0,0,2606,2020-06-05 09:00:00.000,2021-09-16 10:11:33.897
15179,0,15,제주,0,0,0,2605,2020-06-05 09:00:00.000,2021-09-16 10:11:33.897
15180,0,540,검역,1,0,1,2604,2020-06-05 09:00:00.000,2021-09-16 10:11:33.897
15181,273,11629,합계,39,33,6,2603,2020-06-04 09:00:00.000,2021-09-16 10:11:33.897
15182,4,909,서울,14,13,1,2602,2020-06-04 09:00:00.000,2021-09-16 10:11:33.897
15183,3,147,부산,0,0,0,2601,2020-06-04 09:00:00.000,2021-09-16 10:11:33.897
15184,188,6885,대구,0,0,0,2600,2020-06-04 09:00:00.000,2021-09-16 10:11:33.897
15185,0,256,인천,7,7,0,2599,2020-06-04 09:00:00.000,2021-09-16 10:11:33.897
15186,0,32,광주,0,0,0,2598,2020-06-04 09:00:00.000,2021-09-16 10:11:33.897
15187,1,46,대전,0,0,0,2597,2020-06-04 09:00:00.000,2021-09-16 10:11:33.897
15188,1,52,울산,0,0,0,2596,2020-06-04 09:00:00.000,2021-09-16 10:11:33.897
15189,0,47,세종,0,0,0,2595,2020-06-04 09:00:00.000,2021-09-16 10:11:33.897
15190,19,894,경기,15,13,2,2594,2020-06-04 09:00:00.000,2021-09-16 10:11:33.897
15191,3,57,강원,0,0,0,2593,2020-06-04 09:00:00.000,2021-09-16 10:11:33.897
15192,0,60,충북,0,0,0,2592,2020-06-04 09:00:00.000,2021-09-16 10:11:33.897
15193,0,146,충남,0,0,0,2591,2020-06-04 09:00:00.000,2021-09-16 10:11:33.897
15194,0,21,전북,0,0,0,2590,2020-06-04 09:00:00.000,2021-09-16 10:11:33.897
15195,0,20,전남,0,0,0,2589,2020-06-04 09:00:00.000,2021-09-16 10:11:33.897
15196,54,1380,경북,1,0,1,2588,2020-06-04 09:00:00.000,2021-09-16 10:11:33.897
15197,0,123,경남,0,0,0,2587,2020-06-04 09:00:00.000,2021-09-16 10:11:33.897
15198,0,15,제주,0,0,0,2586,2020-06-04 09:00:00.000,2021-09-16 10:11:33.897
15199,0,539,검역,2,0,2,2585,2020-06-04 09:00:00.000,2021-09-16 10:11:33.897
15200,273,11590,합계,49,46,3,2584,2020-06-03 09:00:00.000,2021-09-16 10:11:33.897
15201,4,895,서울,19,17,2,2583,2020-06-03 09:00:00.000,2021-09-16 10:11:33.897
15202,3,147,부산,0,0,0,2582,2020-06-03 09:00:00.000,2021-09-16 10:11:33.897
15203,188,6885,대구,1,1,0,2581,2020-06-03 09:00:00.000,2021-09-16 10:11:33.897
15204,0,249,인천,16,16,0,2580,2020-06-03 09:00:00.000,2021-09-16 10:11:33.897
15205,0,32,광주,0,0,0,2579,2020-06-03 09:00:00.000,2021-09-16 10:11:33.897
15206,1,46,대전,0,0,0,2578,2020-06-03 09:00:00.000,2021-09-16 10:11:33.897
15207,1,52,울산,0,0,0,2577,2020-06-03 09:00:00.000,2021-09-16 10:11:33.897
15208,0,47,세종,0,0,0,2576,2020-06-03 09:00:00.000,2021-09-16 10:11:33.897
15209,19,879,경기,13,12,1,2575,2020-06-03 09:00:00.000,2021-09-16 10:11:33.897
15210,3,57,강원,0,0,0,2574,2020-06-03 09:00:00.000,2021-09-16 10:11:33.897
15211,0,60,충북,0,0,0,2573,2020-06-03 09:00:00.000,2021-09-16 10:11:33.897
15212,0,146,충남,0,0,0,2572,2020-06-03 09:00:00.000,2021-09-16 10:11:33.897
15213,0,21,전북,0,0,0,2571,2020-06-03 09:00:00.000,2021-09-16 10:11:33.897
15214,0,20,전남,0,0,0,2570,2020-06-03 09:00:00.000,2021-09-16 10:11:33.897
15215,54,1379,경북,0,0,0,2569,2020-06-03 09:00:00.000,2021-09-16 10:11:33.897
15216,0,123,경남,0,0,0,2568,2020-06-03 09:00:00.000,2021-09-16 10:11:33.897
15217,0,15,제주,0,0,0,2567,2020-06-03 09:00:00.000,2021-09-16 10:11:33.897
15218,0,537,검역,0,0,0,2566,2020-06-03 09:00:00.000,2021-09-16 10:11:33.897
15219,272,11541,합계,38,36,2,2565,2020-06-02 09:00:00.000,2021-09-16 10:11:33.897
15220,4,876,서울,14,13,1,2564,2020-06-02 09:00:00.000,2021-09-16 10:11:33.897
15221,3,147,부산,0,0,0,2563,2020-06-02 09:00:00.000,2021-09-16 10:11:33.897
15222,187,6884,대구,0,0,0,2562,2020-06-02 09:00:00.000,2021-09-16 10:11:33.897
15223,0,233,인천,9,9,0,2561,2020-06-02 09:00:00.000,2021-09-16 10:11:33.897
15224,0,32,광주,0,0,0,2560,2020-06-02 09:00:00.000,2021-09-16 10:11:33.897
15225,1,46,대전,0,0,0,2559,2020-06-02 09:00:00.000,2021-09-16 10:11:33.897
15226,1,52,울산,0,0,0,2558,2020-06-02 09:00:00.000,2021-09-16 10:11:33.897
15227,0,47,세종,0,0,0,2557,2020-06-02 09:00:00.000,2021-09-16 10:11:33.897
15228,19,866,경기,14,14,0,2556,2020-06-02 09:00:00.000,2021-09-16 10:11:33.897
15229,3,57,강원,0,0,0,2555,2020-06-02 09:00:00.000,2021-09-16 10:11:33.897
15230,0,60,충북,0,0,0,2554,2020-06-02 09:00:00.000,2021-09-16 10:11:33.897
15231,0,146,충남,0,0,0,2553,2020-06-02 09:00:00.000,2021-09-16 10:11:33.897
15232,0,21,전북,0,0,0,2552,2020-06-02 09:00:00.000,2021-09-16 10:11:33.897
15233,0,20,전남,0,0,0,2551,2020-06-02 09:00:00.000,2021-09-16 10:11:33.897
15234,54,1379,경북,0,0,0,2550,2020-06-02 09:00:00.000,2021-09-16 10:11:33.897
15235,0,123,경남,0,0,0,2549,2020-06-02 09:00:00.000,2021-09-16 10:11:33.897
15236,0,15,제주,0,0,0,2548,2020-06-02 09:00:00.000,2021-09-16 10:11:33.897
15237,0,537,검역,1,0,1,2547,2020-06-02 09:00:00.000,2021-09-16 10:11:33.897
15238,271,11503,합계,35,30,5,2546,2020-06-01 09:00:00.000,2021-09-16 10:11:33.897
15239,4,862,서울,1,0,1,2545,2020-06-01 09:00:00.000,2021-09-16 10:11:33.897
15240,3,147,부산,0,0,0,2544,2020-06-01 09:00:00.000,2021-09-16 10:11:33.897
15241,186,6884,대구,1,1,0,2543,2020-06-01 09:00:00.000,2021-09-16 10:11:33.897
15242,0,224,인천,18,18,0,2542,2020-06-01 09:00:00.000,2021-09-16 10:11:33.897
15243,0,32,광주,0,0,0,2541,2020-06-01 09:00:00.000,2021-09-16 10:11:33.897
15244,1,46,대전,0,0,0,2540,2020-06-01 09:00:00.000,2021-09-16 10:11:33.897
15245,1,52,울산,0,0,0,2539,2020-06-01 09:00:00.000,2021-09-16 10:11:33.897
15246,0,47,세종,0,0,0,2538,2020-06-01 09:00:00.000,2021-09-16 10:11:33.897
15247,19,852,경기,12,11,1,2537,2020-06-01 09:00:00.000,2021-09-16 10:11:33.897
15248,3,57,강원,0,0,0,2536,2020-06-01 09:00:00.000,2021-09-16 10:11:33.897
15249,0,60,충북,0,0,0,2535,2020-06-01 09:00:00.000,2021-09-16 10:11:33.897
15250,0,146,충남,0,0,0,2534,2020-06-01 09:00:00.000,2021-09-16 10:11:33.897
15251,0,21,전북,0,0,0,2533,2020-06-01 09:00:00.000,2021-09-16 10:11:33.897
15252,0,20,전남,1,0,1,2532,2020-06-01 09:00:00.000,2021-09-16 10:11:33.897
15253,54,1379,경북,0,0,0,2531,2020-06-01 09:00:00.000,2021-09-16 10:11:33.897
15254,0,123,경남,0,0,0,2530,2020-06-01 09:00:00.000,2021-09-16 10:11:33.897
15255,0,15,제주,0,0,0,2529,2020-06-01 09:00:00.000,2021-09-16 10:11:33.897
15256,0,536,검역,2,0,2,2528,2020-06-01 09:00:00.000,2021-09-16 10:11:33.897
15257,270,11468,합계,27,15,12,2527,2020-05-31 09:00:00.000,2021-09-16 10:11:33.897
15258,4,861,서울,6,5,1,2526,2020-05-31 09:00:00.000,2021-09-16 10:11:33.897
15259,3,147,부산,1,0,1,2525,2020-05-31 09:00:00.000,2021-09-16 10:11:33.897
15260,185,6883,대구,1,0,1,2524,2020-05-31 09:00:00.000,2021-09-16 10:11:33.897
15261,0,206,인천,3,3,0,2523,2020-05-31 09:00:00.000,2021-09-16 10:11:33.897
15262,0,32,광주,0,0,0,2522,2020-05-31 09:00:00.000,2021-09-16 10:11:33.897
15263,1,46,대전,1,0,1,2521,2020-05-31 09:00:00.000,2021-09-16 10:11:33.897
15264,1,52,울산,2,0,2,2520,2020-05-31 09:00:00.000,2021-09-16 10:11:33.897
15265,0,47,세종,0,0,0,2519,2020-05-31 09:00:00.000,2021-09-16 10:11:33.897
15266,19,840,경기,12,7,5,2518,2020-05-31 09:00:00.000,2021-09-16 10:11:33.897
15267,3,57,강원,0,0,0,2517,2020-05-31 09:00:00.000,2021-09-16 10:11:33.897
15268,0,60,충북,0,0,0,2516,2020-05-31 09:00:00.000,2021-09-16 10:11:33.897
15269,0,146,충남,0,0,0,2515,2020-05-31 09:00:00.000,2021-09-16 10:11:33.897
15270,0,21,전북,0,0,0,2514,2020-05-31 09:00:00.000,2021-09-16 10:11:33.897
15271,0,19,전남,0,0,0,2513,2020-05-31 09:00:00.000,2021-09-16 10:11:33.897
15272,54,1379,경북,0,0,0,2512,2020-05-31 09:00:00.000,2021-09-16 10:11:33.897
15273,0,123,경남,0,0,0,2511,2020-05-31 09:00:00.000,2021-09-16 10:11:33.897
15274,0,15,제주,1,0,1,2510,2020-05-31 09:00:00.000,2021-09-16 10:11:33.897
15275,0,534,검역,0,0,0,2509,2020-05-31 09:00:00.000,2021-09-16 10:11:33.897
15276,269,11441,합계,39,27,12,2508,2020-05-30 09:00:00.000,2021-09-16 10:11:33.897
15277,4,855,서울,9,7,2,2507,2020-05-30 09:00:00.000,2021-09-16 10:11:33.897
15278,3,146,부산,1,1,0,2506,2020-05-30 09:00:00.000,2021-09-16 10:11:33.897
15279,184,6882,대구,2,1,1,2505,2020-05-30 09:00:00.000,2021-09-16 10:11:33.897
15280,0,203,인천,5,5,0,2504,2020-05-30 09:00:00.000,2021-09-16 10:11:33.897
15281,0,32,광주,2,0,2,2503,2020-05-30 09:00:00.000,2021-09-16 10:11:33.897
15282,1,45,대전,0,0,0,2502,2020-05-30 09:00:00.000,2021-09-16 10:11:33.897
15283,1,50,울산,0,0,0,2501,2020-05-30 09:00:00.000,2021-09-16 10:11:33.897
15284,0,47,세종,0,0,0,2500,2020-05-30 09:00:00.000,2021-09-16 10:11:33.897
15285,19,828,경기,13,12,1,2499,2020-05-30 09:00:00.000,2021-09-16 10:11:33.897
15286,3,57,강원,1,1,0,2498,2020-05-30 09:00:00.000,2021-09-16 10:11:33.897
15287,0,60,충북,0,0,0,2497,2020-05-30 09:00:00.000,2021-09-16 10:11:33.897
15288,0,146,충남,0,0,0,2496,2020-05-30 09:00:00.000,2021-09-16 10:11:33.897
15289,0,21,전북,0,0,0,2495,2020-05-30 09:00:00.000,2021-09-16 10:11:33.897
15290,0,19,전남,1,0,1,2494,2020-05-30 09:00:00.000,2021-09-16 10:11:33.897
15291,54,1379,경북,0,0,0,2493,2020-05-30 09:00:00.000,2021-09-16 10:11:33.897
15292,0,123,경남,0,0,0,2492,2020-05-30 09:00:00.000,2021-09-16 10:11:33.897
15293,0,14,제주,0,0,0,2491,2020-05-30 09:00:00.000,2021-09-16 10:11:33.897
15294,0,534,검역,5,0,5,2490,2020-05-30 09:00:00.000,2021-09-16 10:11:33.897
15295,269,11402,합계,58,55,3,2489,2020-05-29 09:00:00.000,2021-09-16 10:11:33.897
15296,4,846,서울,20,19,1,2488,2020-05-29 09:00:00.000,2021-09-16 10:11:33.897
15297,3,145,부산,0,0,0,2487,2020-05-29 09:00:00.000,2021-09-16 10:11:33.897
15298,184,6880,대구,0,0,0,2486,2020-05-29 09:00:00.000,2021-09-16 10:11:33.897
15299,0,198,인천,18,18,0,2485,2020-05-29 09:00:00.000,2021-09-16 10:11:33.897
15300,0,30,광주,0,0,0,2484,2020-05-29 09:00:00.000,2021-09-16 10:11:33.897
15301,1,45,대전,0,0,0,2483,2020-05-29 09:00:00.000,2021-09-16 10:11:33.897
15302,1,50,울산,0,0,0,2482,2020-05-29 09:00:00.000,2021-09-16 10:11:33.897
15303,0,47,세종,0,0,0,2481,2020-05-29 09:00:00.000,2021-09-16 10:11:33.897
15304,19,815,경기,20,18,2,2480,2020-05-29 09:00:00.000,2021-09-16 10:11:33.897
15305,3,56,강원,0,0,0,2479,2020-05-29 09:00:00.000,2021-09-16 10:11:33.897
15306,0,60,충북,0,0,0,2478,2020-05-29 09:00:00.000,2021-09-16 10:11:33.897
15307,0,146,충남,0,0,0,2477,2020-05-29 09:00:00.000,2021-09-16 10:11:33.897
15308,0,21,전북,0,0,0,2476,2020-05-29 09:00:00.000,2021-09-16 10:11:33.897
15309,0,18,전남,0,0,0,2475,2020-05-29 09:00:00.000,2021-09-16 10:11:33.897
15310,54,1379,경북,0,0,0,2474,2020-05-29 09:00:00.000,2021-09-16 10:11:33.897
15311,0,123,경남,0,0,0,2473,2020-05-29 09:00:00.000,2021-09-16 10:11:33.897
15312,0,14,제주,0,0,0,2472,2020-05-29 09:00:00.000,2021-09-16 10:11:33.897
15313,0,529,검역,0,0,0,2471,2020-05-29 09:00:00.000,2021-09-16 10:11:33.897
15314,269,11344,합계,79,68,11,2470,2020-05-28 09:00:00.000,2021-09-16 10:11:33.897
15315,4,826,서울,24,22,2,2469,2020-05-28 09:00:00.000,2021-09-16 10:11:33.897
15316,3,145,부산,1,0,1,2468,2020-05-28 09:00:00.000,2021-09-16 10:11:33.897
15317,184,6880,대구,2,2,0,2467,2020-05-28 09:00:00.000,2021-09-16 10:11:33.897
15318,0,180,인천,22,22,0,2466,2020-05-28 09:00:00.000,2021-09-16 10:11:33.897
15319,0,30,광주,0,0,0,2465,2020-05-28 09:00:00.000,2021-09-16 10:11:33.897
15320,1,45,대전,0,0,0,2464,2020-05-28 09:00:00.000,2021-09-16 10:11:33.897
15321,1,50,울산,0,0,0,2463,2020-05-28 09:00:00.000,2021-09-16 10:11:33.897
15322,0,47,세종,0,0,0,2462,2020-05-28 09:00:00.000,2021-09-16 10:11:33.897
15323,19,795,경기,21,21,0,2461,2020-05-28 09:00:00.000,2021-09-16 10:11:33.897
15324,3,56,강원,0,0,0,2460,2020-05-28 09:00:00.000,2021-09-16 10:11:33.897
15325,0,60,충북,0,0,0,2459,2020-05-28 09:00:00.000,2021-09-16 10:11:33.897
15326,0,146,충남,1,1,0,2458,2020-05-28 09:00:00.000,2021-09-16 10:11:33.897
15327,0,21,전북,0,0,0,2457,2020-05-28 09:00:00.000,2021-09-16 10:11:33.897
15328,0,18,전남,0,0,0,2456,2020-05-28 09:00:00.000,2021-09-16 10:11:33.897
15329,54,1379,경북,1,0,1,2455,2020-05-28 09:00:00.000,2021-09-16 10:11:33.897
15330,0,123,경남,0,0,0,2454,2020-05-28 09:00:00.000,2021-09-16 10:11:33.897
15331,0,14,제주,0,0,0,2453,2020-05-28 09:00:00.000,2021-09-16 10:11:33.897
15332,0,529,검역,7,0,7,2452,2020-05-28 09:00:00.000,2021-09-16 10:11:33.897
15333,269,11265,합계,40,37,3,2451,2020-05-27 09:00:00.000,2021-09-16 10:11:33.897
15334,4,802,서울,19,19,0,2450,2020-05-27 09:00:00.000,2021-09-16 10:11:33.897
15335,3,144,부산,0,0,0,2449,2020-05-27 09:00:00.000,2021-09-16 10:11:33.897
15336,184,6878,대구,3,2,1,2448,2020-05-27 09:00:00.000,2021-09-16 10:11:33.897
15337,0,158,인천,11,10,1,2447,2020-05-27 09:00:00.000,2021-09-16 10:11:33.897
15338,0,30,광주,0,0,0,2446,2020-05-27 09:00:00.000,2021-09-16 10:11:33.897
15339,1,45,대전,0,0,0,2445,2020-05-27 09:00:00.000,2021-09-16 10:11:33.897
15340,1,50,울산,0,0,0,2444,2020-05-27 09:00:00.000,2021-09-16 10:11:33.897
15341,0,47,세종,0,0,0,2443,2020-05-27 09:00:00.000,2021-09-16 10:11:33.897
15342,19,774,경기,6,6,0,2442,2020-05-27 09:00:00.000,2021-09-16 10:11:33.897
15343,3,56,강원,0,0,0,2441,2020-05-27 09:00:00.000,2021-09-16 10:11:33.897
15344,0,60,충북,0,0,0,2440,2020-05-27 09:00:00.000,2021-09-16 10:11:33.897
15345,0,145,충남,0,0,0,2439,2020-05-27 09:00:00.000,2021-09-16 10:11:33.897
15346,0,21,전북,0,0,0,2438,2020-05-27 09:00:00.000,2021-09-16 10:11:33.897
15347,0,18,전남,0,0,0,2437,2020-05-27 09:00:00.000,2021-09-16 10:11:33.897
15348,54,1378,경북,0,0,0,2436,2020-05-27 09:00:00.000,2021-09-16 10:11:33.897
15349,0,123,경남,0,0,0,2435,2020-05-27 09:00:00.000,2021-09-16 10:11:33.897
15350,0,14,제주,0,0,0,2434,2020-05-27 09:00:00.000,2021-09-16 10:11:33.897
15351,0,522,검역,1,0,1,2433,2020-05-27 09:00:00.000,2021-09-16 10:11:33.897
15352,269,11225,합계,19,16,3,2432,2020-05-26 09:00:00.000,2021-09-16 10:11:33.897
15353,4,783,서울,9,8,1,2431,2020-05-26 09:00:00.000,2021-09-16 10:11:33.897
15354,3,144,부산,0,0,0,2430,2020-05-26 09:00:00.000,2021-09-16 10:11:33.897
15355,184,6875,대구,1,1,0,2429,2020-05-26 09:00:00.000,2021-09-16 10:11:33.897
15356,0,147,인천,3,3,0,2428,2020-05-26 09:00:00.000,2021-09-16 10:11:33.897
15357,0,30,광주,0,0,0,2427,2020-05-26 09:00:00.000,2021-09-16 10:11:33.897
15358,1,45,대전,0,0,0,2426,2020-05-26 09:00:00.000,2021-09-16 10:11:33.897
15359,1,50,울산,0,0,0,2425,2020-05-26 09:00:00.000,2021-09-16 10:11:33.897
15360,0,47,세종,0,0,0,2424,2020-05-26 09:00:00.000,2021-09-16 10:11:33.897
15361,19,768,경기,2,2,0,2423,2020-05-26 09:00:00.000,2021-09-16 10:11:33.897
15362,3,56,강원,0,0,0,2422,2020-05-26 09:00:00.000,2021-09-16 10:11:33.897
15363,0,60,충북,1,1,0,2421,2020-05-26 09:00:00.000,2021-09-16 10:11:33.897
15364,0,145,충남,0,0,0,2420,2020-05-26 09:00:00.000,2021-09-16 10:11:33.897
15365,0,21,전북,0,0,0,2419,2020-05-26 09:00:00.000,2021-09-16 10:11:33.897
15366,0,18,전남,0,0,0,2418,2020-05-26 09:00:00.000,2021-09-16 10:11:33.897
15367,54,1378,경북,1,1,0,2417,2020-05-26 09:00:00.000,2021-09-16 10:11:33.897
15368,0,123,경남,0,0,0,2416,2020-05-26 09:00:00.000,2021-09-16 10:11:33.897
15369,0,14,제주,0,0,0,2415,2020-05-26 09:00:00.000,2021-09-16 10:11:33.897
15370,0,521,검역,2,0,2,2414,2020-05-26 09:00:00.000,2021-09-16 10:11:33.897
15371,267,11206,합계,16,13,3,2413,2020-05-25 09:00:00.000,2021-09-16 10:11:33.897
15372,4,774,서울,6,6,0,2412,2020-05-25 09:00:00.000,2021-09-16 10:11:33.897
15373,3,144,부산,0,0,0,2411,2020-05-25 09:00:00.000,2021-09-16 10:11:33.897
15374,183,6874,대구,1,1,0,2410,2020-05-25 09:00:00.000,2021-09-16 10:11:33.897
15375,0,144,인천,1,1,0,2409,2020-05-25 09:00:00.000,2021-09-16 10:11:33.897
15376,0,30,광주,0,0,0,2408,2020-05-25 09:00:00.000,2021-09-16 10:11:33.897
15377,1,45,대전,0,0,0,2407,2020-05-25 09:00:00.000,2021-09-16 10:11:33.897
15378,1,50,울산,0,0,0,2406,2020-05-25 09:00:00.000,2021-09-16 10:11:33.897
15379,0,47,세종,0,0,0,2405,2020-05-25 09:00:00.000,2021-09-16 10:11:33.897
15380,19,766,경기,6,4,2,2404,2020-05-25 09:00:00.000,2021-09-16 10:11:33.897
15381,2,56,강원,0,0,0,2403,2020-05-25 09:00:00.000,2021-09-16 10:11:33.897
15382,0,59,충북,0,0,0,2402,2020-05-25 09:00:00.000,2021-09-16 10:11:33.897
15383,0,145,충남,0,0,0,2401,2020-05-25 09:00:00.000,2021-09-16 10:11:33.897
15384,0,21,전북,0,0,0,2400,2020-05-25 09:00:00.000,2021-09-16 10:11:33.897
15385,0,18,전남,0,0,0,2399,2020-05-25 09:00:00.000,2021-09-16 10:11:33.897
15386,54,1377,경북,1,1,0,2398,2020-05-25 09:00:00.000,2021-09-16 10:11:33.897
15387,0,123,경남,0,0,0,2397,2020-05-25 09:00:00.000,2021-09-16 10:11:33.897
15388,0,14,제주,0,0,0,2396,2020-05-25 09:00:00.000,2021-09-16 10:11:33.897
15389,0,519,검역,1,0,1,2395,2020-05-25 09:00:00.000,2021-09-16 10:11:33.897
15390,266,11190,합계,25,17,8,2394,2020-05-24 09:00:00.000,2021-09-16 10:11:33.897
15391,4,768,서울,6,4,2,2393,2020-05-24 09:00:00.000,2021-09-16 10:11:33.897
15392,3,144,부산,0,0,0,2392,2020-05-24 09:00:00.000,2021-09-16 10:11:33.897
15393,183,6873,대구,0,0,0,2391,2020-05-24 09:00:00.000,2021-09-16 10:11:33.897
15394,0,143,인천,2,2,0,2390,2020-05-24 09:00:00.000,2021-09-16 10:11:33.897
15395,0,30,광주,0,0,0,2389,2020-05-24 09:00:00.000,2021-09-16 10:11:33.897
15396,1,45,대전,0,0,0,2388,2020-05-24 09:00:00.000,2021-09-16 10:11:33.897
15397,1,50,울산,0,0,0,2387,2020-05-24 09:00:00.000,2021-09-16 10:11:33.897
15398,0,47,세종,0,0,0,2386,2020-05-24 09:00:00.000,2021-09-16 10:11:33.897
15399,18,760,경기,6,5,1,2385,2020-05-24 09:00:00.000,2021-09-16 10:11:33.897
15400,2,56,강원,1,0,1,2384,2020-05-24 09:00:00.000,2021-09-16 10:11:33.897
15401,0,59,충북,0,0,0,2383,2020-05-24 09:00:00.000,2021-09-16 10:11:33.897
15402,0,145,충남,0,0,0,2382,2020-05-24 09:00:00.000,2021-09-16 10:11:33.897
15403,0,21,전북,0,0,0,2381,2020-05-24 09:00:00.000,2021-09-16 10:11:33.897
15404,0,18,전남,0,0,0,2380,2020-05-24 09:00:00.000,2021-09-16 10:11:33.897
15405,54,1376,경북,6,6,0,2379,2020-05-24 09:00:00.000,2021-09-16 10:11:33.897
15406,0,123,경남,0,0,0,2378,2020-05-24 09:00:00.000,2021-09-16 10:11:33.897
15407,0,14,제주,0,0,0,2377,2020-05-24 09:00:00.000,2021-09-16 10:11:33.897
15408,0,518,검역,4,0,4,2376,2020-05-24 09:00:00.000,2021-09-16 10:11:33.897
15409,266,11165,합계,23,19,4,2375,2020-05-23 09:00:00.000,2021-09-16 10:11:33.897
15410,4,762,서울,4,4,0,2374,2020-05-23 09:00:00.000,2021-09-16 10:11:33.897
15411,3,144,부산,0,0,0,2373,2020-05-23 09:00:00.000,2021-09-16 10:11:33.897
15412,183,6873,대구,1,1,0,2372,2020-05-23 09:00:00.000,2021-09-16 10:11:33.897
15413,0,141,인천,0,0,0,2371,2020-05-23 09:00:00.000,2021-09-16 10:11:33.897
15414,0,30,광주,0,0,0,2370,2020-05-23 09:00:00.000,2021-09-16 10:11:33.897
15415,1,45,대전,1,0,1,2369,2020-05-23 09:00:00.000,2021-09-16 10:11:33.897
15416,1,50,울산,0,0,0,2368,2020-05-23 09:00:00.000,2021-09-16 10:11:33.897
15417,0,47,세종,0,0,0,2367,2020-05-23 09:00:00.000,2021-09-16 10:11:33.897
15418,18,754,경기,13,13,0,2366,2020-05-23 09:00:00.000,2021-09-16 10:11:33.897
15419,2,55,강원,0,0,0,2365,2020-05-23 09:00:00.000,2021-09-16 10:11:33.897
15420,0,59,충북,0,0,0,2364,2020-05-23 09:00:00.000,2021-09-16 10:11:33.897
15421,0,145,충남,0,0,0,2363,2020-05-23 09:00:00.000,2021-09-16 10:11:33.897
15422,0,21,전북,0,0,0,2362,2020-05-23 09:00:00.000,2021-09-16 10:11:33.897
15423,0,18,전남,0,0,0,2361,2020-05-23 09:00:00.000,2021-09-16 10:11:33.897
15424,54,1370,경북,0,0,0,2360,2020-05-23 09:00:00.000,2021-09-16 10:11:33.897
15425,0,123,경남,1,1,0,2359,2020-05-23 09:00:00.000,2021-09-16 10:11:33.897
15426,0,14,제주,0,0,0,2358,2020-05-23 09:00:00.000,2021-09-16 10:11:33.897
15427,0,514,검역,3,0,3,2357,2020-05-23 09:00:00.000,2021-09-16 10:11:33.897
15428,264,11142,합계,20,11,9,2356,2020-05-22 09:00:00.000,2021-09-16 10:11:33.897
15429,4,758,서울,2,1,1,2355,2020-05-22 09:00:00.000,2021-09-16 10:11:33.897
15430,3,144,부산,0,0,0,2354,2020-05-22 09:00:00.000,2021-09-16 10:11:33.897
15431,182,6872,대구,0,0,0,2353,2020-05-22 09:00:00.000,2021-09-16 10:11:33.897
15432,0,141,인천,1,1,0,2352,2020-05-22 09:00:00.000,2021-09-16 10:11:33.897
15433,0,30,광주,0,0,0,2351,2020-05-22 09:00:00.000,2021-09-16 10:11:33.897
15434,1,44,대전,0,0,0,2350,2020-05-22 09:00:00.000,2021-09-16 10:11:33.897
15435,1,50,울산,1,0,1,2349,2020-05-22 09:00:00.000,2021-09-16 10:11:33.897
15436,0,47,세종,0,0,0,2348,2020-05-22 09:00:00.000,2021-09-16 10:11:33.897
15437,17,741,경기,6,6,0,2347,2020-05-22 09:00:00.000,2021-09-16 10:11:33.897
15438,2,55,강원,0,0,0,2346,2020-05-22 09:00:00.000,2021-09-16 10:11:33.897
15439,0,59,충북,0,0,0,2345,2020-05-22 09:00:00.000,2021-09-16 10:11:33.897
15440,0,145,충남,0,0,0,2344,2020-05-22 09:00:00.000,2021-09-16 10:11:33.897
15441,0,21,전북,0,0,0,2343,2020-05-22 09:00:00.000,2021-09-16 10:11:33.897
15442,0,18,전남,0,0,0,2342,2020-05-22 09:00:00.000,2021-09-16 10:11:33.897
15443,54,1370,경북,2,2,0,2341,2020-05-22 09:00:00.000,2021-09-16 10:11:33.897
15444,0,122,경남,1,1,0,2340,2020-05-22 09:00:00.000,2021-09-16 10:11:33.897
15445,0,14,제주,0,0,0,2339,2020-05-22 09:00:00.000,2021-09-16 10:11:33.897
15446,0,511,검역,7,0,7,2338,2020-05-22 09:00:00.000,2021-09-16 10:11:33.897
15447,264,11122,합계,12,10,2,2337,2020-05-21 09:00:00.000,2021-09-16 10:11:33.897
15448,4,756,서울,4,3,1,2336,2020-05-21 09:00:00.000,2021-09-16 10:11:33.897
15449,3,144,부산,0,0,0,2335,2020-05-21 09:00:00.000,2021-09-16 10:11:33.897
15450,182,6872,대구,0,0,0,2334,2020-05-21 09:00:00.000,2021-09-16 10:11:33.897
15451,0,140,인천,6,6,0,2333,2020-05-21 09:00:00.000,2021-09-16 10:11:33.897
15452,0,30,광주,0,0,0,2332,2020-05-21 09:00:00.000,2021-09-16 10:11:33.897
15453,1,44,대전,0,0,0,2331,2020-05-21 09:00:00.000,2021-09-16 10:11:33.897
15454,1,49,울산,0,0,0,2330,2020-05-21 09:00:00.000,2021-09-16 10:11:33.897
15455,0,47,세종,0,0,0,2329,2020-05-21 09:00:00.000,2021-09-16 10:11:33.897
15456,17,735,경기,0,0,0,2328,2020-05-21 09:00:00.000,2021-09-16 10:11:33.897
15457,2,55,강원,0,0,0,2327,2020-05-21 09:00:00.000,2021-09-16 10:11:33.897
15458,0,59,충북,0,0,0,2326,2020-05-21 09:00:00.000,2021-09-16 10:11:33.897
15459,0,145,충남,1,1,0,2325,2020-05-21 09:00:00.000,2021-09-16 10:11:33.897
15460,0,21,전북,0,0,0,2324,2020-05-21 09:00:00.000,2021-09-16 10:11:33.897
15461,0,18,전남,0,0,0,2323,2020-05-21 09:00:00.000,2021-09-16 10:11:33.897
15462,54,1368,경북,0,0,0,2322,2020-05-21 09:00:00.000,2021-09-16 10:11:33.897
15463,0,121,경남,0,0,0,2321,2020-05-21 09:00:00.000,2021-09-16 10:11:33.897
15464,0,14,제주,0,0,0,2320,2020-05-21 09:00:00.000,2021-09-16 10:11:33.897
15465,0,504,검역,1,0,1,2319,2020-05-21 09:00:00.000,2021-09-16 10:11:33.897
15466,263,11110,합계,32,24,8,2318,2020-05-20 09:00:00.000,2021-09-16 10:11:33.897
15467,4,752,서울,10,6,4,2317,2020-05-20 09:00:00.000,2021-09-16 10:11:33.897
15468,3,144,부산,0,0,0,2316,2020-05-20 09:00:00.000,2021-09-16 10:11:33.897
15469,182,6872,대구,1,1,0,2315,2020-05-20 09:00:00.000,2021-09-16 10:11:33.897
15470,0,134,인천,8,8,0,2314,2020-05-20 09:00:00.000,2021-09-16 10:11:33.897
15471,0,30,광주,0,0,0,2313,2020-05-20 09:00:00.000,2021-09-16 10:11:33.897
15472,1,44,대전,0,0,0,2312,2020-05-20 09:00:00.000,2021-09-16 10:11:33.897
15473,1,49,울산,0,0,0,2311,2020-05-20 09:00:00.000,2021-09-16 10:11:33.897
15474,0,47,세종,0,0,0,2310,2020-05-20 09:00:00.000,2021-09-16 10:11:33.897
15475,16,735,경기,10,8,2,2309,2020-05-20 09:00:00.000,2021-09-16 10:11:33.897
15476,2,55,강원,0,0,0,2308,2020-05-20 09:00:00.000,2021-09-16 10:11:33.897
15477,0,59,충북,0,0,0,2307,2020-05-20 09:00:00.000,2021-09-16 10:11:33.897
15478,0,144,충남,0,0,0,2306,2020-05-20 09:00:00.000,2021-09-16 10:11:33.897
15479,0,21,전북,1,1,0,2305,2020-05-20 09:00:00.000,2021-09-16 10:11:33.897
15480,0,18,전남,0,0,0,2304,2020-05-20 09:00:00.000,2021-09-16 10:11:33.897
15481,54,1368,경북,0,0,0,2303,2020-05-20 09:00:00.000,2021-09-16 10:11:33.897
15482,0,121,경남,0,0,0,2302,2020-05-20 09:00:00.000,2021-09-16 10:11:33.897
15483,0,14,제주,0,0,0,2301,2020-05-20 09:00:00.000,2021-09-16 10:11:33.897
15484,0,503,검역,2,0,2,2300,2020-05-20 09:00:00.000,2021-09-16 10:11:33.897
15485,263,11078,합계,13,9,4,2299,2020-05-19 09:00:00.000,2021-09-16 10:11:33.897
15486,4,742,서울,6,6,0,2298,2020-05-19 09:00:00.000,2021-09-16 10:11:33.897
15487,3,144,부산,0,0,0,2297,2020-05-19 09:00:00.000,2021-09-16 10:11:33.897
15488,182,6871,대구,0,0,0,2296,2020-05-19 09:00:00.000,2021-09-16 10:11:33.897
15489,0,126,인천,2,2,0,2295,2020-05-19 09:00:00.000,2021-09-16 10:11:33.897
15490,0,30,광주,0,0,0,2294,2020-05-19 09:00:00.000,2021-09-16 10:11:33.897
15491,1,44,대전,0,0,0,2293,2020-05-19 09:00:00.000,2021-09-16 10:11:33.897
15492,1,49,울산,4,0,4,2292,2020-05-19 09:00:00.000,2021-09-16 10:11:33.897
15493,0,47,세종,0,0,0,2291,2020-05-19 09:00:00.000,2021-09-16 10:11:33.897
15494,16,725,경기,1,1,0,2290,2020-05-19 09:00:00.000,2021-09-16 10:11:33.897
15495,2,55,강원,0,0,0,2289,2020-05-19 09:00:00.000,2021-09-16 10:11:33.897
15496,0,59,충북,0,0,0,2288,2020-05-19 09:00:00.000,2021-09-16 10:11:33.897
15497,0,144,충남,0,0,0,2287,2020-05-19 09:00:00.000,2021-09-16 10:11:33.897
15498,0,20,전북,0,0,0,2286,2020-05-19 09:00:00.000,2021-09-16 10:11:33.897
15499,0,18,전남,0,0,0,2285,2020-05-19 09:00:00.000,2021-09-16 10:11:33.897
15500,54,1368,경북,0,0,0,2284,2020-05-19 09:00:00.000,2021-09-16 10:11:33.897
15501,0,121,경남,0,0,0,2283,2020-05-19 09:00:00.000,2021-09-16 10:11:33.897
15502,0,14,제주,0,0,0,2282,2020-05-19 09:00:00.000,2021-09-16 10:11:33.897
15503,0,501,검역,0,0,0,2281,2020-05-19 09:00:00.000,2021-09-16 10:11:33.897
15504,263,11065,합계,15,5,10,2280,2020-05-18 09:00:00.000,2021-09-16 10:11:33.897
15505,4,736,서울,1,0,1,2279,2020-05-18 09:00:00.000,2021-09-16 10:11:33.897
15506,3,144,부산,0,0,0,2278,2020-05-18 09:00:00.000,2021-09-16 10:11:33.897
15507,182,6871,대구,1,1,0,2277,2020-05-18 09:00:00.000,2021-09-16 10:11:33.897
15508,0,124,인천,0,0,0,2276,2020-05-18 09:00:00.000,2021-09-16 10:11:33.897
15509,0,30,광주,0,0,0,2275,2020-05-18 09:00:00.000,2021-09-16 10:11:33.897
15510,1,44,대전,0,0,0,2274,2020-05-18 09:00:00.000,2021-09-16 10:11:33.897
15511,1,45,울산,0,0,0,2273,2020-05-18 09:00:00.000,2021-09-16 10:11:33.897
15512,0,47,세종,0,0,0,2272,2020-05-18 09:00:00.000,2021-09-16 10:11:33.897
15513,16,724,경기,3,2,1,2271,2020-05-18 09:00:00.000,2021-09-16 10:11:33.897
15514,2,55,강원,0,0,0,2270,2020-05-18 09:00:00.000,2021-09-16 10:11:33.897
15515,0,59,충북,3,2,1,2269,2020-05-18 09:00:00.000,2021-09-16 10:11:33.897
15516,0,144,충남,0,0,0,2268,2020-05-18 09:00:00.000,2021-09-16 10:11:33.897
15517,0,20,전북,0,0,0,2267,2020-05-18 09:00:00.000,2021-09-16 10:11:33.897
15518,0,18,전남,0,0,0,2266,2020-05-18 09:00:00.000,2021-09-16 10:11:33.897
15519,54,1368,경북,0,0,0,2265,2020-05-18 09:00:00.000,2021-09-16 10:11:33.897
15520,0,121,경남,0,0,0,2264,2020-05-18 09:00:00.000,2021-09-16 10:11:33.897
15521,0,14,제주,0,0,0,2263,2020-05-18 09:00:00.000,2021-09-16 10:11:33.897
15522,0,501,검역,7,0,7,2262,2020-05-18 09:00:00.000,2021-09-16 10:11:33.897
15523,262,11050,합계,13,6,7,2261,2020-05-17 09:00:00.000,2021-09-16 10:11:33.897
15524,4,735,서울,5,4,1,2260,2020-05-17 09:00:00.000,2021-09-16 10:11:33.897
15525,3,144,부산,0,0,0,2259,2020-05-17 09:00:00.000,2021-09-16 10:11:33.897
15526,181,6870,대구,1,1,0,2258,2020-05-17 09:00:00.000,2021-09-16 10:11:33.897
15527,0,124,인천,0,0,0,2257,2020-05-17 09:00:00.000,2021-09-16 10:11:33.897
15528,0,30,광주,0,0,0,2256,2020-05-17 09:00:00.000,2021-09-16 10:11:33.897
15529,1,44,대전,1,1,0,2255,2020-05-17 09:00:00.000,2021-09-16 10:11:33.897
15530,1,45,울산,0,0,0,2254,2020-05-17 09:00:00.000,2021-09-16 10:11:33.897
15531,0,47,세종,0,0,0,2253,2020-05-17 09:00:00.000,2021-09-16 10:11:33.897
15532,16,721,경기,0,0,0,2252,2020-05-17 09:00:00.000,2021-09-16 10:11:33.897
15533,2,55,강원,0,0,0,2251,2020-05-17 09:00:00.000,2021-09-16 10:11:33.897
15534,0,56,충북,0,0,0,2250,2020-05-17 09:00:00.000,2021-09-16 10:11:33.897
15535,0,144,충남,0,0,0,2249,2020-05-17 09:00:00.000,2021-09-16 10:11:33.897
15536,0,20,전북,0,0,0,2248,2020-05-17 09:00:00.000,2021-09-16 10:11:33.897
15537,0,18,전남,0,0,0,2247,2020-05-17 09:00:00.000,2021-09-16 10:11:33.897
15538,54,1368,경북,0,0,0,2246,2020-05-17 09:00:00.000,2021-09-16 10:11:33.897
15539,0,121,경남,2,0,2,2245,2020-05-17 09:00:00.000,2021-09-16 10:11:33.897
15540,0,14,제주,0,0,0,2244,2020-05-17 09:00:00.000,2021-09-16 10:11:33.897
15541,0,494,검역,4,0,4,2243,2020-05-17 09:00:00.000,2021-09-16 10:11:33.897
15542,262,11037,합계,19,9,10,2242,2020-05-16 09:00:00.000,2021-09-16 10:11:33.897
15543,4,730,서울,5,5,0,2241,2020-05-16 09:00:00.000,2021-09-16 10:11:33.897
15544,3,144,부산,0,0,0,2240,2020-05-16 09:00:00.000,2021-09-16 10:11:33.897
15545,181,6869,대구,1,1,0,2239,2020-05-16 09:00:00.000,2021-09-16 10:11:33.897
15546,0,124,인천,0,0,0,2238,2020-05-16 09:00:00.000,2021-09-16 10:11:33.897
15547,0,30,광주,0,0,0,2237,2020-05-16 09:00:00.000,2021-09-16 10:11:33.897
15548,1,43,대전,0,0,0,2236,2020-05-16 09:00:00.000,2021-09-16 10:11:33.897
15549,1,45,울산,0,0,0,2235,2020-05-16 09:00:00.000,2021-09-16 10:11:33.897
15550,0,47,세종,0,0,0,2234,2020-05-16 09:00:00.000,2021-09-16 10:11:33.897
15551,16,721,경기,4,2,2,2233,2020-05-16 09:00:00.000,2021-09-16 10:11:33.897
15552,2,55,강원,0,0,0,2232,2020-05-16 09:00:00.000,2021-09-16 10:11:33.897
15553,0,56,충북,1,1,0,2231,2020-05-16 09:00:00.000,2021-09-16 10:11:33.897
15554,0,144,충남,0,0,0,2230,2020-05-16 09:00:00.000,2021-09-16 10:11:33.897
15555,0,20,전북,0,0,0,2229,2020-05-16 09:00:00.000,2021-09-16 10:11:33.897
15556,0,18,전남,0,0,0,2228,2020-05-16 09:00:00.000,2021-09-16 10:11:33.897
15557,54,1368,경북,0,0,0,2227,2020-05-16 09:00:00.000,2021-09-16 10:11:33.897
15558,0,119,경남,0,0,0,2226,2020-05-16 09:00:00.000,2021-09-16 10:11:33.897
15559,0,14,제주,0,0,0,2225,2020-05-16 09:00:00.000,2021-09-16 10:11:33.897
15560,0,490,검역,8,0,8,2224,2020-05-16 09:00:00.000,2021-09-16 10:11:33.897
15561,260,11018,합계,27,22,5,2223,2020-05-15 09:00:00.000,2021-09-16 10:11:33.897
15562,4,725,서울,14,14,0,2222,2020-05-15 09:00:00.000,2021-09-16 10:11:33.897
15563,3,144,부산,0,0,0,2221,2020-05-15 09:00:00.000,2021-09-16 10:11:33.897
15564,179,6868,대구,3,3,0,2220,2020-05-15 09:00:00.000,2021-09-16 10:11:33.897
15565,0,124,인천,5,4,1,2219,2020-05-15 09:00:00.000,2021-09-16 10:11:33.897
15566,0,30,광주,0,0,0,2218,2020-05-15 09:00:00.000,2021-09-16 10:11:33.897
15567,1,43,대전,0,0,0,2217,2020-05-15 09:00:00.000,2021-09-16 10:11:33.897
15568,1,45,울산,0,0,0,2216,2020-05-15 09:00:00.000,2021-09-16 10:11:33.897
15569,0,47,세종,0,0,0,2215,2020-05-15 09:00:00.000,2021-09-16 10:11:33.897
15570,16,717,경기,3,1,2,2214,2020-05-15 09:00:00.000,2021-09-16 10:11:33.897
15571,2,55,강원,0,0,0,2213,2020-05-15 09:00:00.000,2021-09-16 10:11:33.897
15572,0,55,충북,0,0,0,2212,2020-05-15 09:00:00.000,2021-09-16 10:11:33.897
15573,0,144,충남,0,0,0,2211,2020-05-15 09:00:00.000,2021-09-16 10:11:33.897
15574,0,20,전북,0,0,0,2210,2020-05-15 09:00:00.000,2021-09-16 10:11:33.897
15575,0,18,전남,1,0,1,2209,2020-05-15 09:00:00.000,2021-09-16 10:11:33.897
15576,54,1368,경북,0,0,0,2208,2020-05-15 09:00:00.000,2021-09-16 10:11:33.897
15577,0,119,경남,0,0,0,2207,2020-05-15 09:00:00.000,2021-09-16 10:11:33.897
15578,0,14,제주,0,0,0,2206,2020-05-15 09:00:00.000,2021-09-16 10:11:33.897
15579,0,482,검역,1,0,1,2205,2020-05-15 09:00:00.000,2021-09-16 10:11:33.897
15580,260,10991,합계,29,26,3,2204,2020-05-14 09:00:00.000,2021-09-16 10:11:33.897
15581,4,711,서울,4,3,1,2203,2020-05-14 09:00:00.000,2021-09-16 10:11:33.897
15582,3,144,부산,0,0,0,2202,2020-05-14 09:00:00.000,2021-09-16 10:11:33.897
15583,179,6865,대구,0,0,0,2201,2020-05-14 09:00:00.000,2021-09-16 10:11:33.897
15584,0,119,인천,12,12,0,2200,2020-05-14 09:00:00.000,2021-09-16 10:11:33.897
15585,0,30,광주,0,0,0,2199,2020-05-14 09:00:00.000,2021-09-16 10:11:33.897
15586,1,43,대전,0,0,0,2198,2020-05-14 09:00:00.000,2021-09-16 10:11:33.897
15587,1,45,울산,0,0,0,2197,2020-05-14 09:00:00.000,2021-09-16 10:11:33.897
15588,0,47,세종,0,0,0,2196,2020-05-14 09:00:00.000,2021-09-16 10:11:33.897
15589,16,714,경기,6,6,0,2195,2020-05-14 09:00:00.000,2021-09-16 10:11:33.897
15590,2,55,강원,1,1,0,2194,2020-05-14 09:00:00.000,2021-09-16 10:11:33.897
15591,0,55,충북,3,3,0,2193,2020-05-14 09:00:00.000,2021-09-16 10:11:33.897
15592,0,144,충남,1,1,0,2192,2020-05-14 09:00:00.000,2021-09-16 10:11:33.897
15593,0,20,전북,0,0,0,2191,2020-05-14 09:00:00.000,2021-09-16 10:11:33.897
15594,0,17,전남,1,0,1,2190,2020-05-14 09:00:00.000,2021-09-16 10:11:33.897
15595,54,1368,경북,1,0,1,2189,2020-05-14 09:00:00.000,2021-09-16 10:11:33.897
15596,0,119,경남,0,0,0,2188,2020-05-14 09:00:00.000,2021-09-16 10:11:33.897
15597,0,14,제주,0,0,0,2187,2020-05-14 09:00:00.000,2021-09-16 10:11:33.897
15598,0,481,검역,0,0,0,2186,2020-05-14 09:00:00.000,2021-09-16 10:11:33.897
15599,259,10962,합계,26,22,4,2185,2020-05-13 09:00:00.000,2021-09-16 10:11:33.897
15600,3,707,서울,11,11,0,2184,2020-05-13 09:00:00.000,2021-09-16 10:11:33.897
15601,3,144,부산,3,3,0,2183,2020-05-13 09:00:00.000,2021-09-16 10:11:33.897
15602,179,6865,대구,3,2,1,2182,2020-05-13 09:00:00.000,2021-09-16 10:11:33.897
15603,0,107,인천,2,2,0,2181,2020-05-13 09:00:00.000,2021-09-16 10:11:33.897
15604,0,30,광주,0,0,0,2180,2020-05-13 09:00:00.000,2021-09-16 10:11:33.897
15605,1,43,대전,0,0,0,2179,2020-05-13 09:00:00.000,2021-09-16 10:11:33.897
15606,1,45,울산,1,0,1,2178,2020-05-13 09:00:00.000,2021-09-16 10:11:33.897
15607,0,47,세종,0,0,0,2177,2020-05-13 09:00:00.000,2021-09-16 10:11:33.897
15608,16,708,경기,3,2,1,2176,2020-05-13 09:00:00.000,2021-09-16 10:11:33.897
15609,2,54,강원,0,0,0,2175,2020-05-13 09:00:00.000,2021-09-16 10:11:33.897
15610,0,52,충북,0,0,0,2174,2020-05-13 09:00:00.000,2021-09-16 10:11:33.897
15611,0,143,충남,0,0,0,2173,2020-05-13 09:00:00.000,2021-09-16 10:11:33.897
15612,0,20,전북,1,1,0,2172,2020-05-13 09:00:00.000,2021-09-16 10:11:33.897
15613,0,16,전남,0,0,0,2171,2020-05-13 09:00:00.000,2021-09-16 10:11:33.897
15614,54,1367,경북,0,0,0,2170,2020-05-13 09:00:00.000,2021-09-16 10:11:33.897
15615,0,119,경남,1,1,0,2169,2020-05-13 09:00:00.000,2021-09-16 10:11:33.897
15616,0,14,제주,0,0,0,2168,2020-05-13 09:00:00.000,2021-09-16 10:11:33.897
15617,0,481,검역,1,0,1,2167,2020-05-13 09:00:00.000,2021-09-16 10:11:33.897
15618,258,10936,합계,27,22,5,2166,2020-05-12 09:00:00.000,2021-09-16 10:11:33.897
15619,2,696,서울,12,12,0,2165,2020-05-12 09:00:00.000,2021-09-16 10:11:33.897
15620,3,141,부산,0,0,0,2164,2020-05-12 09:00:00.000,2021-09-16 10:11:33.897
15621,179,6862,대구,1,1,0,2163,2020-05-12 09:00:00.000,2021-09-16 10:11:33.897
15622,0,105,인천,1,1,0,2162,2020-05-12 09:00:00.000,2021-09-16 10:11:33.897
15623,0,30,광주,0,0,0,2161,2020-05-12 09:00:00.000,2021-09-16 10:11:33.897
15624,1,43,대전,2,0,2,2160,2020-05-12 09:00:00.000,2021-09-16 10:11:33.897
15625,1,44,울산,0,0,0,2159,2020-05-12 09:00:00.000,2021-09-16 10:11:33.897
15626,0,47,세종,0,0,0,2158,2020-05-12 09:00:00.000,2021-09-16 10:11:33.897
15627,16,705,경기,8,8,0,2157,2020-05-12 09:00:00.000,2021-09-16 10:11:33.897
15628,2,54,강원,0,0,0,2156,2020-05-12 09:00:00.000,2021-09-16 10:11:33.897
15629,0,52,충북,0,0,0,2155,2020-05-12 09:00:00.000,2021-09-16 10:11:33.897
15630,0,143,충남,0,0,0,2154,2020-05-12 09:00:00.000,2021-09-16 10:11:33.897
15631,0,19,전북,0,0,0,2153,2020-05-12 09:00:00.000,2021-09-16 10:11:33.897
15632,0,16,전남,0,0,0,2152,2020-05-12 09:00:00.000,2021-09-16 10:11:33.897
15633,54,1367,경북,1,0,1,2151,2020-05-12 09:00:00.000,2021-09-16 10:11:33.897
15634,0,118,경남,1,0,1,2150,2020-05-12 09:00:00.000,2021-09-16 10:11:33.897
15635,0,14,제주,0,0,0,2149,2020-05-12 09:00:00.000,2021-09-16 10:11:33.897
15636,0,480,검역,1,0,1,2148,2020-05-12 09:00:00.000,2021-09-16 10:11:33.897
15637,256,10909,합계,35,29,6,2147,2020-05-11 09:00:00.000,2021-09-16 10:11:33.897
15638,2,684,서울,21,21,0,2146,2020-05-11 09:00:00.000,2021-09-16 10:11:33.897
15639,3,141,부산,0,0,0,2145,2020-05-11 09:00:00.000,2021-09-16 10:11:33.897
15640,178,6861,대구,0,0,0,2144,2020-05-11 09:00:00.000,2021-09-16 10:11:33.897
15641,0,104,인천,3,2,1,2143,2020-05-11 09:00:00.000,2021-09-16 10:11:33.897
15642,0,30,광주,0,0,0,2142,2020-05-11 09:00:00.000,2021-09-16 10:11:33.897
15643,1,41,대전,0,0,0,2141,2020-05-11 09:00:00.000,2021-09-16 10:11:33.897
15644,1,44,울산,0,0,0,2140,2020-05-11 09:00:00.000,2021-09-16 10:11:33.897
15645,0,47,세종,1,0,1,2139,2020-05-11 09:00:00.000,2021-09-16 10:11:33.897
15646,16,697,경기,3,3,0,2138,2020-05-11 09:00:00.000,2021-09-16 10:11:33.897
15647,2,54,강원,1,0,1,2137,2020-05-11 09:00:00.000,2021-09-16 10:11:33.897
15648,0,52,충북,3,3,0,2136,2020-05-11 09:00:00.000,2021-09-16 10:11:33.897
15649,0,143,충남,0,0,0,2135,2020-05-11 09:00:00.000,2021-09-16 10:11:33.897
15650,0,19,전북,0,0,0,2134,2020-05-11 09:00:00.000,2021-09-16 10:11:33.897
15651,0,16,전남,0,0,0,2133,2020-05-11 09:00:00.000,2021-09-16 10:11:33.897
15652,53,1366,경북,0,0,0,2132,2020-05-11 09:00:00.000,2021-09-16 10:11:33.897
15653,0,117,경남,0,0,0,2131,2020-05-11 09:00:00.000,2021-09-16 10:11:33.897
15654,0,14,제주,0,0,0,2130,2020-05-11 09:00:00.000,2021-09-16 10:11:33.897
15655,0,479,검역,3,0,3,2129,2020-05-11 09:00:00.000,2021-09-16 10:11:33.897
15656,256,10874,합계,34,26,8,2128,2020-05-10 09:00:00.000,2021-09-16 10:11:33.897
15657,2,663,서울,14,12,2,2127,2020-05-10 09:00:00.000,2021-09-16 10:11:33.897
15658,3,141,부산,0,0,0,2126,2020-05-10 09:00:00.000,2021-09-16 10:11:33.897
15659,178,6861,대구,2,2,0,2125,2020-05-10 09:00:00.000,2021-09-16 10:11:33.897
15660,0,101,인천,3,3,0,2124,2020-05-10 09:00:00.000,2021-09-16 10:11:33.897
15661,0,30,광주,0,0,0,2123,2020-05-10 09:00:00.000,2021-09-16 10:11:33.897
15662,1,41,대전,0,0,0,2122,2020-05-10 09:00:00.000,2021-09-16 10:11:33.897
15663,1,44,울산,0,0,0,2121,2020-05-10 09:00:00.000,2021-09-16 10:11:33.897
15664,0,46,세종,0,0,0,2120,2020-05-10 09:00:00.000,2021-09-16 10:11:33.897
15665,16,694,경기,6,6,0,2119,2020-05-10 09:00:00.000,2021-09-16 10:11:33.897
15666,2,53,강원,0,0,0,2118,2020-05-10 09:00:00.000,2021-09-16 10:11:33.897
15667,0,49,충북,2,2,0,2117,2020-05-10 09:00:00.000,2021-09-16 10:11:33.897
15668,0,143,충남,0,0,0,2116,2020-05-10 09:00:00.000,2021-09-16 10:11:33.897
15669,0,19,전북,0,0,0,2115,2020-05-10 09:00:00.000,2021-09-16 10:11:33.897
15670,0,16,전남,0,0,0,2114,2020-05-10 09:00:00.000,2021-09-16 10:11:33.897
15671,53,1366,경북,0,0,0,2113,2020-05-10 09:00:00.000,2021-09-16 10:11:33.897
15672,0,117,경남,0,0,0,2112,2020-05-10 09:00:00.000,2021-09-16 10:11:33.897
15673,0,14,제주,1,1,0,2111,2020-05-10 09:00:00.000,2021-09-16 10:11:33.897
15674,0,476,검역,6,0,6,2110,2020-05-10 09:00:00.000,2021-09-16 10:11:33.897
15675,256,10840,합계,18,17,1,2109,2020-05-09 09:00:00.000,2021-09-16 10:11:33.897
15676,2,649,서울,12,12,0,2108,2020-05-09 09:00:00.000,2021-09-16 10:11:33.897
15677,3,141,부산,1,1,0,2107,2020-05-09 09:00:00.000,2021-09-16 10:11:33.897
15678,178,6859,대구,0,0,0,2106,2020-05-09 09:00:00.000,2021-09-16 10:11:33.897
15679,0,98,인천,1,1,0,2105,2020-05-09 09:00:00.000,2021-09-16 10:11:33.897
15680,0,30,광주,0,0,0,2104,2020-05-09 09:00:00.000,2021-09-16 10:11:33.897
15681,1,41,대전,0,0,0,2103,2020-05-09 09:00:00.000,2021-09-16 10:11:33.897
15682,1,44,울산,0,0,0,2102,2020-05-09 09:00:00.000,2021-09-16 10:11:33.897
15683,0,46,세종,0,0,0,2101,2020-05-09 09:00:00.000,2021-09-16 10:11:33.897
15684,16,688,경기,4,3,1,2100,2020-05-09 09:00:00.000,2021-09-16 10:11:33.897
15685,2,53,강원,0,0,0,2099,2020-05-09 09:00:00.000,2021-09-16 10:11:33.897
15686,0,47,충북,0,0,0,2098,2020-05-09 09:00:00.000,2021-09-16 10:11:33.897
15687,0,143,충남,0,0,0,2097,2020-05-09 09:00:00.000,2021-09-16 10:11:33.897
15688,0,19,전북,0,0,0,2096,2020-05-09 09:00:00.000,2021-09-16 10:11:33.897
15689,0,16,전남,0,0,0,2095,2020-05-09 09:00:00.000,2021-09-16 10:11:33.897
15690,53,1366,경북,0,0,0,2094,2020-05-09 09:00:00.000,2021-09-16 10:11:33.897
15691,0,117,경남,0,0,0,2093,2020-05-09 09:00:00.000,2021-09-16 10:11:33.897
15692,0,13,제주,0,0,0,2092,2020-05-09 09:00:00.000,2021-09-16 10:11:33.897
15693,0,470,검역,0,0,0,2091,2020-05-09 09:00:00.000,2021-09-16 10:11:33.897
15694,256,10822,합계,12,1,11,2090,2020-05-08 09:00:00.000,2021-09-16 10:11:33.897
15695,2,637,서울,0,0,0,2089,2020-05-08 09:00:00.000,2021-09-16 10:11:33.897
15696,3,140,부산,2,0,2,2088,2020-05-08 09:00:00.000,2021-09-16 10:11:33.897
15697,178,6859,대구,3,0,3,2087,2020-05-08 09:00:00.000,2021-09-16 10:11:33.897
15698,0,97,인천,0,0,0,2086,2020-05-08 09:00:00.000,2021-09-16 10:11:33.897
15699,0,30,광주,0,0,0,2085,2020-05-08 09:00:00.000,2021-09-16 10:11:33.897
15700,1,41,대전,0,0,0,2084,2020-05-08 09:00:00.000,2021-09-16 10:11:33.897
15701,1,44,울산,0,0,0,2083,2020-05-08 09:00:00.000,2021-09-16 10:11:33.897
15702,0,46,세종,0,0,0,2082,2020-05-08 09:00:00.000,2021-09-16 10:11:33.897
15703,16,684,경기,2,1,1,2081,2020-05-08 09:00:00.000,2021-09-16 10:11:33.897
15704,2,53,강원,0,0,0,2080,2020-05-08 09:00:00.000,2021-09-16 10:11:33.897
15705,0,47,충북,1,0,1,2079,2020-05-08 09:00:00.000,2021-09-16 10:11:33.897
15706,0,143,충남,0,0,0,2078,2020-05-08 09:00:00.000,2021-09-16 10:11:33.897
15707,0,19,전북,1,0,1,2077,2020-05-08 09:00:00.000,2021-09-16 10:11:33.897
15708,0,16,전남,0,0,0,2076,2020-05-08 09:00:00.000,2021-09-16 10:11:33.897
15709,53,1366,경북,0,0,0,2075,2020-05-08 09:00:00.000,2021-09-16 10:11:33.897
15710,0,117,경남,0,0,0,2074,2020-05-08 09:00:00.000,2021-09-16 10:11:33.897
15711,0,13,제주,0,0,0,2073,2020-05-08 09:00:00.000,2021-09-16 10:11:33.897
15712,0,470,검역,3,0,3,2072,2020-05-08 09:00:00.000,2021-09-16 10:11:33.897
15713,256,10810,합계,4,1,3,2071,2020-05-07 09:00:00.000,2021-09-16 10:11:33.897
15714,2,637,서울,0,0,0,2070,2020-05-07 09:00:00.000,2021-09-16 10:11:33.897
15715,3,138,부산,0,0,0,2069,2020-05-07 09:00:00.000,2021-09-16 10:11:33.897
15716,178,6856,대구,0,0,0,2068,2020-05-07 09:00:00.000,2021-09-16 10:11:33.897
15717,0,97,인천,0,0,0,2067,2020-05-07 09:00:00.000,2021-09-16 10:11:33.897
15718,0,30,광주,0,0,0,2066,2020-05-07 09:00:00.000,2021-09-16 10:11:33.897
15719,1,41,대전,1,0,1,2065,2020-05-07 09:00:00.000,2021-09-16 10:11:33.897
15720,1,44,울산,0,0,0,2064,2020-05-07 09:00:00.000,2021-09-16 10:11:33.897
15721,0,46,세종,0,0,0,2063,2020-05-07 09:00:00.000,2021-09-16 10:11:33.897
15722,16,682,경기,1,1,0,2062,2020-05-07 09:00:00.000,2021-09-16 10:11:33.897
15723,2,53,강원,0,0,0,2061,2020-05-07 09:00:00.000,2021-09-16 10:11:33.897
15724,0,46,충북,1,0,1,2060,2020-05-07 09:00:00.000,2021-09-16 10:11:33.897
15725,0,143,충남,0,0,0,2059,2020-05-07 09:00:00.000,2021-09-16 10:11:33.897
15726,0,18,전북,0,0,0,2058,2020-05-07 09:00:00.000,2021-09-16 10:11:33.897
15727,0,16,전남,0,0,0,2057,2020-05-07 09:00:00.000,2021-09-16 10:11:33.897
15728,53,1366,경북,0,0,0,2056,2020-05-07 09:00:00.000,2021-09-16 10:11:33.897
15729,0,117,경남,0,0,0,2055,2020-05-07 09:00:00.000,2021-09-16 10:11:33.897
15730,0,13,제주,0,0,0,2054,2020-05-07 09:00:00.000,2021-09-16 10:11:33.897
15731,0,467,검역,1,0,1,2053,2020-05-07 09:00:00.000,2021-09-16 10:11:33.897
15732,255,10806,합계,2,0,2,2052,2020-05-06 09:00:00.000,2021-09-16 10:11:33.897
15733,2,637,서울,0,0,0,2051,2020-05-06 09:00:00.000,2021-09-16 10:11:33.897
15734,3,138,부산,0,0,0,2050,2020-05-06 09:00:00.000,2021-09-16 10:11:33.897
15735,177,6856,대구,0,0,0,2049,2020-05-06 09:00:00.000,2021-09-16 10:11:33.897
15736,0,97,인천,0,0,0,2048,2020-05-06 09:00:00.000,2021-09-16 10:11:33.897
15737,0,30,광주,0,0,0,2047,2020-05-06 09:00:00.000,2021-09-16 10:11:33.897
15738,1,40,대전,0,0,0,2046,2020-05-06 09:00:00.000,2021-09-16 10:11:33.897
15739,1,44,울산,0,0,0,2045,2020-05-06 09:00:00.000,2021-09-16 10:11:33.897
15740,0,46,세종,0,0,0,2044,2020-05-06 09:00:00.000,2021-09-16 10:11:33.897
15741,16,681,경기,0,0,0,2043,2020-05-06 09:00:00.000,2021-09-16 10:11:33.897
15742,2,53,강원,0,0,0,2042,2020-05-06 09:00:00.000,2021-09-16 10:11:33.897
15743,0,45,충북,0,0,0,2041,2020-05-06 09:00:00.000,2021-09-16 10:11:33.897
15744,0,143,충남,0,0,0,2040,2020-05-06 09:00:00.000,2021-09-16 10:11:33.897
15745,0,18,전북,0,0,0,2039,2020-05-06 09:00:00.000,2021-09-16 10:11:33.897
15746,0,16,전남,0,0,0,2038,2020-05-06 09:00:00.000,2021-09-16 10:11:33.897
15747,53,1366,경북,0,0,0,2037,2020-05-06 09:00:00.000,2021-09-16 10:11:33.897
15748,0,117,경남,0,0,0,2036,2020-05-06 09:00:00.000,2021-09-16 10:11:33.897
15749,0,13,제주,0,0,0,2035,2020-05-06 09:00:00.000,2021-09-16 10:11:33.897
15750,0,466,검역,2,0,2,2034,2020-05-06 09:00:00.000,2021-09-16 10:11:33.897
15751,254,10804,합계,3,0,3,2033,2020-05-05 09:00:00.000,2021-09-16 10:11:33.897
15752,2,637,서울,0,0,0,2032,2020-05-05 09:00:00.000,2021-09-16 10:11:33.897
15753,3,138,부산,0,0,0,2031,2020-05-05 09:00:00.000,2021-09-16 10:11:33.897
15754,176,6856,대구,0,0,0,2030,2020-05-05 09:00:00.000,2021-09-16 10:11:33.897
15755,0,97,인천,1,0,1,2029,2020-05-05 09:00:00.000,2021-09-16 10:11:33.897
15756,0,30,광주,0,0,0,2028,2020-05-05 09:00:00.000,2021-09-16 10:11:33.897
15757,1,40,대전,0,0,0,2027,2020-05-05 09:00:00.000,2021-09-16 10:11:33.897
15758,1,44,울산,0,0,0,2026,2020-05-05 09:00:00.000,2021-09-16 10:11:33.897
15759,0,46,세종,0,0,0,2025,2020-05-05 09:00:00.000,2021-09-16 10:11:33.897
15760,16,681,경기,0,0,0,2024,2020-05-05 09:00:00.000,2021-09-16 10:11:33.897
15761,2,53,강원,0,0,0,2023,2020-05-05 09:00:00.000,2021-09-16 10:11:33.897
15762,0,45,충북,0,0,0,2022,2020-05-05 09:00:00.000,2021-09-16 10:11:33.897
15763,0,143,충남,0,0,0,2021,2020-05-05 09:00:00.000,2021-09-16 10:11:33.897
15764,0,18,전북,0,0,0,2020,2020-05-05 09:00:00.000,2021-09-16 10:11:33.897
15765,0,16,전남,0,0,0,2019,2020-05-05 09:00:00.000,2021-09-16 10:11:33.897
15766,53,1366,경북,0,0,0,2018,2020-05-05 09:00:00.000,2021-09-16 10:11:33.897
15767,0,117,경남,0,0,0,2017,2020-05-05 09:00:00.000,2021-09-16 10:11:33.897
15768,0,13,제주,0,0,0,2016,2020-05-05 09:00:00.000,2021-09-16 10:11:33.897
15769,0,464,검역,2,0,2,2015,2020-05-05 09:00:00.000,2021-09-16 10:11:33.897
15770,252,10801,합계,8,0,8,2014,2020-05-04 09:00:00.000,2021-09-16 10:11:33.897
15771,2,637,서울,0,0,0,2013,2020-05-04 09:00:00.000,2021-09-16 10:11:33.897
15772,3,138,부산,0,0,0,2012,2020-05-04 09:00:00.000,2021-09-16 10:11:33.897
15773,174,6856,대구,0,0,0,2011,2020-05-04 09:00:00.000,2021-09-16 10:11:33.897
15774,0,96,인천,1,0,1,2010,2020-05-04 09:00:00.000,2021-09-16 10:11:33.897
15775,0,30,광주,0,0,0,2009,2020-05-04 09:00:00.000,2021-09-16 10:11:33.897
15776,1,40,대전,0,0,0,2008,2020-05-04 09:00:00.000,2021-09-16 10:11:33.897
15777,1,44,울산,1,0,1,2007,2020-05-04 09:00:00.000,2021-09-16 10:11:33.897
15778,0,46,세종,0,0,0,2006,2020-05-04 09:00:00.000,2021-09-16 10:11:33.897
15779,16,681,경기,1,0,1,2005,2020-05-04 09:00:00.000,2021-09-16 10:11:33.897
15780,2,53,강원,0,0,0,2004,2020-05-04 09:00:00.000,2021-09-16 10:11:33.897
15781,0,45,충북,0,0,0,2003,2020-05-04 09:00:00.000,2021-09-16 10:11:33.897
15782,0,143,충남,0,0,0,2002,2020-05-04 09:00:00.000,2021-09-16 10:11:33.897
15783,0,18,전북,0,0,0,2001,2020-05-04 09:00:00.000,2021-09-16 10:11:33.897
15784,0,16,전남,1,0,1,2000,2020-05-04 09:00:00.000,2021-09-16 10:11:33.897
15785,53,1366,경북,0,0,0,1999,2020-05-04 09:00:00.000,2021-09-16 10:11:33.897
15786,0,117,경남,0,0,0,1998,2020-05-04 09:00:00.000,2021-09-16 10:11:33.897
15787,0,13,제주,0,0,0,1997,2020-05-04 09:00:00.000,2021-09-16 10:11:33.897
15788,0,462,검역,4,0,4,1996,2020-05-04 09:00:00.000,2021-09-16 10:11:33.897
15789,250,10793,합계,13,3,10,1995,2020-05-03 09:00:00.000,2021-09-16 10:11:33.897
15790,2,637,서울,2,0,2,1994,2020-05-03 09:00:00.000,2021-09-16 10:11:33.897
15791,3,138,부산,0,0,0,1993,2020-05-03 09:00:00.000,2021-09-16 10:11:33.897
15792,174,6856,대구,4,3,1,1992,2020-05-03 09:00:00.000,2021-09-16 10:11:33.897
15793,0,95,인천,0,0,0,1991,2020-05-03 09:00:00.000,2021-09-16 10:11:33.897
15794,0,30,광주,0,0,0,1990,2020-05-03 09:00:00.000,2021-09-16 10:11:33.897
15795,0,40,대전,0,0,0,1989,2020-05-03 09:00:00.000,2021-09-16 10:11:33.897
15796,1,43,울산,0,0,0,1988,2020-05-03 09:00:00.000,2021-09-16 10:11:33.897
15797,0,46,세종,0,0,0,1987,2020-05-03 09:00:00.000,2021-09-16 10:11:33.897
15798,16,680,경기,2,0,2,1986,2020-05-03 09:00:00.000,2021-09-16 10:11:33.897
15799,2,53,강원,0,0,0,1985,2020-05-03 09:00:00.000,2021-09-16 10:11:33.897
15800,0,45,충북,0,0,0,1984,2020-05-03 09:00:00.000,2021-09-16 10:11:33.897
15801,0,143,충남,0,0,0,1983,2020-05-03 09:00:00.000,2021-09-16 10:11:33.897
15802,0,18,전북,0,0,0,1982,2020-05-03 09:00:00.000,2021-09-16 10:11:33.897
15803,0,15,전남,0,0,0,1981,2020-05-03 09:00:00.000,2021-09-16 10:11:33.897
15804,52,1366,경북,0,0,0,1980,2020-05-03 09:00:00.000,2021-09-16 10:11:33.897
15805,0,117,경남,0,0,0,1979,2020-05-03 09:00:00.000,2021-09-16 10:11:33.897
15806,0,13,제주,0,0,0,1978,2020-05-03 09:00:00.000,2021-09-16 10:11:33.897
15807,0,458,검역,5,0,5,1977,2020-05-03 09:00:00.000,2021-09-16 10:11:33.897
15808,250,10780,합계,6,0,6,1976,2020-05-02 09:00:00.000,2021-09-16 10:11:33.897
15809,2,635,서울,1,0,1,1975,2020-05-02 09:00:00.000,2021-09-16 10:11:33.897
15810,3,138,부산,1,0,1,1974,2020-05-02 09:00:00.000,2021-09-16 10:11:33.897
15811,174,6852,대구,0,0,0,1973,2020-05-02 09:00:00.000,2021-09-16 10:11:33.897
15812,0,95,인천,1,0,1,1972,2020-05-02 09:00:00.000,2021-09-16 10:11:33.897
15813,0,30,광주,0,0,0,1971,2020-05-02 09:00:00.000,2021-09-16 10:11:33.897
15814,0,40,대전,0,0,0,1970,2020-05-02 09:00:00.000,2021-09-16 10:11:33.897
15815,1,43,울산,0,0,0,1969,2020-05-02 09:00:00.000,2021-09-16 10:11:33.897
15816,0,46,세종,0,0,0,1968,2020-05-02 09:00:00.000,2021-09-16 10:11:33.897
15817,16,678,경기,0,0,0,1967,2020-05-02 09:00:00.000,2021-09-16 10:11:33.897
15818,2,53,강원,0,0,0,1966,2020-05-02 09:00:00.000,2021-09-16 10:11:33.897
15819,0,45,충북,0,0,0,1965,2020-05-02 09:00:00.000,2021-09-16 10:11:33.897
15820,0,143,충남,0,0,0,1964,2020-05-02 09:00:00.000,2021-09-16 10:11:33.897
15821,0,18,전북,0,0,0,1963,2020-05-02 09:00:00.000,2021-09-16 10:11:33.897
15822,0,15,전남,0,0,0,1962,2020-05-02 09:00:00.000,2021-09-16 10:11:33.897
15823,52,1366,경북,0,0,0,1961,2020-05-02 09:00:00.000,2021-09-16 10:11:33.897
15824,0,117,경남,0,0,0,1960,2020-05-02 09:00:00.000,2021-09-16 10:11:33.897
15825,0,13,제주,0,0,0,1959,2020-05-02 09:00:00.000,2021-09-16 10:11:33.897
15826,0,453,검역,3,0,3,1958,2020-05-02 09:00:00.000,2021-09-16 10:11:33.897
15827,248,10774,합계,9,1,8,1957,2020-05-01 09:00:00.000,2021-09-16 10:11:33.897
15828,2,634,서울,1,0,1,1956,2020-05-01 09:00:00.000,2021-09-16 10:11:33.897
15829,3,137,부산,0,0,0,1955,2020-05-01 09:00:00.000,2021-09-16 10:11:33.897
15830,172,6852,대구,0,0,0,1954,2020-05-01 09:00:00.000,2021-09-16 10:11:33.897
15831,0,94,인천,1,0,1,1953,2020-05-01 09:00:00.000,2021-09-16 10:11:33.897
15832,0,30,광주,0,0,0,1952,2020-05-01 09:00:00.000,2021-09-16 10:11:33.897
15833,0,40,대전,0,0,0,1951,2020-05-01 09:00:00.000,2021-09-16 10:11:33.897
15834,1,43,울산,0,0,0,1950,2020-05-01 09:00:00.000,2021-09-16 10:11:33.897
15835,0,46,세종,0,0,0,1949,2020-05-01 09:00:00.000,2021-09-16 10:11:33.897
15836,16,678,경기,2,0,2,1948,2020-05-01 09:00:00.000,2021-09-16 10:11:33.897
15837,2,53,강원,0,0,0,1947,2020-05-01 09:00:00.000,2021-09-16 10:11:33.897
15838,0,45,충북,0,0,0,1946,2020-05-01 09:00:00.000,2021-09-16 10:11:33.897
15839,0,143,충남,0,0,0,1945,2020-05-01 09:00:00.000,2021-09-16 10:11:33.897
15840,0,18,전북,0,0,0,1944,2020-05-01 09:00:00.000,2021-09-16 10:11:33.897
15841,0,15,전남,0,0,0,1943,2020-05-01 09:00:00.000,2021-09-16 10:11:33.897
15842,52,1366,경북,1,1,0,1942,2020-05-01 09:00:00.000,2021-09-16 10:11:33.897
15843,0,117,경남,0,0,0,1941,2020-05-01 09:00:00.000,2021-09-16 10:11:33.897
15844,0,13,제주,0,0,0,1940,2020-05-01 09:00:00.000,2021-09-16 10:11:33.897
15845,0,450,검역,4,0,4,1939,2020-05-01 09:00:00.000,2021-09-16 10:11:33.897
15846,247,10765,합계,4,0,4,1938,2020-04-30 09:00:00.000,2021-09-16 10:11:33.897
15847,2,633,서울,0,0,0,1937,2020-04-30 09:00:00.000,2021-09-16 10:11:33.897
15848,3,137,부산,0,0,0,1936,2020-04-30 09:00:00.000,2021-09-16 10:11:33.897
15849,172,6852,대구,0,0,0,1935,2020-04-30 09:00:00.000,2021-09-16 10:11:33.897
15850,0,93,인천,0,0,0,1934,2020-04-30 09:00:00.000,2021-09-16 10:11:33.897
15851,0,30,광주,0,0,0,1933,2020-04-30 09:00:00.000,2021-09-16 10:11:33.897
15852,0,40,대전,0,0,0,1932,2020-04-30 09:00:00.000,2021-09-16 10:11:33.897
15853,1,43,울산,0,0,0,1931,2020-04-30 09:00:00.000,2021-09-16 10:11:33.897
15854,0,46,세종,0,0,0,1930,2020-04-30 09:00:00.000,2021-09-16 10:11:33.897
15855,15,676,경기,0,0,0,1929,2020-04-30 09:00:00.000,2021-09-16 10:11:33.897
15856,2,53,강원,0,0,0,1928,2020-04-30 09:00:00.000,2021-09-16 10:11:33.897
15857,0,45,충북,0,0,0,1927,2020-04-30 09:00:00.000,2021-09-16 10:11:33.897
15858,0,143,충남,0,0,0,1926,2020-04-30 09:00:00.000,2021-09-16 10:11:33.897
15859,0,18,전북,0,0,0,1925,2020-04-30 09:00:00.000,2021-09-16 10:11:33.897
15860,0,15,전남,0,0,0,1924,2020-04-30 09:00:00.000,2021-09-16 10:11:33.897
15861,52,1365,경북,0,0,0,1923,2020-04-30 09:00:00.000,2021-09-16 10:11:33.897
15862,0,117,경남,0,0,0,1922,2020-04-30 09:00:00.000,2021-09-16 10:11:33.897
15863,0,13,제주,0,0,0,1921,2020-04-30 09:00:00.000,2021-09-16 10:11:33.897
15864,0,446,검역,4,0,4,1920,2020-04-30 09:00:00.000,2021-09-16 10:11:33.897
15865,246,10761,합계,9,4,5,1919,2020-04-29 09:00:00.000,2021-09-16 10:11:33.897
15866,2,633,서울,0,0,0,1918,2020-04-29 09:00:00.000,2021-09-16 10:11:33.897
15867,3,137,부산,0,0,0,1917,2020-04-29 09:00:00.000,2021-09-16 10:11:33.897
15868,171,6852,대구,3,3,0,1916,2020-04-29 09:00:00.000,2021-09-16 10:11:33.897
15869,0,93,인천,0,0,0,1915,2020-04-29 09:00:00.000,2021-09-16 10:11:33.897
15870,0,30,광주,0,0,0,1914,2020-04-29 09:00:00.000,2021-09-16 10:11:33.897
15871,0,40,대전,0,0,0,1913,2020-04-29 09:00:00.000,2021-09-16 10:11:33.897
15872,1,43,울산,0,0,0,1912,2020-04-29 09:00:00.000,2021-09-16 10:11:33.897
15873,0,46,세종,0,0,0,1911,2020-04-29 09:00:00.000,2021-09-16 10:11:33.897
15874,15,676,경기,2,1,1,1910,2020-04-29 09:00:00.000,2021-09-16 10:11:33.897
15875,2,53,강원,0,0,0,1909,2020-04-29 09:00:00.000,2021-09-16 10:11:33.897
15876,0,45,충북,0,0,0,1908,2020-04-29 09:00:00.000,2021-09-16 10:11:33.897
15877,0,143,충남,1,0,1,1907,2020-04-29 09:00:00.000,2021-09-16 10:11:33.897
15878,0,18,전북,0,0,0,1906,2020-04-29 09:00:00.000,2021-09-16 10:11:33.897
15879,0,15,전남,0,0,0,1905,2020-04-29 09:00:00.000,2021-09-16 10:11:33.897
15880,52,1365,경북,0,0,0,1904,2020-04-29 09:00:00.000,2021-09-16 10:11:33.897
15881,0,117,경남,0,0,0,1903,2020-04-29 09:00:00.000,2021-09-16 10:11:33.897
15882,0,13,제주,0,0,0,1902,2020-04-29 09:00:00.000,2021-09-16 10:11:33.897
15883,0,442,검역,3,0,3,1901,2020-04-29 09:00:00.000,2021-09-16 10:11:33.897
15884,244,10752,합계,14,2,12,1900,2020-04-28 09:00:00.000,2021-09-16 10:11:33.897
15885,2,633,서울,4,0,4,1899,2020-04-28 09:00:00.000,2021-09-16 10:11:33.897
15886,3,137,부산,0,0,0,1898,2020-04-28 09:00:00.000,2021-09-16 10:11:33.897
15887,170,6849,대구,2,0,2,1897,2020-04-28 09:00:00.000,2021-09-16 10:11:33.897
15888,0,93,인천,1,1,0,1896,2020-04-28 09:00:00.000,2021-09-16 10:11:33.897
15889,0,30,광주,0,0,0,1895,2020-04-28 09:00:00.000,2021-09-16 10:11:33.897
15890,0,40,대전,0,0,0,1894,2020-04-28 09:00:00.000,2021-09-16 10:11:33.897
15891,1,43,울산,0,0,0,1893,2020-04-28 09:00:00.000,2021-09-16 10:11:33.897
15892,0,46,세종,0,0,0,1892,2020-04-28 09:00:00.000,2021-09-16 10:11:33.897
15893,14,674,경기,3,0,3,1891,2020-04-28 09:00:00.000,2021-09-16 10:11:33.897
15894,2,53,강원,0,0,0,1890,2020-04-28 09:00:00.000,2021-09-16 10:11:33.897
15895,0,45,충북,0,0,0,1889,2020-04-28 09:00:00.000,2021-09-16 10:11:33.897
15896,0,142,충남,0,0,0,1888,2020-04-28 09:00:00.000,2021-09-16 10:11:33.897
15897,0,18,전북,0,0,0,1887,2020-04-28 09:00:00.000,2021-09-16 10:11:33.897
15898,0,15,전남,0,0,0,1886,2020-04-28 09:00:00.000,2021-09-16 10:11:33.897
15899,52,1365,경북,1,1,0,1885,2020-04-28 09:00:00.000,2021-09-16 10:11:33.897
15900,0,117,경남,0,0,0,1884,2020-04-28 09:00:00.000,2021-09-16 10:11:33.897
15901,0,13,제주,0,0,0,1883,2020-04-28 09:00:00.000,2021-09-16 10:11:33.897
15902,0,439,검역,3,0,3,1882,2020-04-28 09:00:00.000,2021-09-16 10:11:33.897
15903,243,10738,합계,10,3,7,1881,2020-04-27 09:00:00.000,2021-09-16 10:11:33.897
15904,2,629,서울,0,0,0,1880,2020-04-27 09:00:00.000,2021-09-16 10:11:33.897
15905,3,137,부산,0,0,0,1879,2020-04-27 09:00:00.000,2021-09-16 10:11:33.897
15906,169,6847,대구,1,1,0,1878,2020-04-27 09:00:00.000,2021-09-16 10:11:33.897
15907,0,92,인천,0,0,0,1877,2020-04-27 09:00:00.000,2021-09-16 10:11:33.897
15908,0,30,광주,0,0,0,1876,2020-04-27 09:00:00.000,2021-09-16 10:11:33.897
15909,0,40,대전,0,0,0,1875,2020-04-27 09:00:00.000,2021-09-16 10:11:33.897
15910,1,43,울산,0,0,0,1874,2020-04-27 09:00:00.000,2021-09-16 10:11:33.897
15911,0,46,세종,0,0,0,1873,2020-04-27 09:00:00.000,2021-09-16 10:11:33.897
15912,14,671,경기,3,2,1,1872,2020-04-27 09:00:00.000,2021-09-16 10:11:33.897
15913,2,53,강원,0,0,0,1871,2020-04-27 09:00:00.000,2021-09-16 10:11:33.897
15914,0,45,충북,0,0,0,1870,2020-04-27 09:00:00.000,2021-09-16 10:11:33.897
15915,0,142,충남,1,0,1,1869,2020-04-27 09:00:00.000,2021-09-16 10:11:33.897
15916,0,18,전북,0,0,0,1868,2020-04-27 09:00:00.000,2021-09-16 10:11:33.897
15917,0,15,전남,0,0,0,1867,2020-04-27 09:00:00.000,2021-09-16 10:11:33.897
15918,52,1364,경북,0,0,0,1866,2020-04-27 09:00:00.000,2021-09-16 10:11:33.897
15919,0,117,경남,0,0,0,1865,2020-04-27 09:00:00.000,2021-09-16 10:11:33.897
15920,0,13,제주,0,0,0,1864,2020-04-27 09:00:00.000,2021-09-16 10:11:33.897
15921,0,436,검역,5,0,5,1863,2020-04-27 09:00:00.000,2021-09-16 10:11:33.897
15922,242,10728,합계,10,1,9,1862,2020-04-26 09:00:00.000,2021-09-16 10:11:33.897
15923,2,629,서울,0,0,0,1861,2020-04-26 09:00:00.000,2021-09-16 10:11:33.897
15924,3,137,부산,1,0,1,1860,2020-04-26 09:00:00.000,2021-09-16 10:11:33.897
15925,168,6846,대구,1,1,0,1859,2020-04-26 09:00:00.000,2021-09-16 10:11:33.897
15926,0,92,인천,0,0,0,1858,2020-04-26 09:00:00.000,2021-09-16 10:11:33.897
15927,0,30,광주,0,0,0,1857,2020-04-26 09:00:00.000,2021-09-16 10:11:33.897
15928,0,40,대전,0,0,0,1856,2020-04-26 09:00:00.000,2021-09-16 10:11:33.897
15929,1,43,울산,0,0,0,1855,2020-04-26 09:00:00.000,2021-09-16 10:11:33.897
15930,0,46,세종,0,0,0,1854,2020-04-26 09:00:00.000,2021-09-16 10:11:33.897
15931,14,668,경기,6,0,6,1853,2020-04-26 09:00:00.000,2021-09-16 10:11:33.897
15932,2,53,강원,0,0,0,1852,2020-04-26 09:00:00.000,2021-09-16 10:11:33.897
15933,0,45,충북,0,0,0,1851,2020-04-26 09:00:00.000,2021-09-16 10:11:33.897
15934,0,141,충남,0,0,0,1850,2020-04-26 09:00:00.000,2021-09-16 10:11:33.897
15935,0,18,전북,1,0,1,1849,2020-04-26 09:00:00.000,2021-09-16 10:11:33.897
15936,0,15,전남,0,0,0,1848,2020-04-26 09:00:00.000,2021-09-16 10:11:33.897
15937,52,1364,경북,0,0,0,1847,2020-04-26 09:00:00.000,2021-09-16 10:11:33.897
15938,0,117,경남,0,0,0,1846,2020-04-26 09:00:00.000,2021-09-16 10:11:33.897
15939,0,13,제주,0,0,0,1845,2020-04-26 09:00:00.000,2021-09-16 10:11:33.897
15940,0,431,검역,1,0,1,1844,2020-04-26 09:00:00.000,2021-09-16 10:11:33.897
15941,240,10718,합계,10,5,5,1843,2020-04-25 09:00:00.000,2021-09-16 10:11:33.897
15942,2,629,서울,1,0,1,1842,2020-04-25 09:00:00.000,2021-09-16 10:11:33.897
15943,3,136,부산,0,0,0,1841,2020-04-25 09:00:00.000,2021-09-16 10:11:33.897
15944,166,6845,대구,2,2,0,1840,2020-04-25 09:00:00.000,2021-09-16 10:11:33.897
15945,0,92,인천,0,0,0,1839,2020-04-25 09:00:00.000,2021-09-16 10:11:33.897
15946,0,30,광주,0,0,0,1838,2020-04-25 09:00:00.000,2021-09-16 10:11:33.897
15947,0,40,대전,0,0,0,1837,2020-04-25 09:00:00.000,2021-09-16 10:11:33.897
15948,1,43,울산,0,0,0,1836,2020-04-25 09:00:00.000,2021-09-16 10:11:33.897
15949,0,46,세종,0,0,0,1835,2020-04-25 09:00:00.000,2021-09-16 10:11:33.897
15950,14,662,경기,2,2,0,1834,2020-04-25 09:00:00.000,2021-09-16 10:11:33.897
15951,2,53,강원,0,0,0,1833,2020-04-25 09:00:00.000,2021-09-16 10:11:33.897
15952,0,45,충북,0,0,0,1832,2020-04-25 09:00:00.000,2021-09-16 10:11:33.897
15953,0,141,충남,0,0,0,1831,2020-04-25 09:00:00.000,2021-09-16 10:11:33.897
15954,0,17,전북,0,0,0,1830,2020-04-25 09:00:00.000,2021-09-16 10:11:33.897
15955,0,15,전남,0,0,0,1829,2020-04-25 09:00:00.000,2021-09-16 10:11:33.897
15956,52,1364,경북,1,1,0,1828,2020-04-25 09:00:00.000,2021-09-16 10:11:33.897
15957,0,117,경남,0,0,0,1827,2020-04-25 09:00:00.000,2021-09-16 10:11:33.897
15958,0,13,제주,0,0,0,1826,2020-04-25 09:00:00.000,2021-09-16 10:11:33.897
15959,0,430,검역,4,0,4,1825,2020-04-25 09:00:00.000,2021-09-16 10:11:33.897
15960,240,10708,합계,6,4,2,1824,2020-04-24 09:00:00.000,2021-09-16 10:11:33.897
15961,2,628,서울,0,0,0,1823,2020-04-24 09:00:00.000,2021-09-16 10:11:33.897
15962,3,136,부산,1,0,1,1822,2020-04-24 09:00:00.000,2021-09-16 10:11:33.897
15963,166,6843,대구,3,3,0,1821,2020-04-24 09:00:00.000,2021-09-16 10:11:33.897
15964,0,92,인천,0,0,0,1820,2020-04-24 09:00:00.000,2021-09-16 10:11:33.897
15965,0,30,광주,0,0,0,1819,2020-04-24 09:00:00.000,2021-09-16 10:11:33.897
15966,0,40,대전,0,0,0,1818,2020-04-24 09:00:00.000,2021-09-16 10:11:33.897
15967,1,43,울산,0,0,0,1817,2020-04-24 09:00:00.000,2021-09-16 10:11:33.897
15968,0,46,세종,0,0,0,1816,2020-04-24 09:00:00.000,2021-09-16 10:11:33.897
15969,14,660,경기,1,1,0,1815,2020-04-24 09:00:00.000,2021-09-16 10:11:33.897
15970,2,53,강원,0,0,0,1814,2020-04-24 09:00:00.000,2021-09-16 10:11:33.897
15971,0,45,충북,0,0,0,1813,2020-04-24 09:00:00.000,2021-09-16 10:11:33.897
15972,0,141,충남,0,0,0,1812,2020-04-24 09:00:00.000,2021-09-16 10:11:33.897
15973,0,17,전북,0,0,0,1811,2020-04-24 09:00:00.000,2021-09-16 10:11:33.897
15974,0,15,전남,0,0,0,1810,2020-04-24 09:00:00.000,2021-09-16 10:11:33.897
15975,52,1363,경북,0,0,0,1809,2020-04-24 09:00:00.000,2021-09-16 10:11:33.897
15976,0,117,경남,0,0,0,1808,2020-04-24 09:00:00.000,2021-09-16 10:11:33.897
15977,0,13,제주,0,0,0,1807,2020-04-24 09:00:00.000,2021-09-16 10:11:33.897
15978,0,426,검역,1,0,1,1806,2020-04-24 09:00:00.000,2021-09-16 10:11:33.897
15979,240,10702,합계,8,4,4,1805,2020-04-23 09:00:00.000,2021-09-16 10:11:33.897
15980,2,628,서울,0,0,0,1804,2020-04-23 09:00:00.000,2021-09-16 10:11:33.897
15981,3,135,부산,1,0,1,1803,2020-04-23 09:00:00.000,2021-09-16 10:11:33.897
15982,166,6840,대구,4,3,1,1802,2020-04-23 09:00:00.000,2021-09-16 10:11:33.897
15983,0,92,인천,0,0,0,1801,2020-04-23 09:00:00.000,2021-09-16 10:11:33.897
15984,0,30,광주,0,0,0,1800,2020-04-23 09:00:00.000,2021-09-16 10:11:33.897
15985,0,40,대전,0,0,0,1799,2020-04-23 09:00:00.000,2021-09-16 10:11:33.897
15986,1,43,울산,0,0,0,1798,2020-04-23 09:00:00.000,2021-09-16 10:11:33.897
15987,0,46,세종,0,0,0,1797,2020-04-23 09:00:00.000,2021-09-16 10:11:33.897
15988,14,659,경기,1,1,0,1796,2020-04-23 09:00:00.000,2021-09-16 10:11:33.897
15989,2,53,강원,0,0,0,1795,2020-04-23 09:00:00.000,2021-09-16 10:11:33.897
15990,0,45,충북,0,0,0,1794,2020-04-23 09:00:00.000,2021-09-16 10:11:33.897
15991,0,141,충남,0,0,0,1793,2020-04-23 09:00:00.000,2021-09-16 10:11:33.897
15992,0,17,전북,0,0,0,1792,2020-04-23 09:00:00.000,2021-09-16 10:11:33.897
15993,0,15,전남,0,0,0,1791,2020-04-23 09:00:00.000,2021-09-16 10:11:33.897
15994,52,1363,경북,0,0,0,1790,2020-04-23 09:00:00.000,2021-09-16 10:11:33.897
15995,0,117,경남,0,0,0,1789,2020-04-23 09:00:00.000,2021-09-16 10:11:33.897
15996,0,13,제주,0,0,0,1788,2020-04-23 09:00:00.000,2021-09-16 10:11:33.897
15997,0,425,검역,2,0,2,1787,2020-04-23 09:00:00.000,2021-09-16 10:11:33.897
15998,238,10694,합계,11,5,6,1786,2020-04-22 09:00:00.000,2021-09-16 10:11:33.897
15999,2,628,서울,2,0,2,1785,2020-04-22 09:00:00.000,2021-09-16 10:11:33.897
16000,3,134,부산,2,1,1,1784,2020-04-22 09:00:00.000,2021-09-16 10:11:33.897
16001,165,6836,대구,1,1,0,1783,2020-04-22 09:00:00.000,2021-09-16 10:11:33.897
16002,0,92,인천,0,0,0,1782,2020-04-22 09:00:00.000,2021-09-16 10:11:33.897
16003,0,30,광주,0,0,0,1781,2020-04-22 09:00:00.000,2021-09-16 10:11:33.897
16004,0,40,대전,1,0,1,1780,2020-04-22 09:00:00.000,2021-09-16 10:11:33.897
16005,1,43,울산,0,0,0,1779,2020-04-22 09:00:00.000,2021-09-16 10:11:33.897
16006,0,46,세종,0,0,0,1778,2020-04-22 09:00:00.000,2021-09-16 10:11:33.897
16007,14,658,경기,0,0,0,1777,2020-04-22 09:00:00.000,2021-09-16 10:11:33.897
16008,2,53,강원,0,0,0,1776,2020-04-22 09:00:00.000,2021-09-16 10:11:33.897
16009,0,45,충북,0,0,0,1775,2020-04-22 09:00:00.000,2021-09-16 10:11:33.897
16010,0,141,충남,0,0,0,1774,2020-04-22 09:00:00.000,2021-09-16 10:11:33.897
16011,0,17,전북,0,0,0,1773,2020-04-22 09:00:00.000,2021-09-16 10:11:33.897
16012,0,15,전남,0,0,0,1772,2020-04-22 09:00:00.000,2021-09-16 10:11:33.897
16013,51,1363,경북,2,2,0,1771,2020-04-22 09:00:00.000,2021-09-16 10:11:33.897
16014,0,117,경남,1,1,0,1770,2020-04-22 09:00:00.000,2021-09-16 10:11:33.897
16015,0,13,제주,0,0,0,1769,2020-04-22 09:00:00.000,2021-09-16 10:11:33.897
16016,0,423,검역,2,0,2,1768,2020-04-22 09:00:00.000,2021-09-16 10:11:33.897
16017,237,10683,합계,9,4,5,1767,2020-04-21 09:00:00.000,2021-09-16 10:11:33.897
16018,2,626,서울,2,1,1,1766,2020-04-21 09:00:00.000,2021-09-16 10:11:33.897
16019,3,132,부산,0,0,0,1765,2020-04-21 09:00:00.000,2021-09-16 10:11:33.897
16020,164,6835,대구,2,2,0,1764,2020-04-21 09:00:00.000,2021-09-16 10:11:33.897
16021,0,92,인천,0,0,0,1763,2020-04-21 09:00:00.000,2021-09-16 10:11:33.897
16022,0,30,광주,0,0,0,1762,2020-04-21 09:00:00.000,2021-09-16 10:11:33.897
16023,0,39,대전,0,0,0,1761,2020-04-21 09:00:00.000,2021-09-16 10:11:33.897
16024,1,43,울산,0,0,0,1760,2020-04-21 09:00:00.000,2021-09-16 10:11:33.897
16025,0,46,세종,0,0,0,1759,2020-04-21 09:00:00.000,2021-09-16 10:11:33.897
16026,14,658,경기,2,1,1,1758,2020-04-21 09:00:00.000,2021-09-16 10:11:33.897
16027,2,53,강원,0,0,0,1757,2020-04-21 09:00:00.000,2021-09-16 10:11:33.897
16028,0,45,충북,0,0,0,1756,2020-04-21 09:00:00.000,2021-09-16 10:11:33.897
16029,0,141,충남,0,0,0,1755,2020-04-21 09:00:00.000,2021-09-16 10:11:33.897
16030,0,17,전북,0,0,0,1754,2020-04-21 09:00:00.000,2021-09-16 10:11:33.897
16031,0,15,전남,0,0,0,1753,2020-04-21 09:00:00.000,2021-09-16 10:11:33.897
16032,51,1361,경북,0,0,0,1752,2020-04-21 09:00:00.000,2021-09-16 10:11:33.897
16033,0,116,경남,0,0,0,1751,2020-04-21 09:00:00.000,2021-09-16 10:11:33.897
16034,0,13,제주,0,0,0,1750,2020-04-21 09:00:00.000,2021-09-16 10:11:33.897
16035,0,421,검역,3,0,3,1749,2020-04-21 09:00:00.000,2021-09-16 10:11:33.897
16036,236,10674,합계,13,6,7,1748,2020-04-20 09:00:00.000,2021-09-16 10:11:33.897
16037,2,624,서울,0,0,0,1747,2020-04-20 09:00:00.000,2021-09-16 10:11:33.897
16038,3,132,부산,2,2,0,1746,2020-04-20 09:00:00.000,2021-09-16 10:11:33.897
16039,163,6833,대구,1,1,0,1745,2020-04-20 09:00:00.000,2021-09-16 10:11:33.897
16040,0,92,인천,1,0,1,1744,2020-04-20 09:00:00.000,2021-09-16 10:11:33.897
16041,0,30,광주,0,0,0,1743,2020-04-20 09:00:00.000,2021-09-16 10:11:33.897
16042,0,39,대전,0,0,0,1742,2020-04-20 09:00:00.000,2021-09-16 10:11:33.897
16043,1,43,울산,1,0,1,1741,2020-04-20 09:00:00.000,2021-09-16 10:11:33.897
16044,0,46,세종,0,0,0,1740,2020-04-20 09:00:00.000,2021-09-16 10:11:33.897
16045,14,656,경기,2,1,1,1739,2020-04-20 09:00:00.000,2021-09-16 10:11:33.897
16046,2,53,강원,0,0,0,1738,2020-04-20 09:00:00.000,2021-09-16 10:11:33.897
16047,0,45,충북,0,0,0,1737,2020-04-20 09:00:00.000,2021-09-16 10:11:33.897
16048,0,141,충남,0,0,0,1736,2020-04-20 09:00:00.000,2021-09-16 10:11:33.897
16049,0,17,전북,0,0,0,1735,2020-04-20 09:00:00.000,2021-09-16 10:11:33.897
16050,0,15,전남,0,0,0,1734,2020-04-20 09:00:00.000,2021-09-16 10:11:33.897
16051,51,1361,경북,2,2,0,1733,2020-04-20 09:00:00.000,2021-09-16 10:11:33.897
16052,0,116,경남,0,0,0,1732,2020-04-20 09:00:00.000,2021-09-16 10:11:33.897
16053,0,13,제주,0,0,0,1731,2020-04-20 09:00:00.000,2021-09-16 10:11:33.897
16054,0,418,검역,4,0,4,1730,2020-04-20 09:00:00.000,2021-09-16 10:11:33.897
16055,234,10661,합계,8,2,6,1729,2020-04-19 09:00:00.000,2021-09-16 10:11:33.897
16056,2,624,서울,2,0,2,1728,2020-04-19 09:00:00.000,2021-09-16 10:11:33.897
16057,3,130,부산,0,0,0,1727,2020-04-19 09:00:00.000,2021-09-16 10:11:33.897
16058,161,6832,대구,2,1,1,1726,2020-04-19 09:00:00.000,2021-09-16 10:11:33.897
16059,0,91,인천,1,0,1,1725,2020-04-19 09:00:00.000,2021-09-16 10:11:33.897
16060,0,30,광주,0,0,0,1724,2020-04-19 09:00:00.000,2021-09-16 10:11:33.897
16061,0,39,대전,0,0,0,1723,2020-04-19 09:00:00.000,2021-09-16 10:11:33.897
16062,1,42,울산,0,0,0,1722,2020-04-19 09:00:00.000,2021-09-16 10:11:33.897
16063,0,46,세종,0,0,0,1721,2020-04-19 09:00:00.000,2021-09-16 10:11:33.897
16064,14,654,경기,0,0,0,1720,2020-04-19 09:00:00.000,2021-09-16 10:11:33.897
16065,2,53,강원,0,0,0,1719,2020-04-19 09:00:00.000,2021-09-16 10:11:33.897
16066,0,45,충북,0,0,0,1718,2020-04-19 09:00:00.000,2021-09-16 10:11:33.897
16067,0,141,충남,0,0,0,1717,2020-04-19 09:00:00.000,2021-09-16 10:11:33.897
16068,0,17,전북,0,0,0,1716,2020-04-19 09:00:00.000,2021-09-16 10:11:33.897
16069,0,15,전남,0,0,0,1715,2020-04-19 09:00:00.000,2021-09-16 10:11:33.897
16070,51,1359,경북,1,1,0,1714,2020-04-19 09:00:00.000,2021-09-16 10:11:33.897
16071,0,116,경남,0,0,0,1713,2020-04-19 09:00:00.000,2021-09-16 10:11:33.897
16072,0,13,제주,0,0,0,1712,2020-04-19 09:00:00.000,2021-09-16 10:11:33.897
16073,0,414,검역,2,0,2,1711,2020-04-19 09:00:00.000,2021-09-16 10:11:33.897
16074,232,10653,합계,18,9,9,1710,2020-04-18 09:00:00.000,2021-09-16 10:11:33.897
16075,2,622,서울,1,0,1,1709,2020-04-18 09:00:00.000,2021-09-16 10:11:33.897
16076,3,130,부산,0,0,0,1708,2020-04-18 09:00:00.000,2021-09-16 10:11:33.897
16077,160,6830,대구,3,3,0,1707,2020-04-18 09:00:00.000,2021-09-16 10:11:33.897
16078,0,90,인천,1,0,1,1706,2020-04-18 09:00:00.000,2021-09-16 10:11:33.897
16079,0,30,광주,0,0,0,1705,2020-04-18 09:00:00.000,2021-09-16 10:11:33.897
16080,0,39,대전,0,0,0,1704,2020-04-18 09:00:00.000,2021-09-16 10:11:33.897
16081,1,42,울산,0,0,0,1703,2020-04-18 09:00:00.000,2021-09-16 10:11:33.897
16082,0,46,세종,0,0,0,1702,2020-04-18 09:00:00.000,2021-09-16 10:11:33.897
16083,14,654,경기,4,4,0,1701,2020-04-18 09:00:00.000,2021-09-16 10:11:33.897
16084,1,53,강원,1,0,1,1700,2020-04-18 09:00:00.000,2021-09-16 10:11:33.897
16085,0,45,충북,0,0,0,1699,2020-04-18 09:00:00.000,2021-09-16 10:11:33.897
16086,0,141,충남,2,1,1,1698,2020-04-18 09:00:00.000,2021-09-16 10:11:33.897
16087,0,17,전북,0,0,0,1697,2020-04-18 09:00:00.000,2021-09-16 10:11:33.897
16088,0,15,전남,0,0,0,1696,2020-04-18 09:00:00.000,2021-09-16 10:11:33.897
16089,51,1358,경북,2,1,1,1695,2020-04-18 09:00:00.000,2021-09-16 10:11:33.897
16090,0,116,경남,0,0,0,1694,2020-04-18 09:00:00.000,2021-09-16 10:11:33.897
16091,0,13,제주,0,0,0,1693,2020-04-18 09:00:00.000,2021-09-16 10:11:33.897
16092,0,412,검역,4,0,4,1692,2020-04-18 09:00:00.000,2021-09-16 10:11:33.897
16093,230,10635,합계,22,7,15,1691,2020-04-17 09:00:00.000,2021-09-16 10:11:33.897
16094,2,621,서울,2,1,1,1690,2020-04-17 09:00:00.000,2021-09-16 10:11:33.897
16095,3,130,부산,0,0,0,1689,2020-04-17 09:00:00.000,2021-09-16 10:11:33.897
16096,159,6827,대구,0,0,0,1688,2020-04-17 09:00:00.000,2021-09-16 10:11:33.897
16097,0,89,인천,1,0,1,1687,2020-04-17 09:00:00.000,2021-09-16 10:11:33.897
16098,0,30,광주,2,0,2,1686,2020-04-17 09:00:00.000,2021-09-16 10:11:33.897
16099,0,39,대전,0,0,0,1685,2020-04-17 09:00:00.000,2021-09-16 10:11:33.897
16100,1,42,울산,0,0,0,1684,2020-04-17 09:00:00.000,2021-09-16 10:11:33.897
16101,0,46,세종,0,0,0,1683,2020-04-17 09:00:00.000,2021-09-16 10:11:33.897
16102,14,650,경기,1,1,0,1682,2020-04-17 09:00:00.000,2021-09-16 10:11:33.897
16103,1,52,강원,0,0,0,1681,2020-04-17 09:00:00.000,2021-09-16 10:11:33.897
16104,0,45,충북,0,0,0,1680,2020-04-17 09:00:00.000,2021-09-16 10:11:33.897
16105,0,139,충남,0,0,0,1679,2020-04-17 09:00:00.000,2021-09-16 10:11:33.897
16106,0,17,전북,0,0,0,1678,2020-04-17 09:00:00.000,2021-09-16 10:11:33.897
16107,0,15,전남,0,0,0,1677,2020-04-17 09:00:00.000,2021-09-16 10:11:33.897
16108,50,1356,경북,4,4,0,1676,2020-04-17 09:00:00.000,2021-09-16 10:11:33.897
16109,0,116,경남,1,1,0,1675,2020-04-17 09:00:00.000,2021-09-16 10:11:33.897
16110,0,13,제주,0,0,0,1674,2020-04-17 09:00:00.000,2021-09-16 10:11:33.897
16111,0,408,검역,11,0,11,1673,2020-04-17 09:00:00.000,2021-09-16 10:11:33.897
16112,229,10613,합계,22,11,11,1672,2020-04-16 09:00:00.000,2021-09-16 10:11:33.897
16113,2,619,서울,2,1,1,1671,2020-04-16 09:00:00.000,2021-09-16 10:11:33.897
16114,3,130,부산,3,0,3,1670,2020-04-16 09:00:00.000,2021-09-16 10:11:33.897
16115,158,6827,대구,4,4,0,1669,2020-04-16 09:00:00.000,2021-09-16 10:11:33.897
16116,0,88,인천,0,0,0,1668,2020-04-16 09:00:00.000,2021-09-16 10:11:33.897
16117,0,28,광주,0,0,0,1667,2020-04-16 09:00:00.000,2021-09-16 10:11:33.897
16118,0,39,대전,0,0,0,1666,2020-04-16 09:00:00.000,2021-09-16 10:11:33.897
16119,1,42,울산,0,0,0,1665,2020-04-16 09:00:00.000,2021-09-16 10:11:33.897
16120,0,46,세종,0,0,0,1664,2020-04-16 09:00:00.000,2021-09-16 10:11:33.897
16121,14,649,경기,4,1,3,1663,2020-04-16 09:00:00.000,2021-09-16 10:11:33.897
16122,1,52,강원,1,1,0,1662,2020-04-16 09:00:00.000,2021-09-16 10:11:33.897
16123,0,45,충북,0,0,0,1661,2020-04-16 09:00:00.000,2021-09-16 10:11:33.897
16124,0,139,충남,0,0,0,1660,2020-04-16 09:00:00.000,2021-09-16 10:11:33.897
16125,0,17,전북,0,0,0,1659,2020-04-16 09:00:00.000,2021-09-16 10:11:33.897
16126,0,15,전남,0,0,0,1658,2020-04-16 09:00:00.000,2021-09-16 10:11:33.897
16127,50,1352,경북,4,4,0,1657,2020-04-16 09:00:00.000,2021-09-16 10:11:33.897
16128,0,115,경남,0,0,0,1656,2020-04-16 09:00:00.000,2021-09-16 10:11:33.897
16129,0,13,제주,0,0,0,1655,2020-04-16 09:00:00.000,2021-09-16 10:11:33.897
16130,0,397,검역,4,0,4,1654,2020-04-16 09:00:00.000,2021-09-16 10:11:33.897
16131,225,10591,합계,27,13,14,1653,2020-04-15 09:00:00.000,2021-09-16 10:11:33.897
16132,2,617,서울,5,1,4,1652,2020-04-15 09:00:00.000,2021-09-16 10:11:33.897
16133,3,127,부산,1,0,1,1651,2020-04-15 09:00:00.000,2021-09-16 10:11:33.897
16134,155,6823,대구,1,0,1,1650,2020-04-15 09:00:00.000,2021-09-16 10:11:33.897
16135,0,88,인천,0,0,0,1649,2020-04-15 09:00:00.000,2021-09-16 10:11:33.897
16136,0,28,광주,1,0,1,1648,2020-04-15 09:00:00.000,2021-09-16 10:11:33.897
16137,0,39,대전,0,0,0,1647,2020-04-15 09:00:00.000,2021-09-16 10:11:33.897
16138,1,42,울산,0,0,0,1646,2020-04-15 09:00:00.000,2021-09-16 10:11:33.897
16139,0,46,세종,0,0,0,1645,2020-04-15 09:00:00.000,2021-09-16 10:11:33.897
16140,13,645,경기,6,5,1,1644,2020-04-15 09:00:00.000,2021-09-16 10:11:33.897
16141,1,51,강원,2,1,1,1643,2020-04-15 09:00:00.000,2021-09-16 10:11:33.897
16142,0,45,충북,0,0,0,1642,2020-04-15 09:00:00.000,2021-09-16 10:11:33.897
16143,0,139,충남,0,0,0,1641,2020-04-15 09:00:00.000,2021-09-16 10:11:33.897
16144,0,17,전북,0,0,0,1640,2020-04-15 09:00:00.000,2021-09-16 10:11:33.897
16145,0,15,전남,0,0,0,1639,2020-04-15 09:00:00.000,2021-09-16 10:11:33.897
16146,50,1348,경북,6,6,0,1638,2020-04-15 09:00:00.000,2021-09-16 10:11:33.897
16147,0,115,경남,0,0,0,1637,2020-04-15 09:00:00.000,2021-09-16 10:11:33.897
16148,0,13,제주,1,0,1,1636,2020-04-15 09:00:00.000,2021-09-16 10:11:33.897
16149,0,393,검역,4,0,4,1635,2020-04-15 09:00:00.000,2021-09-16 10:11:33.897
16150,222,10564,합계,27,11,16,1634,2020-04-14 09:00:00.000,2021-09-16 10:11:33.897
16151,2,612,서울,2,0,2,1633,2020-04-14 09:00:00.000,2021-09-16 10:11:33.897
16152,3,126,부산,0,0,0,1632,2020-04-14 09:00:00.000,2021-09-16 10:11:33.897
16153,152,6822,대구,3,2,1,1631,2020-04-14 09:00:00.000,2021-09-16 10:11:33.897
16154,0,88,인천,1,0,1,1630,2020-04-14 09:00:00.000,2021-09-16 10:11:33.897
16155,0,27,광주,0,0,0,1629,2020-04-14 09:00:00.000,2021-09-16 10:11:33.897
16156,0,39,대전,0,0,0,1628,2020-04-14 09:00:00.000,2021-09-16 10:11:33.897
16157,1,42,울산,1,0,1,1627,2020-04-14 09:00:00.000,2021-09-16 10:11:33.897
16158,0,46,세종,0,0,0,1626,2020-04-14 09:00:00.000,2021-09-16 10:11:33.897
16159,13,639,경기,8,4,4,1625,2020-04-14 09:00:00.000,2021-09-16 10:11:33.897
16160,1,49,강원,0,0,0,1624,2020-04-14 09:00:00.000,2021-09-16 10:11:33.897
16161,0,45,충북,0,0,0,1623,2020-04-14 09:00:00.000,2021-09-16 10:11:33.897
16162,0,139,충남,0,0,0,1622,2020-04-14 09:00:00.000,2021-09-16 10:11:33.897
16163,0,17,전북,0,0,0,1621,2020-04-14 09:00:00.000,2021-09-16 10:11:33.897
16164,0,15,전남,0,0,0,1620,2020-04-14 09:00:00.000,2021-09-16 10:11:33.897
16165,50,1342,경북,5,5,0,1619,2020-04-14 09:00:00.000,2021-09-16 10:11:33.897
16166,0,115,경남,0,0,0,1618,2020-04-14 09:00:00.000,2021-09-16 10:11:33.897
16167,0,12,제주,0,0,0,1617,2020-04-14 09:00:00.000,2021-09-16 10:11:33.897
16168,0,389,검역,7,0,7,1616,2020-04-14 09:00:00.000,2021-09-16 10:11:33.897
16169,217,10537,합계,25,10,15,1615,2020-04-13 09:00:00.000,2021-09-16 10:11:33.897
16170,2,610,서울,8,1,7,1614,2020-04-13 09:00:00.000,2021-09-16 10:11:33.897
16171,3,126,부산,0,0,0,1613,2020-04-13 09:00:00.000,2021-09-16 10:11:33.897
16172,147,6819,대구,3,3,0,1612,2020-04-13 09:00:00.000,2021-09-16 10:11:33.897
16173,0,87,인천,1,0,1,1611,2020-04-13 09:00:00.000,2021-09-16 10:11:33.897
16174,0,27,광주,0,0,0,1610,2020-04-13 09:00:00.000,2021-09-16 10:11:33.897
16175,0,39,대전,0,0,0,1609,2020-04-13 09:00:00.000,2021-09-16 10:11:33.897
16176,1,41,울산,0,0,0,1608,2020-04-13 09:00:00.000,2021-09-16 10:11:33.897
16177,0,46,세종,0,0,0,1607,2020-04-13 09:00:00.000,2021-09-16 10:11:33.897
16178,13,631,경기,3,2,1,1606,2020-04-13 09:00:00.000,2021-09-16 10:11:33.897
16179,1,49,강원,0,0,0,1605,2020-04-13 09:00:00.000,2021-09-16 10:11:33.897
16180,0,45,충북,0,0,0,1604,2020-04-13 09:00:00.000,2021-09-16 10:11:33.897
16181,0,139,충남,0,0,0,1603,2020-04-13 09:00:00.000,2021-09-16 10:11:33.897
16182,0,17,전북,0,0,0,1602,2020-04-13 09:00:00.000,2021-09-16 10:11:33.897
16183,0,15,전남,0,0,0,1601,2020-04-13 09:00:00.000,2021-09-16 10:11:33.897
16184,50,1337,경북,4,4,0,1600,2020-04-13 09:00:00.000,2021-09-16 10:11:33.897
16185,0,115,경남,0,0,0,1599,2020-04-13 09:00:00.000,2021-09-16 10:11:33.897
16186,0,12,제주,0,0,0,1598,2020-04-13 09:00:00.000,2021-09-16 10:11:33.897
16187,0,382,검역,6,0,6,1597,2020-04-13 09:00:00.000,2021-09-16 10:11:33.897
16188,214,10512,합계,32,9,23,1596,2020-04-12 09:00:00.000,2021-09-16 10:11:33.897
16189,2,602,서울,3,2,1,1595,2020-04-12 09:00:00.000,2021-09-16 10:11:33.897
16190,3,126,부산,0,0,0,1594,2020-04-12 09:00:00.000,2021-09-16 10:11:33.897
16191,146,6816,대구,2,1,1,1593,2020-04-12 09:00:00.000,2021-09-16 10:11:33.897
16192,0,86,인천,1,0,1,1592,2020-04-12 09:00:00.000,2021-09-16 10:11:33.897
16193,0,27,광주,0,0,0,1591,2020-04-12 09:00:00.000,2021-09-16 10:11:33.897
16194,0,39,대전,0,0,0,1590,2020-04-12 09:00:00.000,2021-09-16 10:11:33.897
16195,1,41,울산,0,0,0,1589,2020-04-12 09:00:00.000,2021-09-16 10:11:33.897
16196,0,46,세종,0,0,0,1588,2020-04-12 09:00:00.000,2021-09-16 10:11:33.897
16197,12,628,경기,4,3,1,1587,2020-04-12 09:00:00.000,2021-09-16 10:11:33.897
16198,1,49,강원,0,0,0,1586,2020-04-12 09:00:00.000,2021-09-16 10:11:33.897
16199,0,45,충북,0,0,0,1585,2020-04-12 09:00:00.000,2021-09-16 10:11:33.897
16200,0,139,충남,1,0,1,1584,2020-04-12 09:00:00.000,2021-09-16 10:11:33.897
16201,0,17,전북,0,0,0,1583,2020-04-12 09:00:00.000,2021-09-16 10:11:33.897
16202,0,15,전남,0,0,0,1582,2020-04-12 09:00:00.000,2021-09-16 10:11:33.897
16203,49,1333,경북,3,3,0,1581,2020-04-12 09:00:00.000,2021-09-16 10:11:33.897
16204,0,115,경남,0,0,0,1580,2020-04-12 09:00:00.000,2021-09-16 10:11:33.897
16205,0,12,제주,0,0,0,1579,2020-04-12 09:00:00.000,2021-09-16 10:11:33.897
16206,0,376,검역,18,0,18,1578,2020-04-12 09:00:00.000,2021-09-16 10:11:33.897
16207,211,10480,합계,30,16,14,1577,2020-04-11 09:00:00.000,2021-09-16 10:11:33.897
16208,2,599,서울,4,1,3,1576,2020-04-11 09:00:00.000,2021-09-16 10:11:33.897
16209,3,126,부산,0,0,0,1575,2020-04-11 09:00:00.000,2021-09-16 10:11:33.897
16210,145,6814,대구,7,6,1,1574,2020-04-11 09:00:00.000,2021-09-16 10:11:33.897
16211,0,85,인천,0,0,0,1573,2020-04-11 09:00:00.000,2021-09-16 10:11:33.897
16212,0,27,광주,0,0,0,1572,2020-04-11 09:00:00.000,2021-09-16 10:11:33.897
16213,0,39,대전,0,0,0,1571,2020-04-11 09:00:00.000,2021-09-16 10:11:33.897
16214,1,41,울산,1,0,1,1570,2020-04-11 09:00:00.000,2021-09-16 10:11:33.897
16215,0,46,세종,0,0,0,1569,2020-04-11 09:00:00.000,2021-09-16 10:11:33.897
16216,11,624,경기,9,6,3,1568,2020-04-11 09:00:00.000,2021-09-16 10:11:33.897
16217,1,49,강원,0,0,0,1567,2020-04-11 09:00:00.000,2021-09-16 10:11:33.897
16218,0,45,충북,0,0,0,1566,2020-04-11 09:00:00.000,2021-09-16 10:11:33.897
16219,0,138,충남,0,0,0,1565,2020-04-11 09:00:00.000,2021-09-16 10:11:33.897
16220,0,17,전북,0,0,0,1564,2020-04-11 09:00:00.000,2021-09-16 10:11:33.897
16221,0,15,전남,0,0,0,1563,2020-04-11 09:00:00.000,2021-09-16 10:11:33.897
16222,48,1330,경북,3,3,0,1562,2020-04-11 09:00:00.000,2021-09-16 10:11:33.897
16223,0,115,경남,0,0,0,1561,2020-04-11 09:00:00.000,2021-09-16 10:11:33.897
16224,0,12,제주,0,0,0,1560,2020-04-11 09:00:00.000,2021-09-16 10:11:33.897
16225,0,358,검역,6,0,6,1559,2020-04-11 09:00:00.000,2021-09-16 10:11:33.897
16226,208,10450,합계,27,17,10,1558,2020-04-10 09:00:00.000,2021-09-16 10:11:33.897
16227,2,595,서울,5,3,2,1557,2020-04-10 09:00:00.000,2021-09-16 10:11:33.897
16228,3,126,부산,1,0,1,1556,2020-04-10 09:00:00.000,2021-09-16 10:11:33.897
16229,142,6807,대구,0,0,0,1555,2020-04-10 09:00:00.000,2021-09-16 10:11:33.897
16230,0,85,인천,1,1,0,1554,2020-04-10 09:00:00.000,2021-09-16 10:11:33.897
16231,0,27,광주,0,0,0,1553,2020-04-10 09:00:00.000,2021-09-16 10:11:33.897
16232,0,39,대전,0,0,0,1552,2020-04-10 09:00:00.000,2021-09-16 10:11:33.897
16233,1,40,울산,0,0,0,1551,2020-04-10 09:00:00.000,2021-09-16 10:11:33.897
16234,0,46,세종,0,0,0,1550,2020-04-10 09:00:00.000,2021-09-16 10:11:33.897
16235,11,615,경기,9,6,3,1549,2020-04-10 09:00:00.000,2021-09-16 10:11:33.897
16236,1,49,강원,0,0,0,1548,2020-04-10 09:00:00.000,2021-09-16 10:11:33.897
16237,0,45,충북,0,0,0,1547,2020-04-10 09:00:00.000,2021-09-16 10:11:33.897
16238,0,138,충남,0,0,0,1546,2020-04-10 09:00:00.000,2021-09-16 10:11:33.897
16239,0,17,전북,0,0,0,1545,2020-04-10 09:00:00.000,2021-09-16 10:11:33.897
16240,0,15,전남,0,0,0,1544,2020-04-10 09:00:00.000,2021-09-16 10:11:33.897
16241,48,1327,경북,7,7,0,1543,2020-04-10 09:00:00.000,2021-09-16 10:11:33.897
16242,0,115,경남,0,0,0,1542,2020-04-10 09:00:00.000,2021-09-16 10:11:33.897
16243,0,12,제주,0,0,0,1541,2020-04-10 09:00:00.000,2021-09-16 10:11:33.897
16244,0,352,검역,4,0,4,1540,2020-04-10 09:00:00.000,2021-09-16 10:11:33.897
16245,204,10423,합계,39,13,26,1539,2020-04-09 09:00:00.000,2021-09-16 10:11:33.897
16246,2,590,서울,12,3,9,1538,2020-04-09 09:00:00.000,2021-09-16 10:11:33.897
16247,3,125,부산,0,0,0,1537,2020-04-09 09:00:00.000,2021-09-16 10:11:33.897
16248,139,6807,대구,4,4,0,1536,2020-04-09 09:00:00.000,2021-09-16 10:11:33.897
16249,0,84,인천,0,0,0,1535,2020-04-09 09:00:00.000,2021-09-16 10:11:33.897
16250,0,27,광주,0,0,0,1534,2020-04-09 09:00:00.000,2021-09-16 10:11:33.897
16251,0,39,대전,0,0,0,1533,2020-04-09 09:00:00.000,2021-09-16 10:11:33.897
16252,1,40,울산,0,0,0,1532,2020-04-09 09:00:00.000,2021-09-16 10:11:33.897
16253,0,46,세종,0,0,0,1531,2020-04-09 09:00:00.000,2021-09-16 10:11:33.897
16254,11,606,경기,10,5,5,1530,2020-04-09 09:00:00.000,2021-09-16 10:11:33.897
16255,1,49,강원,0,0,0,1529,2020-04-09 09:00:00.000,2021-09-16 10:11:33.897
16256,0,45,충북,0,0,0,1528,2020-04-09 09:00:00.000,2021-09-16 10:11:33.897
16257,0,138,충남,1,0,1,1527,2020-04-09 09:00:00.000,2021-09-16 10:11:33.897
16258,0,17,전북,0,0,0,1526,2020-04-09 09:00:00.000,2021-09-16 10:11:33.897
16259,0,15,전남,0,0,0,1525,2020-04-09 09:00:00.000,2021-09-16 10:11:33.897
16260,47,1320,경북,0,0,0,1524,2020-04-09 09:00:00.000,2021-09-16 10:11:33.897
16261,0,115,경남,2,1,1,1523,2020-04-09 09:00:00.000,2021-09-16 10:11:33.897
16262,0,12,제주,0,0,0,1522,2020-04-09 09:00:00.000,2021-09-16 10:11:33.897
16263,0,348,검역,10,0,10,1521,2020-04-09 09:00:00.000,2021-09-16 10:11:33.897
16264,200,10384,합계,53,23,30,1520,2020-04-08 09:00:00.000,2021-09-16 10:11:33.897
16265,2,578,서울,11,3,8,1519,2020-04-08 09:00:00.000,2021-09-16 10:11:33.897
16266,3,125,부산,2,0,2,1518,2020-04-08 09:00:00.000,2021-09-16 10:11:33.897
16267,137,6803,대구,9,9,0,1517,2020-04-08 09:00:00.000,2021-09-16 10:11:33.897
16268,0,84,인천,4,1,3,1516,2020-04-08 09:00:00.000,2021-09-16 10:11:33.897
16269,0,27,광주,0,0,0,1515,2020-04-08 09:00:00.000,2021-09-16 10:11:33.897
16270,0,39,대전,0,0,0,1514,2020-04-08 09:00:00.000,2021-09-16 10:11:33.897
16271,1,40,울산,0,0,0,1513,2020-04-08 09:00:00.000,2021-09-16 10:11:33.897
16272,0,46,세종,0,0,0,1512,2020-04-08 09:00:00.000,2021-09-16 10:11:33.897
16273,10,596,경기,6,4,2,1511,2020-04-08 09:00:00.000,2021-09-16 10:11:33.897
16274,1,49,강원,2,2,0,1510,2020-04-08 09:00:00.000,2021-09-16 10:11:33.897
16275,0,45,충북,0,0,0,1509,2020-04-08 09:00:00.000,2021-09-16 10:11:33.897
16276,0,137,충남,0,0,0,1508,2020-04-08 09:00:00.000,2021-09-16 10:11:33.897
16277,0,17,전북,1,0,1,1507,2020-04-08 09:00:00.000,2021-09-16 10:11:33.897
16278,0,15,전남,0,0,0,1506,2020-04-08 09:00:00.000,2021-09-16 10:11:33.897
16279,46,1320,경북,3,3,0,1505,2020-04-08 09:00:00.000,2021-09-16 10:11:33.897
16280,0,113,경남,1,1,0,1504,2020-04-08 09:00:00.000,2021-09-16 10:11:33.897
16281,0,12,제주,0,0,0,1503,2020-04-08 09:00:00.000,2021-09-16 10:11:33.897
16282,0,338,검역,14,0,14,1502,2020-04-08 09:00:00.000,2021-09-16 10:11:33.897
16283,192,10331,합계,47,23,24,1501,2020-04-07 09:00:00.000,2021-09-16 10:11:33.897
16284,0,567,서울,4,1,3,1500,2020-04-07 09:00:00.000,2021-09-16 10:11:33.897
16285,3,123,부산,1,0,1,1499,2020-04-07 09:00:00.000,2021-09-16 10:11:33.897
16286,134,6794,대구,13,12,1,1498,2020-04-07 09:00:00.000,2021-09-16 10:11:33.897
16287,0,80,인천,0,0,0,1497,2020-04-07 09:00:00.000,2021-09-16 10:11:33.897
16288,0,27,광주,0,0,0,1496,2020-04-07 09:00:00.000,2021-09-16 10:11:33.897
16289,0,39,대전,0,0,0,1495,2020-04-07 09:00:00.000,2021-09-16 10:11:33.897
16290,1,40,울산,0,0,0,1494,2020-04-07 09:00:00.000,2021-09-16 10:11:33.897
16291,0,46,세종,0,0,0,1493,2020-04-07 09:00:00.000,2021-09-16 10:11:33.897
16292,7,590,경기,10,7,3,1492,2020-04-07 09:00:00.000,2021-09-16 10:11:33.897
16293,1,47,강원,2,0,2,1491,2020-04-07 09:00:00.000,2021-09-16 10:11:33.897
16294,0,45,충북,0,0,0,1490,2020-04-07 09:00:00.000,2021-09-16 10:11:33.897
16295,0,137,충남,1,1,0,1489,2020-04-07 09:00:00.000,2021-09-16 10:11:33.897
16296,0,16,전북,0,0,0,1488,2020-04-07 09:00:00.000,2021-09-16 10:11:33.897
16297,0,15,전남,0,0,0,1487,2020-04-07 09:00:00.000,2021-09-16 10:11:33.897
16298,46,1317,경북,1,1,0,1486,2020-04-07 09:00:00.000,2021-09-16 10:11:33.897
16299,0,112,경남,1,1,0,1485,2020-04-07 09:00:00.000,2021-09-16 10:11:33.897
16300,0,12,제주,0,0,0,1484,2020-04-07 09:00:00.000,2021-09-16 10:11:33.897
16301,0,324,검역,14,0,14,1483,2020-04-07 09:00:00.000,2021-09-16 10:11:33.897
16302,186,10284,합계,47,25,22,1482,2020-04-06 09:00:00.000,2021-09-16 10:11:33.897
16303,0,563,서울,11,2,9,1481,2020-04-06 09:00:00.000,2021-09-16 10:11:33.897
16304,3,122,부산,0,0,0,1480,2020-04-06 09:00:00.000,2021-09-16 10:11:33.897
16305,129,6781,대구,13,12,1,1479,2020-04-06 09:00:00.000,2021-09-16 10:11:33.897
16306,0,80,인천,1,1,0,1478,2020-04-06 09:00:00.000,2021-09-16 10:11:33.897
16307,0,27,광주,0,0,0,1477,2020-04-06 09:00:00.000,2021-09-16 10:11:33.897
16308,0,39,대전,2,0,2,1476,2020-04-06 09:00:00.000,2021-09-16 10:11:33.897
16309,1,40,울산,0,0,0,1475,2020-04-06 09:00:00.000,2021-09-16 10:11:33.897
16310,0,46,세종,0,0,0,1474,2020-04-06 09:00:00.000,2021-09-16 10:11:33.897
16311,7,580,경기,8,5,3,1473,2020-04-06 09:00:00.000,2021-09-16 10:11:33.897
16312,1,45,강원,0,0,0,1472,2020-04-06 09:00:00.000,2021-09-16 10:11:33.897
16313,0,45,충북,0,0,0,1471,2020-04-06 09:00:00.000,2021-09-16 10:11:33.897
16314,0,136,충남,1,1,0,1470,2020-04-06 09:00:00.000,2021-09-16 10:11:33.897
16315,0,16,전북,0,0,0,1469,2020-04-06 09:00:00.000,2021-09-16 10:11:33.897
16316,0,15,전남,0,0,0,1468,2020-04-06 09:00:00.000,2021-09-16 10:11:33.897
16317,45,1316,경북,2,2,0,1467,2020-04-06 09:00:00.000,2021-09-16 10:11:33.897
16318,0,111,경남,2,2,0,1466,2020-04-06 09:00:00.000,2021-09-16 10:11:33.897
16319,0,12,제주,0,0,0,1465,2020-04-06 09:00:00.000,2021-09-16 10:11:33.897
16320,0,310,검역,7,0,7,1464,2020-04-06 09:00:00.000,2021-09-16 10:11:33.897
16321,183,10237,합계,81,31,50,1463,2020-04-05 09:00:00.000,2021-09-16 10:11:33.897
16322,0,552,서울,24,11,13,1462,2020-04-05 09:00:00.000,2021-09-16 10:11:33.897
16323,3,122,부산,0,0,0,1461,2020-04-05 09:00:00.000,2021-09-16 10:11:33.897
16324,127,6768,대구,7,6,1,1460,2020-04-05 09:00:00.000,2021-09-16 10:11:33.897
16325,0,79,인천,2,1,1,1459,2020-04-05 09:00:00.000,2021-09-16 10:11:33.897
16326,0,27,광주,1,0,1,1458,2020-04-05 09:00:00.000,2021-09-16 10:11:33.897
16327,0,37,대전,1,0,1,1457,2020-04-05 09:00:00.000,2021-09-16 10:11:33.897
16328,1,40,울산,0,0,0,1456,2020-04-05 09:00:00.000,2021-09-16 10:11:33.897
16329,0,46,세종,0,0,0,1455,2020-04-05 09:00:00.000,2021-09-16 10:11:33.897
16330,7,572,경기,10,5,5,1454,2020-04-05 09:00:00.000,2021-09-16 10:11:33.897
16331,1,45,강원,3,2,1,1453,2020-04-05 09:00:00.000,2021-09-16 10:11:33.897
16332,0,45,충북,0,0,0,1452,2020-04-05 09:00:00.000,2021-09-16 10:11:33.897
16333,0,135,충남,0,0,0,1451,2020-04-05 09:00:00.000,2021-09-16 10:11:33.897
16334,0,16,전북,1,1,0,1450,2020-04-05 09:00:00.000,2021-09-16 10:11:33.897
16335,0,15,전남,0,0,0,1449,2020-04-05 09:00:00.000,2021-09-16 10:11:33.897
16336,44,1314,경북,4,4,0,1448,2020-04-05 09:00:00.000,2021-09-16 10:11:33.897
16337,0,109,경남,1,0,1,1447,2020-04-05 09:00:00.000,2021-09-16 10:11:33.897
16338,0,12,제주,3,1,2,1446,2020-04-05 09:00:00.000,2021-09-16 10:11:33.897
16339,0,303,검역,24,0,24,1445,2020-04-05 09:00:00.000,2021-09-16 10:11:33.897
16340,177,10156,합계,94,53,41,1444,2020-04-04 09:00:00.000,2021-09-16 10:11:33.897
16341,0,528,서울,22,6,16,1443,2020-04-04 09:00:00.000,2021-09-16 10:11:33.897
16342,3,122,부산,0,0,0,1442,2020-04-04 09:00:00.000,2021-09-16 10:11:33.897
16343,122,6761,대구,27,25,2,1441,2020-04-04 09:00:00.000,2021-09-16 10:11:33.897
16344,0,77,인천,3,0,3,1440,2020-04-04 09:00:00.000,2021-09-16 10:11:33.897
16345,0,26,광주,0,0,0,1439,2020-04-04 09:00:00.000,2021-09-16 10:11:33.897
16346,0,36,대전,0,0,0,1438,2020-04-04 09:00:00.000,2021-09-16 10:11:33.897
16347,1,40,울산,0,0,0,1437,2020-04-04 09:00:00.000,2021-09-16 10:11:33.897
16348,0,46,세종,0,0,0,1436,2020-04-04 09:00:00.000,2021-09-16 10:11:33.897
16349,6,562,경기,23,18,5,1435,2020-04-04 09:00:00.000,2021-09-16 10:11:33.897
16350,1,42,강원,1,1,0,1434,2020-04-04 09:00:00.000,2021-09-16 10:11:33.897
16351,0,45,충북,0,0,0,1433,2020-04-04 09:00:00.000,2021-09-16 10:11:33.897
16352,0,135,충남,1,1,0,1432,2020-04-04 09:00:00.000,2021-09-16 10:11:33.897
16353,0,15,전북,0,0,0,1431,2020-04-04 09:00:00.000,2021-09-16 10:11:33.897
16354,0,15,전남,0,0,0,1430,2020-04-04 09:00:00.000,2021-09-16 10:11:33.897
16355,44,1310,경북,1,1,0,1429,2020-04-04 09:00:00.000,2021-09-16 10:11:33.897
16356,0,108,경남,1,1,0,1428,2020-04-04 09:00:00.000,2021-09-16 10:11:33.897
16357,0,9,제주,0,0,0,1427,2020-04-04 09:00:00.000,2021-09-16 10:11:33.897
16358,0,279,검역,15,0,15,1426,2020-04-04 09:00:00.000,2021-09-16 10:11:33.897
16359,174,10062,합계,86,37,49,1425,2020-04-03 09:00:00.000,2021-09-16 10:11:33.897
16360,0,506,서울,18,5,13,1424,2020-04-03 09:00:00.000,2021-09-16 10:11:33.897
16361,3,122,부산,0,0,0,1423,2020-04-03 09:00:00.000,2021-09-16 10:11:33.897
16362,121,6734,대구,9,8,1,1422,2020-04-03 09:00:00.000,2021-09-16 10:11:33.897
16363,0,74,인천,1,1,0,1421,2020-04-03 09:00:00.000,2021-09-16 10:11:33.897
16364,0,26,광주,1,0,1,1420,2020-04-03 09:00:00.000,2021-09-16 10:11:33.897
16365,0,36,대전,0,0,0,1419,2020-04-03 09:00:00.000,2021-09-16 10:11:33.897
16366,1,40,울산,0,0,0,1418,2020-04-03 09:00:00.000,2021-09-16 10:11:33.897
16367,0,46,세종,0,0,0,1417,2020-04-03 09:00:00.000,2021-09-16 10:11:33.897
16368,6,539,경기,23,17,6,1416,2020-04-03 09:00:00.000,2021-09-16 10:11:33.897
16369,1,41,강원,2,2,0,1415,2020-04-03 09:00:00.000,2021-09-16 10:11:33.897
16370,0,45,충북,1,0,1,1414,2020-04-03 09:00:00.000,2021-09-16 10:11:33.897
16371,0,134,충남,1,1,0,1413,2020-04-03 09:00:00.000,2021-09-16 10:11:33.897
16372,0,15,전북,1,0,1,1412,2020-04-03 09:00:00.000,2021-09-16 10:11:33.897
16373,0,15,전남,1,0,1,1411,2020-04-03 09:00:00.000,2021-09-16 10:11:33.897
16374,42,1309,경북,5,3,2,1410,2020-04-03 09:00:00.000,2021-09-16 10:11:33.897
16375,0,107,경남,1,0,1,1409,2020-04-03 09:00:00.000,2021-09-16 10:11:33.897
16376,0,9,제주,0,0,0,1408,2020-04-03 09:00:00.000,2021-09-16 10:11:33.897
16377,0,264,검역,22,0,22,1407,2020-04-03 09:00:00.000,2021-09-16 10:11:33.897
16378,169,9976,합계,89,43,46,1406,2020-04-02 09:00:00.000,2021-09-16 10:11:33.897
16379,0,488,서울,14,3,11,1405,2020-04-02 09:00:00.000,2021-09-16 10:11:33.897
16380,3,122,부산,0,0,0,1404,2020-04-02 09:00:00.000,2021-09-16 10:11:33.897
16381,117,6725,대구,21,20,1,1403,2020-04-02 09:00:00.000,2021-09-16 10:11:33.897
16382,0,73,인천,4,3,1,1402,2020-04-02 09:00:00.000,2021-09-16 10:11:33.897
16383,0,25,광주,1,0,1,1401,2020-04-02 09:00:00.000,2021-09-16 10:11:33.897
16384,0,36,대전,0,0,0,1400,2020-04-02 09:00:00.000,2021-09-16 10:11:33.897
16385,1,40,울산,1,0,1,1399,2020-04-02 09:00:00.000,2021-09-16 10:11:33.897
16386,0,46,세종,0,0,0,1398,2020-04-02 09:00:00.000,2021-09-16 10:11:33.897
16387,6,516,경기,18,10,8,1397,2020-04-02 09:00:00.000,2021-09-16 10:11:33.897
16388,1,39,강원,1,0,1,1396,2020-04-02 09:00:00.000,2021-09-16 10:11:33.897
16389,0,44,충북,0,0,0,1395,2020-04-02 09:00:00.000,2021-09-16 10:11:33.897
16390,0,133,충남,2,2,0,1394,2020-04-02 09:00:00.000,2021-09-16 10:11:33.897
16391,0,14,전북,0,0,0,1393,2020-04-02 09:00:00.000,2021-09-16 10:11:33.897
16392,0,14,전남,2,0,2,1392,2020-04-02 09:00:00.000,2021-09-16 10:11:33.897
16393,41,1304,경북,2,1,1,1391,2020-04-02 09:00:00.000,2021-09-16 10:11:33.897
16394,0,106,경남,6,4,2,1390,2020-04-02 09:00:00.000,2021-09-16 10:11:33.897
16395,0,9,제주,0,0,0,1389,2020-04-02 09:00:00.000,2021-09-16 10:11:33.897
16396,0,242,검역,17,0,17,1388,2020-04-02 09:00:00.000,2021-09-16 10:11:33.897
16397,165,9887,합계,101,56,45,1387,2020-04-01 09:00:00.000,2021-09-16 10:11:33.897
16398,0,474,서울,24,11,13,1386,2020-04-01 09:00:00.000,2021-09-16 10:11:33.897
16399,3,122,부산,3,0,3,1385,2020-04-01 09:00:00.000,2021-09-16 10:11:33.897
16400,115,6704,대구,20,20,0,1384,2020-04-01 09:00:00.000,2021-09-16 10:11:33.897
16401,0,69,인천,5,1,4,1383,2020-04-01 09:00:00.000,2021-09-16 10:11:33.897
16402,0,24,광주,4,1,3,1382,2020-04-01 09:00:00.000,2021-09-16 10:11:33.897
16403,0,36,대전,0,0,0,1381,2020-04-01 09:00:00.000,2021-09-16 10:11:33.897
16404,1,39,울산,0,0,0,1380,2020-04-01 09:00:00.000,2021-09-16 10:11:33.897
16405,0,46,세종,0,0,0,1379,2020-04-01 09:00:00.000,2021-09-16 10:11:33.897
16406,6,498,경기,22,14,8,1378,2020-04-01 09:00:00.000,2021-09-16 10:11:33.897
16407,1,38,강원,2,1,1,1377,2020-04-01 09:00:00.000,2021-09-16 10:11:33.897
16408,0,44,충북,0,0,0,1376,2020-04-01 09:00:00.000,2021-09-16 10:11:33.897
16409,0,131,충남,3,2,1,1375,2020-04-01 09:00:00.000,2021-09-16 10:11:33.897
16410,0,14,전북,1,1,0,1374,2020-04-01 09:00:00.000,2021-09-16 10:11:33.897
16411,0,12,전남,3,1,2,1373,2020-04-01 09:00:00.000,2021-09-16 10:11:33.897
16412,39,1302,경북,2,2,0,1372,2020-04-01 09:00:00.000,2021-09-16 10:11:33.897
16413,0,100,경남,4,2,2,1371,2020-04-01 09:00:00.000,2021-09-16 10:11:33.897
16414,0,9,제주,0,0,0,1370,2020-04-01 09:00:00.000,2021-09-16 10:11:33.897
16415,0,225,검역,8,0,8,1369,2020-04-01 09:00:00.000,2021-09-16 10:11:33.897
16416,162,9786,합계,125,88,37,1368,2020-03-31 09:00:00.000,2021-09-16 10:11:33.897
16417,0,450,서울,24,17,7,1367,2020-03-31 09:00:00.000,2021-09-16 10:11:33.897
16418,3,119,부산,1,0,1,1366,2020-03-31 09:00:00.000,2021-09-16 10:11:33.897
16419,114,6684,대구,60,59,1,1365,2020-03-31 09:00:00.000,2021-09-16 10:11:33.897
16420,0,64,인천,6,3,3,1364,2020-03-31 09:00:00.000,2021-09-16 10:11:33.897
16421,0,20,광주,0,0,0,1363,2020-03-31 09:00:00.000,2021-09-16 10:11:33.897
16422,0,36,대전,2,0,2,1362,2020-03-31 09:00:00.000,2021-09-16 10:11:33.897
16423,0,39,울산,0,0,0,1361,2020-03-31 09:00:00.000,2021-09-16 10:11:33.897
16424,0,46,세종,0,0,0,1360,2020-03-31 09:00:00.000,2021-09-16 10:11:33.897
16425,6,476,경기,13,7,6,1359,2020-03-31 09:00:00.000,2021-09-16 10:11:33.897
16426,1,36,강원,0,0,0,1358,2020-03-31 09:00:00.000,2021-09-16 10:11:33.897
16427,0,44,충북,0,0,0,1357,2020-03-31 09:00:00.000,2021-09-16 10:11:33.897
16428,0,128,충남,1,1,0,1356,2020-03-31 09:00:00.000,2021-09-16 10:11:33.897
16429,0,13,전북,0,0,0,1355,2020-03-31 09:00:00.000,2021-09-16 10:11:33.897
16430,0,9,전남,0,0,0,1354,2020-03-31 09:00:00.000,2021-09-16 10:11:33.897
16431,38,1300,경북,2,1,1,1353,2020-03-31 09:00:00.000,2021-09-16 10:11:33.897
16432,0,96,경남,1,0,1,1352,2020-03-31 09:00:00.000,2021-09-16 10:11:33.897
16433,0,9,제주,0,0,0,1351,2020-03-31 09:00:00.000,2021-09-16 10:11:33.897
16434,0,217,검역,15,0,15,1350,2020-03-31 09:00:00.000,2021-09-16 10:11:33.897
16435,158,9661,합계,78,35,43,1349,2020-03-30 09:00:00.000,2021-09-16 10:11:33.897
16436,0,426,서울,16,7,9,1348,2020-03-30 09:00:00.000,2021-09-16 10:11:33.897
16437,3,118,부산,1,0,1,1347,2020-03-30 09:00:00.000,2021-09-16 10:11:33.897
16438,111,6624,대구,14,13,1,1346,2020-03-30 09:00:00.000,2021-09-16 10:11:33.897
16439,0,58,인천,0,0,0,1345,2020-03-30 09:00:00.000,2021-09-16 10:11:33.897
16440,0,20,광주,0,0,0,1344,2020-03-30 09:00:00.000,2021-09-16 10:11:33.897
16441,0,34,대전,0,0,0,1343,2020-03-30 09:00:00.000,2021-09-16 10:11:33.897
16442,0,39,울산,0,0,0,1342,2020-03-30 09:00:00.000,2021-09-16 10:11:33.897
16443,0,46,세종,0,0,0,1341,2020-03-30 09:00:00.000,2021-09-16 10:11:33.897
16444,5,463,경기,15,6,9,1340,2020-03-30 09:00:00.000,2021-09-16 10:11:33.897
16445,1,36,강원,2,0,2,1339,2020-03-30 09:00:00.000,2021-09-16 10:11:33.897
16446,0,44,충북,3,1,2,1338,2020-03-30 09:00:00.000,2021-09-16 10:11:33.897
16447,0,127,충남,0,0,0,1337,2020-03-30 09:00:00.000,2021-09-16 10:11:33.897
16448,0,13,전북,1,0,1,1336,2020-03-30 09:00:00.000,2021-09-16 10:11:33.897
16449,0,9,전남,0,0,0,1335,2020-03-30 09:00:00.000,2021-09-16 10:11:33.897
16450,38,1298,경북,11,8,3,1334,2020-03-30 09:00:00.000,2021-09-16 10:11:33.897
16451,0,95,경남,1,0,1,1333,2020-03-30 09:00:00.000,2021-09-16 10:11:33.897
16452,0,9,제주,1,0,1,1332,2020-03-30 09:00:00.000,2021-09-16 10:11:33.897
16453,0,202,검역,13,0,13,1331,2020-03-30 09:00:00.000,2021-09-16 10:11:33.897
16454,152,9583,합계,105,38,67,1330,2020-03-29 09:00:00.000,2021-09-16 10:11:33.897
16455,0,410,서울,20,6,14,1329,2020-03-29 09:00:00.000,2021-09-16 10:11:33.897
16456,3,117,부산,3,0,3,1328,2020-03-29 09:00:00.000,2021-09-16 10:11:33.897
16457,106,6610,대구,23,23,0,1327,2020-03-29 09:00:00.000,2021-09-16 10:11:33.897
16458,0,58,인천,7,1,6,1326,2020-03-29 09:00:00.000,2021-09-16 10:11:33.897
16459,0,20,광주,0,0,0,1325,2020-03-29 09:00:00.000,2021-09-16 10:11:33.897
16460,0,34,대전,3,2,1,1324,2020-03-29 09:00:00.000,2021-09-16 10:11:33.897
16461,0,39,울산,0,0,0,1323,2020-03-29 09:00:00.000,2021-09-16 10:11:33.897
16462,0,46,세종,2,0,2,1322,2020-03-29 09:00:00.000,2021-09-16 10:11:33.897
16463,5,448,경기,15,3,12,1321,2020-03-29 09:00:00.000,2021-09-16 10:11:33.897
16464,1,34,강원,2,0,2,1320,2020-03-29 09:00:00.000,2021-09-16 10:11:33.897
16465,0,41,충북,0,0,0,1319,2020-03-29 09:00:00.000,2021-09-16 10:11:33.897
16466,0,127,충남,1,0,1,1318,2020-03-29 09:00:00.000,2021-09-16 10:11:33.897
16467,0,12,전북,2,0,2,1317,2020-03-29 09:00:00.000,2021-09-16 10:11:33.897
16468,0,9,전남,1,0,1,1316,2020-03-29 09:00:00.000,2021-09-16 10:11:33.897
16469,37,1287,경북,2,2,0,1315,2020-03-29 09:00:00.000,2021-09-16 10:11:33.897
16470,0,94,경남,3,1,2,1314,2020-03-29 09:00:00.000,2021-09-16 10:11:33.897
16471,0,8,제주,0,0,0,1313,2020-03-29 09:00:00.000,2021-09-16 10:11:33.897
16472,0,189,검역,21,0,21,1312,2020-03-29 09:00:00.000,2021-09-16 10:11:33.897
16473,144,9478,합계,146,90,56,1311,2020-03-28 09:00:00.000,2021-09-16 10:11:33.897
16474,0,390,서울,18,4,14,1310,2020-03-28 09:00:00.000,2021-09-16 10:11:33.897
16475,2,114,부산,1,0,1,1309,2020-03-28 09:00:00.000,2021-09-16 10:11:33.897
16476,101,6587,대구,71,70,1,1308,2020-03-28 09:00:00.000,2021-09-16 10:11:33.897
16477,0,51,인천,5,2,3,1307,2020-03-28 09:00:00.000,2021-09-16 10:11:33.897
16478,0,20,광주,0,0,0,1306,2020-03-28 09:00:00.000,2021-09-16 10:11:33.897
16479,0,31,대전,0,0,0,1305,2020-03-28 09:00:00.000,2021-09-16 10:11:33.897
16480,0,39,울산,0,0,0,1304,2020-03-28 09:00:00.000,2021-09-16 10:11:33.897
16481,0,44,세종,0,0,0,1303,2020-03-28 09:00:00.000,2021-09-16 10:11:33.897
16482,5,433,경기,21,11,10,1302,2020-03-28 09:00:00.000,2021-09-16 10:11:33.897
16483,1,32,강원,1,0,1,1301,2020-03-28 09:00:00.000,2021-09-16 10:11:33.897
16484,0,41,충북,0,0,0,1300,2020-03-28 09:00:00.000,2021-09-16 10:11:33.897
16485,0,126,충남,2,1,1,1299,2020-03-28 09:00:00.000,2021-09-16 10:11:33.897
16486,0,10,전북,0,0,0,1298,2020-03-28 09:00:00.000,2021-09-16 10:11:33.897
16487,0,8,전남,0,0,0,1297,2020-03-28 09:00:00.000,2021-09-16 10:11:33.897
16488,35,1285,경북,2,2,0,1296,2020-03-28 09:00:00.000,2021-09-16 10:11:33.897
16489,0,91,경남,0,0,0,1295,2020-03-28 09:00:00.000,2021-09-16 10:11:33.897
16490,0,8,제주,1,0,1,1294,2020-03-28 09:00:00.000,2021-09-16 10:11:33.897
16491,0,168,검역,24,0,24,1293,2020-03-28 09:00:00.000,2021-09-16 10:11:33.897
16492,139,9332,합계,91,57,34,1292,2020-03-27 09:00:00.000,2021-09-16 10:11:33.897
16493,0,372,서울,12,4,8,1291,2020-03-27 09:00:00.000,2021-09-16 10:11:33.897
16494,2,113,부산,1,0,1,1290,2020-03-27 09:00:00.000,2021-09-16 10:11:33.897
16495,98,6516,대구,34,34,0,1289,2020-03-27 09:00:00.000,2021-09-16 10:11:33.897
16496,0,46,인천,3,0,3,1288,2020-03-27 09:00:00.000,2021-09-16 10:11:33.897
16497,0,20,광주,1,0,1,1287,2020-03-27 09:00:00.000,2021-09-16 10:11:33.897
16498,0,31,대전,1,0,1,1286,2020-03-27 09:00:00.000,2021-09-16 10:11:33.897
16499,0,39,울산,2,0,2,1285,2020-03-27 09:00:00.000,2021-09-16 10:11:33.897
16500,0,44,세종,0,0,0,1284,2020-03-27 09:00:00.000,2021-09-16 10:11:33.897
16501,4,412,경기,11,9,2,1283,2020-03-27 09:00:00.000,2021-09-16 10:11:33.897
16502,1,31,강원,0,0,0,1282,2020-03-27 09:00:00.000,2021-09-16 10:11:33.897
16503,0,41,충북,2,1,1,1281,2020-03-27 09:00:00.000,2021-09-16 10:11:33.897
16504,0,124,충남,0,0,0,1280,2020-03-27 09:00:00.000,2021-09-16 10:11:33.897
16505,0,10,전북,0,0,0,1279,2020-03-27 09:00:00.000,2021-09-16 10:11:33.897
16506,0,8,전남,0,0,0,1278,2020-03-27 09:00:00.000,2021-09-16 10:11:33.897
16507,34,1283,경북,9,9,0,1277,2020-03-27 09:00:00.000,2021-09-16 10:11:33.897
16508,0,91,경남,1,0,1,1276,2020-03-27 09:00:00.000,2021-09-16 10:11:33.897
16509,0,7,제주,1,0,1,1275,2020-03-27 09:00:00.000,2021-09-16 10:11:33.897
16510,0,144,검역,13,0,13,1274,2020-03-27 09:00:00.000,2021-09-16 10:11:33.897
16511,131,9241,합계,104,56,48,1273,2020-03-26 09:00:00.000,2021-09-16 10:11:33.897
16512,0,360,서울,13,4,9,1272,2020-03-26 09:00:00.000,2021-09-16 10:11:33.897
16513,2,112,부산,0,0,0,1271,2020-03-26 09:00:00.000,2021-09-16 10:11:33.897
16514,94,6482,대구,26,26,0,1270,2020-03-26 09:00:00.000,2021-09-16 10:11:33.897
16515,0,43,인천,1,0,1,1269,2020-03-26 09:00:00.000,2021-09-16 10:11:33.897
16516,0,19,광주,0,0,0,1268,2020-03-26 09:00:00.000,2021-09-16 10:11:33.897
16517,0,30,대전,6,4,2,1267,2020-03-26 09:00:00.000,2021-09-16 10:11:33.897
16518,0,37,울산,0,0,0,1266,2020-03-26 09:00:00.000,2021-09-16 10:11:33.897
16519,0,44,세종,0,0,0,1265,2020-03-26 09:00:00.000,2021-09-16 10:11:33.897
16520,4,401,경기,14,10,4,1264,2020-03-26 09:00:00.000,2021-09-16 10:11:33.897
16521,1,31,강원,0,0,0,1263,2020-03-26 09:00:00.000,2021-09-16 10:11:33.897
16522,0,39,충북,1,0,1,1262,2020-03-26 09:00:00.000,2021-09-16 10:11:33.897
16523,0,124,충남,1,0,1,1261,2020-03-26 09:00:00.000,2021-09-16 10:11:33.897
16524,0,10,전북,0,0,0,1260,2020-03-26 09:00:00.000,2021-09-16 10:11:33.897
16525,0,8,전남,0,0,0,1259,2020-03-26 09:00:00.000,2021-09-16 10:11:33.897
16526,30,1274,경북,12,12,0,1258,2020-03-26 09:00:00.000,2021-09-16 10:11:33.897
16527,0,90,경남,0,0,0,1257,2020-03-26 09:00:00.000,2021-09-16 10:11:33.897
16528,0,6,제주,0,0,0,1256,2020-03-26 09:00:00.000,2021-09-16 10:11:33.897
16529,0,131,검역,30,0,30,1255,2020-03-26 09:00:00.000,2021-09-16 10:11:33.897
16530,126,9137,합계,100,42,58,1254,2020-03-25 09:00:00.000,2021-09-16 10:11:33.897
16531,0,347,서울,13,4,9,1253,2020-03-25 09:00:00.000,2021-09-16 10:11:33.897
16532,1,112,부산,1,0,1,1252,2020-03-25 09:00:00.000,2021-09-16 10:11:33.897
16533,92,6456,대구,14,14,0,1251,2020-03-25 09:00:00.000,2021-09-16 10:11:33.897
16534,0,42,인천,1,0,1,1250,2020-03-25 09:00:00.000,2021-09-16 10:11:33.897
16535,0,19,광주,0,0,0,1249,2020-03-25 09:00:00.000,2021-09-16 10:11:33.897
16536,0,24,대전,0,0,0,1248,2020-03-25 09:00:00.000,2021-09-16 10:11:33.897
16537,0,37,울산,1,0,1,1247,2020-03-25 09:00:00.000,2021-09-16 10:11:33.897
16538,0,44,세종,2,1,1,1246,2020-03-25 09:00:00.000,2021-09-16 10:11:33.897
16539,4,387,경기,21,15,6,1245,2020-03-25 09:00:00.000,2021-09-16 10:11:33.897
16540,1,31,강원,1,0,1,1244,2020-03-25 09:00:00.000,2021-09-16 10:11:33.897
16541,0,38,충북,0,0,0,1243,2020-03-25 09:00:00.000,2021-09-16 10:11:33.897
16542,0,123,충남,3,2,1,1242,2020-03-25 09:00:00.000,2021-09-16 10:11:33.897
16543,0,10,전북,0,0,0,1241,2020-03-25 09:00:00.000,2021-09-16 10:11:33.897
16544,0,8,전남,2,2,0,1240,2020-03-25 09:00:00.000,2021-09-16 10:11:33.897
16545,28,1262,경북,5,4,1,1239,2020-03-25 09:00:00.000,2021-09-16 10:11:33.897
16546,0,90,경남,0,0,0,1238,2020-03-25 09:00:00.000,2021-09-16 10:11:33.897
16547,0,6,제주,2,0,2,1237,2020-03-25 09:00:00.000,2021-09-16 10:11:33.897
16548,0,101,검역,34,0,34,1236,2020-03-25 09:00:00.000,2021-09-16 10:11:33.897
16549,120,9037,합계,76,46,30,1235,2020-03-24 09:00:00.000,2021-09-16 10:11:33.897
16550,0,334,서울,4,1,3,1234,2020-03-24 09:00:00.000,2021-09-16 10:11:33.897
16551,1,111,부산,2,2,0,1233,2020-03-24 09:00:00.000,2021-09-16 10:11:33.897
16552,88,6442,대구,31,31,0,1232,2020-03-24 09:00:00.000,2021-09-16 10:11:33.897
16553,0,41,인천,1,0,1,1231,2020-03-24 09:00:00.000,2021-09-16 10:11:33.897
16554,0,19,광주,0,0,0,1230,2020-03-24 09:00:00.000,2021-09-16 10:11:33.897
16555,0,24,대전,0,0,0,1229,2020-03-24 09:00:00.000,2021-09-16 10:11:33.897
16556,0,36,울산,0,0,0,1228,2020-03-24 09:00:00.000,2021-09-16 10:11:33.897
16557,0,42,세종,0,0,0,1227,2020-03-24 09:00:00.000,2021-09-16 10:11:33.897
16558,4,366,경기,15,9,6,1226,2020-03-24 09:00:00.000,2021-09-16 10:11:33.897
16559,1,30,강원,0,0,0,1225,2020-03-24 09:00:00.000,2021-09-16 10:11:33.897
16560,0,38,충북,1,1,0,1224,2020-03-24 09:00:00.000,2021-09-16 10:11:33.897
16561,0,120,충남,0,0,0,1223,2020-03-24 09:00:00.000,2021-09-16 10:11:33.897
16562,0,10,전북,0,0,0,1222,2020-03-24 09:00:00.000,2021-09-16 10:11:33.897
16563,0,6,전남,0,0,0,1221,2020-03-24 09:00:00.000,2021-09-16 10:11:33.897
16564,26,1257,경북,1,1,0,1220,2020-03-24 09:00:00.000,2021-09-16 10:11:33.897
16565,0,90,경남,1,1,0,1219,2020-03-24 09:00:00.000,2021-09-16 10:11:33.897
16566,0,4,제주,0,0,0,1218,2020-03-24 09:00:00.000,2021-09-16 10:11:33.897
16567,0,67,검역,20,0,20,1217,2020-03-24 09:00:00.000,2021-09-16 10:11:33.897
16568,111,8961,합계,64,46,18,1216,2020-03-23 09:00:00.000,2021-09-16 10:11:33.897
16569,0,330,서울,6,3,3,1215,2020-03-23 09:00:00.000,2021-09-16 10:11:33.897
16570,1,109,부산,1,1,0,1214,2020-03-23 09:00:00.000,2021-09-16 10:11:33.897
16571,82,6411,대구,24,24,0,1213,2020-03-23 09:00:00.000,2021-09-16 10:11:33.897
16572,0,40,인천,0,0,0,1212,2020-03-23 09:00:00.000,2021-09-16 10:11:33.897
16573,0,19,광주,0,0,0,1211,2020-03-23 09:00:00.000,2021-09-16 10:11:33.897
16574,0,24,대전,0,0,0,1210,2020-03-23 09:00:00.000,2021-09-16 10:11:33.897
16575,0,36,울산,0,0,0,1209,2020-03-23 09:00:00.000,2021-09-16 10:11:33.897
16576,0,42,세종,1,1,0,1208,2020-03-23 09:00:00.000,2021-09-16 10:11:33.897
16577,3,351,경기,14,12,2,1207,2020-03-23 09:00:00.000,2021-09-16 10:11:33.897
16578,1,30,강원,0,0,0,1206,2020-03-23 09:00:00.000,2021-09-16 10:11:33.897
16579,0,37,충북,2,2,0,1205,2020-03-23 09:00:00.000,2021-09-16 10:11:33.897
16580,0,120,충남,0,0,0,1204,2020-03-23 09:00:00.000,2021-09-16 10:11:33.897
16581,0,10,전북,0,0,0,1203,2020-03-23 09:00:00.000,2021-09-16 10:11:33.897
16582,0,6,전남,0,0,0,1202,2020-03-23 09:00:00.000,2021-09-16 10:11:33.897
16583,24,1256,경북,2,2,0,1201,2020-03-23 09:00:00.000,2021-09-16 10:11:33.897
16584,0,89,경남,1,1,0,1200,2020-03-23 09:00:00.000,2021-09-16 10:11:33.897
16585,0,4,제주,0,0,0,1199,2020-03-23 09:00:00.000,2021-09-16 10:11:33.897
16586,0,47,검역,13,0,13,1198,2020-03-23 09:00:00.000,2021-09-16 10:11:33.897
16587,104,8897,합계,98,77,21,1197,2020-03-22 09:00:00.000,2021-09-16 10:11:33.897
16588,0,324,서울,10,7,3,1196,2020-03-22 09:00:00.000,2021-09-16 10:11:33.897
16589,1,108,부산,0,0,0,1195,2020-03-22 09:00:00.000,2021-09-16 10:11:33.897
16590,75,6387,대구,43,43,0,1194,2020-03-22 09:00:00.000,2021-09-16 10:11:33.897
16591,0,40,인천,0,0,0,1193,2020-03-22 09:00:00.000,2021-09-16 10:11:33.897
16592,0,19,광주,1,0,1,1192,2020-03-22 09:00:00.000,2021-09-16 10:11:33.897
16593,0,24,대전,2,2,0,1191,2020-03-22 09:00:00.000,2021-09-16 10:11:33.897
16594,0,36,울산,0,0,0,1190,2020-03-22 09:00:00.000,2021-09-16 10:11:33.897
16595,0,41,세종,0,0,0,1189,2020-03-22 09:00:00.000,2021-09-16 10:11:33.897
16596,3,337,경기,16,12,4,1188,2020-03-22 09:00:00.000,2021-09-16 10:11:33.897
16597,1,30,강원,0,0,0,1187,2020-03-22 09:00:00.000,2021-09-16 10:11:33.897
16598,0,35,충북,1,1,0,1186,2020-03-22 09:00:00.000,2021-09-16 10:11:33.897
16599,0,120,충남,1,1,0,1185,2020-03-22 09:00:00.000,2021-09-16 10:11:33.897
16600,0,10,전북,0,0,0,1184,2020-03-22 09:00:00.000,2021-09-16 10:11:33.897
16601,0,6,전남,1,0,1,1183,2020-03-22 09:00:00.000,2021-09-16 10:11:33.897
16602,24,1254,경북,11,10,1,1182,2020-03-22 09:00:00.000,2021-09-16 10:11:33.897
16603,0,88,경남,1,1,0,1181,2020-03-22 09:00:00.000,2021-09-16 10:11:33.897
16604,0,4,제주,0,0,0,1180,2020-03-22 09:00:00.000,2021-09-16 10:11:33.897
16605,0,34,검역,11,0,11,1179,2020-03-22 09:00:00.000,2021-09-16 10:11:33.897
16606,102,8799,합계,147,126,21,1178,2020-03-21 09:00:00.000,2021-09-16 10:11:33.897
16607,0,314,서울,15,6,9,1177,2020-03-21 09:00:00.000,2021-09-16 10:11:33.897
16608,1,108,부산,0,0,0,1176,2020-03-21 09:00:00.000,2021-09-16 10:11:33.897
16609,73,6344,대구,69,69,0,1175,2020-03-21 09:00:00.000,2021-09-16 10:11:33.897
16610,0,40,인천,4,1,3,1174,2020-03-21 09:00:00.000,2021-09-16 10:11:33.897
16611,0,18,광주,0,0,0,1173,2020-03-21 09:00:00.000,2021-09-16 10:11:33.897
16612,0,22,대전,0,0,0,1172,2020-03-21 09:00:00.000,2021-09-16 10:11:33.897
16613,0,36,울산,0,0,0,1171,2020-03-21 09:00:00.000,2021-09-16 10:11:33.897
16614,0,41,세종,0,0,0,1170,2020-03-21 09:00:00.000,2021-09-16 10:11:33.897
16615,3,321,경기,12,9,3,1169,2020-03-21 09:00:00.000,2021-09-16 10:11:33.897
16616,1,30,강원,0,0,0,1168,2020-03-21 09:00:00.000,2021-09-16 10:11:33.897
16617,0,34,충북,1,1,0,1167,2020-03-21 09:00:00.000,2021-09-16 10:11:33.897
16618,0,119,충남,0,0,0,1166,2020-03-21 09:00:00.000,2021-09-16 10:11:33.897
16619,0,10,전북,0,0,0,1165,2020-03-21 09:00:00.000,2021-09-16 10:11:33.897
16620,0,5,전남,0,0,0,1164,2020-03-21 09:00:00.000,2021-09-16 10:11:33.897
16621,24,1243,경북,40,40,0,1163,2020-03-21 09:00:00.000,2021-09-16 10:11:33.897
16622,0,87,경남,0,0,0,1162,2020-03-21 09:00:00.000,2021-09-16 10:11:33.897
16623,0,4,제주,0,0,0,1161,2020-03-21 09:00:00.000,2021-09-16 10:11:33.897
16624,0,23,검역,6,0,6,1160,2020-03-21 09:00:00.000,2021-09-16 10:11:33.897
16625,94,8652,합계,87,73,14,1159,2020-03-20 09:00:00.000,2021-09-16 10:11:33.897
16626,0,299,서울,17,12,5,1158,2020-03-20 09:00:00.000,2021-09-16 10:11:33.897
16627,1,108,부산,1,1,0,1157,2020-03-20 09:00:00.000,2021-09-16 10:11:33.897
16628,67,6275,대구,34,34,0,1156,2020-03-20 09:00:00.000,2021-09-16 10:11:33.897
16629,0,36,인천,4,4,0,1155,2020-03-20 09:00:00.000,2021-09-16 10:11:33.897
16630,0,18,광주,1,1,0,1154,2020-03-20 09:00:00.000,2021-09-16 10:11:33.897
16631,0,22,대전,0,0,0,1153,2020-03-20 09:00:00.000,2021-09-16 10:11:33.897
16632,0,36,울산,0,0,0,1152,2020-03-20 09:00:00.000,2021-09-16 10:11:33.897
16633,0,41,세종,0,0,0,1151,2020-03-20 09:00:00.000,2021-09-16 10:11:33.897
16634,3,309,경기,14,7,7,1150,2020-03-20 09:00:00.000,2021-09-16 10:11:33.897
16635,1,30,강원,0,0,0,1149,2020-03-20 09:00:00.000,2021-09-16 10:11:33.897
16636,0,33,충북,0,0,0,1148,2020-03-20 09:00:00.000,2021-09-16 10:11:33.897
16637,0,119,충남,1,0,1,1147,2020-03-20 09:00:00.000,2021-09-16 10:11:33.897
16638,0,10,전북,0,0,0,1146,2020-03-20 09:00:00.000,2021-09-16 10:11:33.897
16639,0,5,전남,0,0,0,1145,2020-03-20 09:00:00.000,2021-09-16 10:11:33.897
16640,22,1203,경북,13,13,0,1144,2020-03-20 09:00:00.000,2021-09-16 10:11:33.897
16641,0,87,경남,1,1,0,1143,2020-03-20 09:00:00.000,2021-09-16 10:11:33.897
16642,0,4,제주,0,0,0,1142,2020-03-20 09:00:00.000,2021-09-16 10:11:33.897
16643,0,17,검역,1,0,1,1141,2020-03-20 09:00:00.000,2021-09-16 10:11:33.897
16644,91,8565,합계,152,135,17,1140,2020-03-19 09:00:00.000,2021-09-16 10:11:33.897
16645,0,282,서울,12,6,6,1139,2020-03-19 09:00:00.000,2021-09-16 10:11:33.897
16646,1,107,부산,0,0,0,1138,2020-03-19 09:00:00.000,2021-09-16 10:11:33.897
16647,65,6241,대구,97,97,0,1137,2020-03-19 09:00:00.000,2021-09-16 10:11:33.897
16648,0,32,인천,0,0,0,1136,2020-03-19 09:00:00.000,2021-09-16 10:11:33.897
16649,0,17,광주,0,0,0,1135,2020-03-19 09:00:00.000,2021-09-16 10:11:33.897
16650,0,22,대전,0,0,0,1134,2020-03-19 09:00:00.000,2021-09-16 10:11:33.897
16651,0,36,울산,6,3,3,1133,2020-03-19 09:00:00.000,2021-09-16 10:11:33.897
16652,0,41,세종,0,0,0,1132,2020-03-19 09:00:00.000,2021-09-16 10:11:33.897
16653,3,295,경기,18,15,3,1131,2020-03-19 09:00:00.000,2021-09-16 10:11:33.897
16654,1,30,강원,0,0,0,1130,2020-03-19 09:00:00.000,2021-09-16 10:11:33.897
16655,0,33,충북,1,1,0,1129,2020-03-19 09:00:00.000,2021-09-16 10:11:33.897
16656,0,118,충남,0,0,0,1128,2020-03-19 09:00:00.000,2021-09-16 10:11:33.897
16657,0,10,전북,1,1,0,1127,2020-03-19 09:00:00.000,2021-09-16 10:11:33.897
16658,0,5,전남,0,0,0,1126,2020-03-19 09:00:00.000,2021-09-16 10:11:33.897
16659,21,1190,경북,12,12,0,1125,2020-03-19 09:00:00.000,2021-09-16 10:11:33.897
16660,0,86,경남,0,0,0,1124,2020-03-19 09:00:00.000,2021-09-16 10:11:33.897
16661,0,4,제주,0,0,0,1123,2020-03-19 09:00:00.000,2021-09-16 10:11:33.897
16662,0,16,검역,5,0,5,1122,2020-03-19 09:00:00.000,2021-09-16 10:11:33.897
16663,84,8413,합계,93,80,13,1121,2020-03-18 09:00:00.000,2021-09-16 10:11:33.897
16664,0,270,서울,5,4,1,1120,2020-03-18 09:00:00.000,2021-09-16 10:11:33.897
16665,1,107,부산,0,0,0,1119,2020-03-18 09:00:00.000,2021-09-16 10:11:33.897
16666,58,6144,대구,46,46,0,1118,2020-03-18 09:00:00.000,2021-09-16 10:11:33.897
16667,0,32,인천,1,1,0,1117,2020-03-18 09:00:00.000,2021-09-16 10:11:33.897
16668,0,17,광주,1,1,0,1116,2020-03-18 09:00:00.000,2021-09-16 10:11:33.897
16669,0,22,대전,0,0,0,1115,2020-03-18 09:00:00.000,2021-09-16 10:11:33.897
16670,0,30,울산,2,0,2,1114,2020-03-18 09:00:00.000,2021-09-16 10:11:33.897
16671,0,41,세종,1,1,0,1113,2020-03-18 09:00:00.000,2021-09-16 10:11:33.897
16672,3,277,경기,15,14,1,1112,2020-03-18 09:00:00.000,2021-09-16 10:11:33.897
16673,1,30,강원,1,1,0,1111,2020-03-18 09:00:00.000,2021-09-16 10:11:33.897
16674,0,32,충북,1,1,0,1110,2020-03-18 09:00:00.000,2021-09-16 10:11:33.897
16675,0,118,충남,3,1,2,1109,2020-03-18 09:00:00.000,2021-09-16 10:11:33.897
16676,0,9,전북,2,0,2,1108,2020-03-18 09:00:00.000,2021-09-16 10:11:33.897
16677,0,5,전남,1,1,0,1107,2020-03-18 09:00:00.000,2021-09-16 10:11:33.897
16678,21,1178,경북,9,9,0,1106,2020-03-18 09:00:00.000,2021-09-16 10:11:33.897
16679,0,86,경남,0,0,0,1105,2020-03-18 09:00:00.000,2021-09-16 10:11:33.897
16680,0,4,제주,0,0,0,1104,2020-03-18 09:00:00.000,2021-09-16 10:11:33.897
16681,0,11,검역,5,0,5,1103,2020-03-18 09:00:00.000,2021-09-16 10:11:33.897
16682,81,8320,합계,84,79,5,1102,2020-03-17 09:00:00.000,2021-09-16 10:11:33.897
16683,0,265,서울,12,11,1,1101,2020-03-17 09:00:00.000,2021-09-16 10:11:33.897
16684,1,107,부산,0,0,0,1100,2020-03-17 09:00:00.000,2021-09-16 10:11:33.897
16685,57,6098,대구,32,32,0,1099,2020-03-17 09:00:00.000,2021-09-16 10:11:33.897
16686,0,31,인천,1,1,0,1098,2020-03-17 09:00:00.000,2021-09-16 10:11:33.897
16687,0,16,광주,0,0,0,1097,2020-03-17 09:00:00.000,2021-09-16 10:11:33.897
16688,0,22,대전,0,0,0,1096,2020-03-17 09:00:00.000,2021-09-16 10:11:33.897
16689,0,28,울산,0,0,0,1095,2020-03-17 09:00:00.000,2021-09-16 10:11:33.897
16690,0,40,세종,0,0,0,1094,2020-03-17 09:00:00.000,2021-09-16 10:11:33.897
16691,3,262,경기,31,30,1,1093,2020-03-17 09:00:00.000,2021-09-16 10:11:33.897
16692,1,29,강원,0,0,0,1092,2020-03-17 09:00:00.000,2021-09-16 10:11:33.897
16693,0,31,충북,0,0,0,1091,2020-03-17 09:00:00.000,2021-09-16 10:11:33.897
16694,0,115,충남,0,0,0,1090,2020-03-17 09:00:00.000,2021-09-16 10:11:33.897
16695,0,7,전북,0,0,0,1089,2020-03-17 09:00:00.000,2021-09-16 10:11:33.897
16696,0,4,전남,0,0,0,1088,2020-03-17 09:00:00.000,2021-09-16 10:11:33.897
16697,19,1169,경북,5,5,0,1087,2020-03-17 09:00:00.000,2021-09-16 10:11:33.897
16698,0,86,경남,1,0,1,1086,2020-03-17 09:00:00.000,2021-09-16 10:11:33.897
16699,0,4,제주,0,0,0,1085,2020-03-17 09:00:00.000,2021-09-16 10:11:33.897
16700,0,6,검역,2,0,2,1084,2020-03-17 09:00:00.000,2021-09-16 10:11:33.897
16701,75,8236,합계,74,70,4,1083,2020-03-16 09:00:00.000,2021-09-16 10:11:33.897
16702,0,253,서울,6,6,0,1082,2020-03-16 09:00:00.000,2021-09-16 10:11:33.897
16703,1,107,부산,1,1,0,1081,2020-03-16 09:00:00.000,2021-09-16 10:11:33.897
16704,53,6066,대구,35,35,0,1080,2020-03-16 09:00:00.000,2021-09-16 10:11:33.897
16705,0,30,인천,1,1,0,1079,2020-03-16 09:00:00.000,2021-09-16 10:11:33.897
16706,0,16,광주,0,0,0,1078,2020-03-16 09:00:00.000,2021-09-16 10:11:33.897
16707,0,22,대전,0,0,0,1077,2020-03-16 09:00:00.000,2021-09-16 10:11:33.897
16708,0,28,울산,0,0,0,1076,2020-03-16 09:00:00.000,2021-09-16 10:11:33.897
16709,0,40,세종,1,1,0,1075,2020-03-16 09:00:00.000,2021-09-16 10:11:33.897
16710,3,231,경기,20,19,1,1074,2020-03-16 09:00:00.000,2021-09-16 10:11:33.897
16711,1,29,강원,0,0,0,1073,2020-03-16 09:00:00.000,2021-09-16 10:11:33.897
16712,0,31,충북,0,0,0,1072,2020-03-16 09:00:00.000,2021-09-16 10:11:33.897
16713,0,115,충남,0,0,0,1071,2020-03-16 09:00:00.000,2021-09-16 10:11:33.897
16714,0,7,전북,0,0,0,1070,2020-03-16 09:00:00.000,2021-09-16 10:11:33.897
16715,0,4,전남,0,0,0,1069,2020-03-16 09:00:00.000,2021-09-16 10:11:33.897
16716,17,1164,경북,7,7,0,1068,2020-03-16 09:00:00.000,2021-09-16 10:11:33.897
16717,0,85,경남,0,0,0,1067,2020-03-16 09:00:00.000,2021-09-16 10:11:33.897
16718,0,4,제주,0,0,0,1066,2020-03-16 09:00:00.000,2021-09-16 10:11:33.897
16719,0,4,검역,3,0,3,1065,2020-03-16 09:00:00.000,2021-09-16 10:11:33.897
16720,75,8162,합계,76,72,4,1064,2020-03-15 09:00:00.000,2021-09-16 10:11:33.897
16721,0,247,서울,9,8,1,1063,2020-03-15 09:00:00.000,2021-09-16 10:11:33.897
16722,1,106,부산,3,3,0,1062,2020-03-15 09:00:00.000,2021-09-16 10:11:33.897
16723,53,6031,대구,41,41,0,1061,2020-03-15 09:00:00.000,2021-09-16 10:11:33.897
16724,0,29,인천,1,1,0,1060,2020-03-15 09:00:00.000,2021-09-16 10:11:33.897
16725,0,16,광주,1,0,1,1059,2020-03-15 09:00:00.000,2021-09-16 10:11:33.897
16726,0,22,대전,0,0,0,1058,2020-03-15 09:00:00.000,2021-09-16 10:11:33.897
16727,0,28,울산,1,1,0,1057,2020-03-15 09:00:00.000,2021-09-16 10:11:33.897
16728,0,39,세종,1,1,0,1056,2020-03-15 09:00:00.000,2021-09-16 10:11:33.897
16729,3,211,경기,11,11,0,1055,2020-03-15 09:00:00.000,2021-09-16 10:11:33.897
16730,1,29,강원,0,0,0,1054,2020-03-15 09:00:00.000,2021-09-16 10:11:33.897
16731,0,31,충북,3,3,0,1053,2020-03-15 09:00:00.000,2021-09-16 10:11:33.897
16732,0,115,충남,0,0,0,1052,2020-03-15 09:00:00.000,2021-09-16 10:11:33.897
16733,0,7,전북,0,0,0,1051,2020-03-15 09:00:00.000,2021-09-16 10:11:33.897
16734,0,4,전남,0,0,0,1050,2020-03-15 09:00:00.000,2021-09-16 10:11:33.897
16735,17,1157,경북,4,3,1,1049,2020-03-15 09:00:00.000,2021-09-16 10:11:33.897
16736,0,85,경남,0,0,0,1048,2020-03-15 09:00:00.000,2021-09-16 10:11:33.897
16737,0,4,제주,0,0,0,1047,2020-03-15 09:00:00.000,2021-09-16 10:11:33.897
16738,0,1,검역,1,0,1,1046,2020-03-15 09:00:00.000,2021-09-16 10:11:33.897
16739,72,8086,합계,107,102,5,1045,2020-03-14 09:00:00.000,2021-09-16 10:11:33.897
16740,0,238,서울,13,9,4,1044,2020-03-14 09:00:00.000,2021-09-16 10:11:33.897
16741,0,103,부산,3,3,0,1043,2020-03-14 09:00:00.000,2021-09-16 10:11:33.897
16742,51,5990,대구,62,62,0,1042,2020-03-14 09:00:00.000,2021-09-16 10:11:33.897
16743,0,28,인천,1,1,0,1041,2020-03-14 09:00:00.000,2021-09-16 10:11:33.897
16744,0,15,광주,0,0,0,1040,2020-03-14 09:00:00.000,2021-09-16 10:11:33.897
16745,0,22,대전,0,0,0,1039,2020-03-14 09:00:00.000,2021-09-16 10:11:33.897
16746,0,27,울산,0,0,0,1038,2020-03-14 09:00:00.000,2021-09-16 10:11:33.897
16747,0,38,세종,6,6,0,1037,2020-03-14 09:00:00.000,2021-09-16 10:11:33.897
16748,3,200,경기,15,14,1,1036,2020-03-14 09:00:00.000,2021-09-16 10:11:33.897
16749,1,29,강원,0,0,0,1035,2020-03-14 09:00:00.000,2021-09-16 10:11:33.897
16750,0,28,충북,1,1,0,1034,2020-03-14 09:00:00.000,2021-09-16 10:11:33.897
16751,0,115,충남,0,0,0,1033,2020-03-14 09:00:00.000,2021-09-16 10:11:33.897
16752,0,7,전북,0,0,0,1032,2020-03-14 09:00:00.000,2021-09-16 10:11:33.897
16753,0,4,전남,0,0,0,1031,2020-03-14 09:00:00.000,2021-09-16 10:11:33.897
16754,17,1153,경북,6,6,0,1030,2020-03-14 09:00:00.000,2021-09-16 10:11:33.897
16755,0,85,경남,0,0,0,1029,2020-03-14 09:00:00.000,2021-09-16 10:11:33.897
16756,0,4,제주,0,0,0,1028,2020-03-14 09:00:00.000,2021-09-16 10:11:33.897
16757,0,0,검역,0,0,0,1027,2020-03-14 09:00:00.000,2021-09-16 10:11:33.897
16758,67,7979,합계,110,107,3,1026,2020-03-13 09:00:00.000,2021-09-16 10:11:33.897
16759,0,225,서울,12,10,2,1025,2020-03-13 09:00:00.000,2021-09-16 10:11:33.897
16760,0,100,부산,1,1,0,1024,2020-03-13 09:00:00.000,2021-09-16 10:11:33.897
16761,48,5928,대구,61,61,0,1023,2020-03-13 09:00:00.000,2021-09-16 10:11:33.897
16762,0,27,인천,2,2,0,1022,2020-03-13 09:00:00.000,2021-09-16 10:11:33.897
16763,0,15,광주,0,0,0,1021,2020-03-13 09:00:00.000,2021-09-16 10:11:33.897
16764,0,22,대전,2,2,0,1020,2020-03-13 09:00:00.000,2021-09-16 10:11:33.897
16765,0,27,울산,2,2,0,1019,2020-03-13 09:00:00.000,2021-09-16 10:11:33.897
16766,0,32,세종,17,17,0,1018,2020-03-13 09:00:00.000,2021-09-16 10:11:33.897
16767,2,185,경기,8,7,1,1017,2020-03-13 09:00:00.000,2021-09-16 10:11:33.897
16768,1,29,강원,0,0,0,1016,2020-03-13 09:00:00.000,2021-09-16 10:11:33.897
16769,0,27,충북,0,0,0,1015,2020-03-13 09:00:00.000,2021-09-16 10:11:33.897
16770,0,115,충남,1,1,0,1014,2020-03-13 09:00:00.000,2021-09-16 10:11:33.897
16771,0,7,전북,0,0,0,1013,2020-03-13 09:00:00.000,2021-09-16 10:11:33.897
16772,0,4,전남,0,0,0,1012,2020-03-13 09:00:00.000,2021-09-16 10:11:33.897
16773,16,1147,경북,4,4,0,1011,2020-03-13 09:00:00.000,2021-09-16 10:11:33.897
16774,0,85,경남,0,0,0,1010,2020-03-13 09:00:00.000,2021-09-16 10:11:33.897
16775,0,4,제주,0,0,0,1009,2020-03-13 09:00:00.000,2021-09-16 10:11:33.897
16776,0,0,검역,0,0,0,1008,2020-03-13 09:00:00.000,2021-09-16 10:11:33.897
16777,66,7869,합계,114,112,2,1007,2020-03-12 09:00:00.000,2021-09-16 10:11:33.897
16778,0,213,서울,19,19,0,1006,2020-03-12 09:00:00.000,2021-09-16 10:11:33.897
16779,0,99,부산,2,2,0,1005,2020-03-12 09:00:00.000,2021-09-16 10:11:33.897
16780,48,5867,대구,72,71,1,1004,2020-03-12 09:00:00.000,2021-09-16 10:11:33.897
16781,0,25,인천,0,0,0,1003,2020-03-12 09:00:00.000,2021-09-16 10:11:33.897
16782,0,15,광주,0,0,0,1002,2020-03-12 09:00:00.000,2021-09-16 10:11:33.897
16783,0,20,대전,2,2,0,1001,2020-03-12 09:00:00.000,2021-09-16 10:11:33.897
16784,0,25,울산,0,0,0,1000,2020-03-12 09:00:00.000,2021-09-16 10:11:33.897
16785,0,15,세종,5,5,0,999,2020-03-12 09:00:00.000,2021-09-16 10:11:33.897
16786,1,177,경기,3,2,1,998,2020-03-12 09:00:00.000,2021-09-16 10:11:33.897
16787,1,29,강원,0,0,0,997,2020-03-12 09:00:00.000,2021-09-16 10:11:33.897
16788,0,27,충북,0,0,0,996,2020-03-12 09:00:00.000,2021-09-16 10:11:33.897
16789,0,114,충남,2,2,0,995,2020-03-12 09:00:00.000,2021-09-16 10:11:33.897
16790,0,7,전북,0,0,0,994,2020-03-12 09:00:00.000,2021-09-16 10:11:33.897
16791,0,4,전남,0,0,0,993,2020-03-12 09:00:00.000,2021-09-16 10:11:33.897
16792,16,1143,경북,8,8,0,992,2020-03-12 09:00:00.000,2021-09-16 10:11:33.897
16793,0,85,경남,1,1,0,991,2020-03-12 09:00:00.000,2021-09-16 10:11:33.897
16794,0,4,제주,0,0,0,990,2020-03-12 09:00:00.000,2021-09-16 10:11:33.897
16795,0,0,검역,0,0,0,989,2020-03-12 09:00:00.000,2021-09-16 10:11:33.897
16796,60,7755,합계,242,239,3,988,2020-03-11 09:00:00.000,2021-09-16 10:11:33.897
16797,0,194,서울,53,51,2,987,2020-03-11 09:00:00.000,2021-09-16 10:11:33.897
16798,0,97,부산,2,1,1,986,2020-03-11 09:00:00.000,2021-09-16 10:11:33.897
16799,44,5795,대구,131,131,0,985,2020-03-11 09:00:00.000,2021-09-16 10:11:33.897
16800,0,25,인천,12,12,0,984,2020-03-11 09:00:00.000,2021-09-16 10:11:33.897
16801,0,15,광주,0,0,0,983,2020-03-11 09:00:00.000,2021-09-16 10:11:33.897
16802,0,18,대전,0,0,0,982,2020-03-11 09:00:00.000,2021-09-16 10:11:33.897
16803,0,25,울산,1,1,0,981,2020-03-11 09:00:00.000,2021-09-16 10:11:33.897
16804,0,10,세종,2,2,0,980,2020-03-11 09:00:00.000,2021-09-16 10:11:33.897
16805,1,174,경기,11,11,0,979,2020-03-11 09:00:00.000,2021-09-16 10:11:33.897
16806,1,29,강원,1,1,0,978,2020-03-11 09:00:00.000,2021-09-16 10:11:33.897
16807,0,27,충북,2,2,0,977,2020-03-11 09:00:00.000,2021-09-16 10:11:33.897
16808,0,112,충남,8,8,0,976,2020-03-11 09:00:00.000,2021-09-16 10:11:33.897
16809,0,7,전북,0,0,0,975,2020-03-11 09:00:00.000,2021-09-16 10:11:33.897
16810,0,4,전남,0,0,0,974,2020-03-11 09:00:00.000,2021-09-16 10:11:33.897
16811,14,1135,경북,18,18,0,973,2020-03-11 09:00:00.000,2021-09-16 10:11:33.897
16812,0,84,경남,1,1,0,972,2020-03-11 09:00:00.000,2021-09-16 10:11:33.897
16813,0,4,제주,0,0,0,971,2020-03-11 09:00:00.000,2021-09-16 10:11:33.897
16814,0,0,검역,0,0,0,970,2020-03-11 09:00:00.000,2021-09-16 10:11:33.897
16815,54,7513,합계,131,131,0,969,2020-03-10 09:00:00.000,2021-09-16 10:11:33.897
16816,0,141,서울,11,11,0,968,2020-03-10 09:00:00.000,2021-09-16 10:11:33.897
16817,0,95,부산,0,0,0,967,2020-03-10 09:00:00.000,2021-09-16 10:11:33.897
16818,38,5664,대구,92,92,0,966,2020-03-10 09:00:00.000,2021-09-16 10:11:33.897
16819,0,13,인천,4,4,0,965,2020-03-10 09:00:00.000,2021-09-16 10:11:33.897
16820,0,15,광주,0,0,0,964,2020-03-10 09:00:00.000,2021-09-16 10:11:33.897
16821,0,18,대전,0,0,0,963,2020-03-10 09:00:00.000,2021-09-16 10:11:33.897
16822,0,24,울산,0,0,0,962,2020-03-10 09:00:00.000,2021-09-16 10:11:33.897
16823,0,8,세종,2,2,0,961,2020-03-10 09:00:00.000,2021-09-16 10:11:33.897
16824,1,163,경기,10,10,0,960,2020-03-10 09:00:00.000,2021-09-16 10:11:33.897
16825,1,28,강원,0,0,0,959,2020-03-10 09:00:00.000,2021-09-16 10:11:33.897
16826,0,25,충북,0,0,0,958,2020-03-10 09:00:00.000,2021-09-16 10:11:33.897
16827,0,104,충남,2,2,0,957,2020-03-10 09:00:00.000,2021-09-16 10:11:33.897
16828,0,7,전북,0,0,0,956,2020-03-10 09:00:00.000,2021-09-16 10:11:33.897
16829,0,4,전남,0,0,0,955,2020-03-10 09:00:00.000,2021-09-16 10:11:33.897
16830,14,1117,경북,10,10,0,954,2020-03-10 09:00:00.000,2021-09-16 10:11:33.897
16831,0,83,경남,0,0,0,953,2020-03-10 09:00:00.000,2021-09-16 10:11:33.897
16832,0,4,제주,0,0,0,952,2020-03-10 09:00:00.000,2021-09-16 10:11:33.897
16833,0,0,검역,0,0,0,951,2020-03-10 09:00:00.000,2021-09-16 10:11:33.897
16834,51,7382,합계,248,247,1,950,2020-03-09 09:00:00.000,2021-09-16 10:11:33.897
16835,0,130,서울,10,10,0,949,2020-03-09 09:00:00.000,2021-09-16 10:11:33.897
16836,0,95,부산,0,0,0,948,2020-03-09 09:00:00.000,2021-09-16 10:11:33.897
16837,35,5572,대구,190,190,0,947,2020-03-09 09:00:00.000,2021-09-16 10:11:33.897
16838,0,9,인천,0,0,0,946,2020-03-09 09:00:00.000,2021-09-16 10:11:33.897
16839,0,15,광주,2,2,0,945,2020-03-09 09:00:00.000,2021-09-16 10:11:33.897
16840,0,18,대전,0,0,0,944,2020-03-09 09:00:00.000,2021-09-16 10:11:33.897
16841,0,24,울산,0,0,0,943,2020-03-09 09:00:00.000,2021-09-16 10:11:33.897
16842,0,6,세종,3,3,0,942,2020-03-09 09:00:00.000,2021-09-16 10:11:33.897
16843,1,153,경기,12,11,1,941,2020-03-09 09:00:00.000,2021-09-16 10:11:33.897
16844,1,28,강원,1,1,0,940,2020-03-09 09:00:00.000,2021-09-16 10:11:33.897
16845,0,25,충북,1,1,0,939,2020-03-09 09:00:00.000,2021-09-16 10:11:33.897
16846,0,102,충남,4,4,0,938,2020-03-09 09:00:00.000,2021-09-16 10:11:33.897
16847,0,7,전북,0,0,0,937,2020-03-09 09:00:00.000,2021-09-16 10:11:33.897
16848,0,4,전남,0,0,0,936,2020-03-09 09:00:00.000,2021-09-16 10:11:33.897
16849,14,1107,경북,25,25,0,935,2020-03-09 09:00:00.000,2021-09-16 10:11:33.897
16850,0,83,경남,0,0,0,934,2020-03-09 09:00:00.000,2021-09-16 10:11:33.897
16851,0,4,제주,0,0,0,933,2020-03-09 09:00:00.000,2021-09-16 10:11:33.897
16852,0,0,검역,0,0,0,932,2020-03-09 09:00:00.000,2021-09-16 10:11:33.897
16853,50,7134,합계,367,366,1,931,2020-03-08 09:00:00.000,2021-09-16 10:11:33.897
16854,0,120,서울,12,11,1,930,2020-03-08 09:00:00.000,2021-09-16 10:11:33.897
16855,0,95,부산,1,1,0,929,2020-03-08 09:00:00.000,2021-09-16 10:11:33.897
16856,35,5382,대구,297,297,0,928,2020-03-08 09:00:00.000,2021-09-16 10:11:33.897
16857,0,9,인천,0,0,0,927,2020-03-08 09:00:00.000,2021-09-16 10:11:33.897
16858,0,13,광주,0,0,0,926,2020-03-08 09:00:00.000,2021-09-16 10:11:33.897
16859,0,18,대전,0,0,0,925,2020-03-08 09:00:00.000,2021-09-16 10:11:33.897
16860,0,24,울산,1,1,0,924,2020-03-08 09:00:00.000,2021-09-16 10:11:33.897
16861,0,3,세종,1,1,0,923,2020-03-08 09:00:00.000,2021-09-16 10:11:33.897
16862,1,141,경기,11,11,0,922,2020-03-08 09:00:00.000,2021-09-16 10:11:33.897
16863,1,27,강원,1,1,0,921,2020-03-08 09:00:00.000,2021-09-16 10:11:33.897
16864,0,24,충북,4,4,0,920,2020-03-08 09:00:00.000,2021-09-16 10:11:33.897
16865,0,98,충남,6,6,0,919,2020-03-08 09:00:00.000,2021-09-16 10:11:33.897
16866,0,7,전북,0,0,0,918,2020-03-08 09:00:00.000,2021-09-16 10:11:33.897
16867,0,4,전남,0,0,0,917,2020-03-08 09:00:00.000,2021-09-16 10:11:33.897
16868,13,1082,경북,32,32,0,916,2020-03-08 09:00:00.000,2021-09-16 10:11:33.897
16869,0,83,경남,1,1,0,915,2020-03-08 09:00:00.000,2021-09-16 10:11:33.897
16870,0,4,제주,0,0,0,914,2020-03-08 09:00:00.000,2021-09-16 10:11:33.897
16871,0,0,검역,0,0,0,913,2020-03-08 09:00:00.000,2021-09-16 10:11:33.897
16872,44,6767,합계,483,483,0,912,2020-03-07 09:00:00.000,2021-09-16 10:11:33.897
16873,0,108,서울,3,3,0,911,2020-03-07 09:00:00.000,2021-09-16 10:11:33.897
16874,0,94,부산,1,1,0,910,2020-03-07 09:00:00.000,2021-09-16 10:11:33.897
16875,31,5085,대구,390,390,0,909,2020-03-07 09:00:00.000,2021-09-16 10:11:33.897
16876,0,9,인천,0,0,0,908,2020-03-07 09:00:00.000,2021-09-16 10:11:33.897
16877,0,13,광주,0,0,0,907,2020-03-07 09:00:00.000,2021-09-16 10:11:33.897
16878,0,18,대전,0,0,0,906,2020-03-07 09:00:00.000,2021-09-16 10:11:33.897
16879,0,23,울산,0,0,0,905,2020-03-07 09:00:00.000,2021-09-16 10:11:33.897
16880,0,2,세종,1,1,0,904,2020-03-07 09:00:00.000,2021-09-16 10:11:33.897
16881,1,130,경기,10,10,0,903,2020-03-07 09:00:00.000,2021-09-16 10:11:33.897
16882,1,26,강원,1,1,0,902,2020-03-07 09:00:00.000,2021-09-16 10:11:33.897
16883,0,20,충북,5,5,0,901,2020-03-07 09:00:00.000,2021-09-16 10:11:33.897
16884,0,92,충남,2,2,0,900,2020-03-07 09:00:00.000,2021-09-16 10:11:33.897
16885,0,7,전북,0,0,0,899,2020-03-07 09:00:00.000,2021-09-16 10:11:33.897
16886,0,4,전남,0,0,0,898,2020-03-07 09:00:00.000,2021-09-16 10:11:33.897
16887,11,1050,경북,65,65,0,897,2020-03-07 09:00:00.000,2021-09-16 10:11:33.897
16888,0,82,경남,5,5,0,896,2020-03-07 09:00:00.000,2021-09-16 10:11:33.897
16889,0,4,제주,0,0,0,895,2020-03-07 09:00:00.000,2021-09-16 10:11:33.897
16890,0,0,검역,0,0,0,894,2020-03-07 09:00:00.000,2021-09-16 10:11:33.897
16891,42,6284,합계,518,518,0,893,2020-03-06 09:00:00.000,2021-09-16 10:11:33.897
16892,0,105,서울,2,2,0,892,2020-03-06 09:00:00.000,2021-09-16 10:11:33.897
16893,0,93,부산,3,3,0,891,2020-03-06 09:00:00.000,2021-09-16 10:11:33.897
16894,30,4695,대구,367,367,0,890,2020-03-06 09:00:00.000,2021-09-16 10:11:33.897
16895,0,9,인천,0,0,0,889,2020-03-06 09:00:00.000,2021-09-16 10:11:33.897
16896,0,13,광주,0,0,0,888,2020-03-06 09:00:00.000,2021-09-16 10:11:33.897
16897,0,18,대전,2,2,0,887,2020-03-06 09:00:00.000,2021-09-16 10:11:33.897
16898,0,23,울산,0,0,0,886,2020-03-06 09:00:00.000,2021-09-16 10:11:33.897
16899,0,1,세종,0,0,0,885,2020-03-06 09:00:00.000,2021-09-16 10:11:33.897
16900,1,120,경기,10,10,0,884,2020-03-06 09:00:00.000,2021-09-16 10:11:33.897
16901,0,25,강원,2,2,0,883,2020-03-06 09:00:00.000,2021-09-16 10:11:33.897
16902,0,15,충북,3,3,0,882,2020-03-06 09:00:00.000,2021-09-16 10:11:33.897
16903,0,90,충남,4,4,0,881,2020-03-06 09:00:00.000,2021-09-16 10:11:33.897
16904,0,7,전북,0,0,0,880,2020-03-06 09:00:00.000,2021-09-16 10:11:33.897
16905,0,4,전남,0,0,0,879,2020-03-06 09:00:00.000,2021-09-16 10:11:33.897
16906,11,985,경북,122,122,0,878,2020-03-06 09:00:00.000,2021-09-16 10:11:33.897
16907,0,77,경남,3,3,0,877,2020-03-06 09:00:00.000,2021-09-16 10:11:33.897
16908,0,4,제주,0,0,0,876,2020-03-06 09:00:00.000,2021-09-16 10:11:33.897
16909,0,0,검역,0,0,0,875,2020-03-06 09:00:00.000,2021-09-16 10:11:33.897
16910,35,5766,합계,438,437,1,874,2020-03-05 09:00:00.000,2021-09-16 10:11:33.897
16911,0,103,서울,5,4,1,873,2020-03-05 09:00:00.000,2021-09-16 10:11:33.897
16912,0,90,부산,0,0,0,872,2020-03-05 09:00:00.000,2021-09-16 10:11:33.897
16913,27,4328,대구,326,326,0,871,2020-03-05 09:00:00.000,2021-09-16 10:11:33.897
16914,0,9,인천,1,1,0,870,2020-03-05 09:00:00.000,2021-09-16 10:11:33.897
16915,0,13,광주,0,0,0,869,2020-03-05 09:00:00.000,2021-09-16 10:11:33.897
16916,0,16,대전,1,1,0,868,2020-03-05 09:00:00.000,2021-09-16 10:11:33.897
16917,0,23,울산,0,0,0,867,2020-03-05 09:00:00.000,2021-09-16 10:11:33.897
16918,0,1,세종,0,0,0,866,2020-03-05 09:00:00.000,2021-09-16 10:11:33.897
16919,1,110,경기,7,7,0,865,2020-03-05 09:00:00.000,2021-09-16 10:11:33.897
16920,0,23,강원,2,2,0,864,2020-03-05 09:00:00.000,2021-09-16 10:11:33.897
16921,0,12,충북,1,1,0,863,2020-03-05 09:00:00.000,2021-09-16 10:11:33.897
16922,0,86,충남,4,4,0,862,2020-03-05 09:00:00.000,2021-09-16 10:11:33.897
16923,0,7,전북,0,0,0,861,2020-03-05 09:00:00.000,2021-09-16 10:11:33.897
16924,0,4,전남,0,0,0,860,2020-03-05 09:00:00.000,2021-09-16 10:11:33.897
16925,7,863,경북,81,81,0,859,2020-03-05 09:00:00.000,2021-09-16 10:11:33.897
16926,0,74,경남,9,9,0,858,2020-03-05 09:00:00.000,2021-09-16 10:11:33.897
16927,0,4,제주,1,1,0,857,2020-03-05 09:00:00.000,2021-09-16 10:11:33.897
16928,0,0,검역,0,0,0,856,2020-03-05 09:00:00.000,2021-09-16 10:11:33.897
16929,32,5328,합계,516,516,0,855,2020-03-04 09:00:00.000,2021-09-16 10:11:33.897
16930,0,98,서울,0,0,0,854,2020-03-04 09:00:00.000,2021-09-16 10:11:33.897
16931,0,90,부산,3,3,0,853,2020-03-04 09:00:00.000,2021-09-16 10:11:33.897
16932,24,4002,대구,398,398,0,852,2020-03-04 09:00:00.000,2021-09-16 10:11:33.897
16933,0,8,인천,1,1,0,851,2020-03-04 09:00:00.000,2021-09-16 10:11:33.897
16934,0,13,광주,2,2,0,850,2020-03-04 09:00:00.000,2021-09-16 10:11:33.897
16935,0,15,대전,1,1,0,849,2020-03-04 09:00:00.000,2021-09-16 10:11:33.897
16936,0,23,울산,3,3,0,848,2020-03-04 09:00:00.000,2021-09-16 10:11:33.897
16937,0,1,세종,0,0,0,847,2020-03-04 09:00:00.000,2021-09-16 10:11:33.897
16938,1,103,경기,9,9,0,846,2020-03-04 09:00:00.000,2021-09-16 10:11:33.897
16939,0,21,강원,1,1,0,845,2020-03-04 09:00:00.000,2021-09-16 10:11:33.897
16940,0,11,충북,0,0,0,844,2020-03-04 09:00:00.000,2021-09-16 10:11:33.897
16941,0,82,충남,1,1,0,843,2020-03-04 09:00:00.000,2021-09-16 10:11:33.897
16942,0,7,전북,0,0,0,842,2020-03-04 09:00:00.000,2021-09-16 10:11:33.897
16943,0,4,전남,0,0,0,841,2020-03-04 09:00:00.000,2021-09-16 10:11:33.897
16944,7,782,경북,95,95,0,840,2020-03-04 09:00:00.000,2021-09-16 10:11:33.897
16945,0,65,경남,2,2,0,839,2020-03-04 09:00:00.000,2021-09-16 10:11:33.897
16946,0,3,제주,0,0,0,838,2020-03-04 09:00:00.000,2021-09-16 10:11:33.897
16947,0,0,검역,0,0,0,837,2020-03-04 09:00:00.000,2021-09-16 10:11:33.897
16948,28,4812,합계,600,599,1,836,2020-03-03 09:00:00.000,2021-09-16 10:11:33.897
16949,0,98,서울,7,7,0,835,2020-03-03 09:00:00.000,2021-09-16 10:11:33.897
16950,0,87,부산,2,2,0,834,2020-03-03 09:00:00.000,2021-09-16 10:11:33.897
16951,20,3604,대구,520,520,0,833,2020-03-03 09:00:00.000,2021-09-16 10:11:33.897
16952,0,7,인천,0,0,0,832,2020-03-03 09:00:00.000,2021-09-16 10:11:33.897
16953,0,11,광주,2,1,1,831,2020-03-03 09:00:00.000,2021-09-16 10:11:33.897
16954,0,14,대전,0,0,0,830,2020-03-03 09:00:00.000,2021-09-16 10:11:33.897
16955,0,20,울산,0,0,0,829,2020-03-03 09:00:00.000,2021-09-16 10:11:33.897
16956,0,1,세종,0,0,0,828,2020-03-03 09:00:00.000,2021-09-16 10:11:33.897
16957,1,94,경기,2,2,0,827,2020-03-03 09:00:00.000,2021-09-16 10:11:33.897
16958,0,20,강원,1,1,0,826,2020-03-03 09:00:00.000,2021-09-16 10:11:33.897
16959,0,11,충북,0,0,0,825,2020-03-03 09:00:00.000,2021-09-16 10:11:33.897
16960,0,81,충남,4,4,0,824,2020-03-03 09:00:00.000,2021-09-16 10:11:33.897
16961,0,7,전북,1,1,0,823,2020-03-03 09:00:00.000,2021-09-16 10:11:33.897
16962,0,4,전남,0,0,0,822,2020-03-03 09:00:00.000,2021-09-16 10:11:33.897
16963,7,687,경북,59,59,0,821,2020-03-03 09:00:00.000,2021-09-16 10:11:33.897
16964,0,63,경남,1,1,0,820,2020-03-03 09:00:00.000,2021-09-16 10:11:33.897
16965,0,3,제주,1,1,0,819,2020-03-03 09:00:00.000,2021-09-16 10:11:33.897
16966,0,0,검역,0,0,0,818,2020-03-03 09:00:00.000,2021-09-16 10:11:33.897
16967,23,4212,합계,686,684,2,817,2020-03-02 09:00:00.000,2021-09-16 10:11:33.897
16968,0,91,서울,9,8,1,816,2020-03-02 09:00:00.000,2021-09-16 10:11:33.897
16969,0,85,부산,6,6,0,815,2020-03-02 09:00:00.000,2021-09-16 10:11:33.897
16970,15,3084,대구,517,517,0,814,2020-03-02 09:00:00.000,2021-09-16 10:11:33.897
16971,0,7,인천,1,1,0,813,2020-03-02 09:00:00.000,2021-09-16 10:11:33.897
16972,0,9,광주,0,0,0,812,2020-03-02 09:00:00.000,2021-09-16 10:11:33.897
16973,0,14,대전,1,1,0,811,2020-03-02 09:00:00.000,2021-09-16 10:11:33.897
16974,0,20,울산,3,3,0,810,2020-03-02 09:00:00.000,2021-09-16 10:11:33.897
16975,0,1,세종,0,0,0,809,2020-03-02 09:00:00.000,2021-09-16 10:11:33.897
16976,1,92,경기,8,8,0,808,2020-03-02 09:00:00.000,2021-09-16 10:11:33.897
16977,0,19,강원,12,11,1,807,2020-03-02 09:00:00.000,2021-09-16 10:11:33.897
16978,0,11,충북,0,0,0,806,2020-03-02 09:00:00.000,2021-09-16 10:11:33.897
16979,0,77,충남,17,17,0,805,2020-03-02 09:00:00.000,2021-09-16 10:11:33.897
16980,0,6,전북,1,1,0,804,2020-03-02 09:00:00.000,2021-09-16 10:11:33.897
16981,0,4,전남,1,1,0,803,2020-03-02 09:00:00.000,2021-09-16 10:11:33.897
16982,7,628,경북,108,108,0,802,2020-03-02 09:00:00.000,2021-09-16 10:11:33.897
16983,0,62,경남,2,2,0,801,2020-03-02 09:00:00.000,2021-09-16 10:11:33.897
16984,0,2,제주,0,0,0,800,2020-03-02 09:00:00.000,2021-09-16 10:11:33.897
16985,0,0,검역,0,0,0,799,2020-03-02 09:00:00.000,2021-09-16 10:11:33.897
16986,17,3526,합계,595,593,2,798,2020-03-01 09:00:00.000,2021-09-16 10:11:33.897
16987,0,82,서울,8,6,2,797,2020-03-01 09:00:00.000,2021-09-16 10:11:33.897
16988,0,79,부산,4,4,0,796,2020-03-01 09:00:00.000,2021-09-16 10:11:33.897
16989,9,2567,대구,512,512,0,795,2020-03-01 09:00:00.000,2021-09-16 10:11:33.897
16990,0,6,인천,0,0,0,794,2020-03-01 09:00:00.000,2021-09-16 10:11:33.897
16991,0,9,광주,0,0,0,793,2020-03-01 09:00:00.000,2021-09-16 10:11:33.897
16992,0,13,대전,0,0,0,792,2020-03-01 09:00:00.000,2021-09-16 10:11:33.897
16993,0,17,울산,0,0,0,791,2020-03-01 09:00:00.000,2021-09-16 10:11:33.897
16994,0,1,세종,0,0,0,790,2020-03-01 09:00:00.000,2021-09-16 10:11:33.897
16995,1,84,경기,8,8,0,789,2020-03-01 09:00:00.000,2021-09-16 10:11:33.897
16996,0,7,강원,0,0,0,788,2020-03-01 09:00:00.000,2021-09-16 10:11:33.897
16997,0,11,충북,1,1,0,787,2020-03-01 09:00:00.000,2021-09-16 10:11:33.897
16998,0,60,충남,12,12,0,786,2020-03-01 09:00:00.000,2021-09-16 10:11:33.897
16999,0,5,전북,0,0,0,785,2020-03-01 09:00:00.000,2021-09-16 10:11:33.897
17000,0,3,전남,1,1,0,784,2020-03-01 09:00:00.000,2021-09-16 10:11:33.897
17001,7,520,경북,48,48,0,783,2020-03-01 09:00:00.000,2021-09-16 10:11:33.897
17002,0,60,경남,1,1,0,782,2020-03-01 09:00:00.000,2021-09-16 10:11:33.897
17003,0,2,제주,0,0,0,781,2020-03-01 09:00:00.000,2021-09-16 10:11:33.897
17004,0,0,검역,0,0,0,780,2020-03-01 09:00:00.000,2021-09-16 10:11:33.897
17005,16,2931,합계,909,909,0,779,2020-02-29 09:00:00.000,2021-09-16 10:11:33.897
17006,0,74,서울,12,12,0,778,2020-02-29 09:00:00.000,2021-09-16 10:11:33.897
17007,0,75,부산,14,14,0,777,2020-02-29 09:00:00.000,2021-09-16 10:11:33.897
17008,8,2055,대구,742,742,0,776,2020-02-29 09:00:00.000,2021-09-16 10:11:33.897
17009,0,6,인천,2,2,0,775,2020-02-29 09:00:00.000,2021-09-16 10:11:33.897
17010,0,9,광주,0,0,0,774,2020-02-29 09:00:00.000,2021-09-16 10:11:33.897
17011,0,13,대전,1,1,0,773,2020-02-29 09:00:00.000,2021-09-16 10:11:33.897
17012,0,17,울산,6,6,0,772,2020-02-29 09:00:00.000,2021-09-16 10:11:33.897
17013,0,1,세종,0,0,0,771,2020-02-29 09:00:00.000,2021-09-16 10:11:33.897
17014,1,76,경기,10,10,0,770,2020-02-29 09:00:00.000,2021-09-16 10:11:33.897
17015,0,7,강원,1,1,0,769,2020-02-29 09:00:00.000,2021-09-16 10:11:33.897
17016,0,10,충북,0,0,0,768,2020-02-29 09:00:00.000,2021-09-16 10:11:33.897
17017,0,48,충남,32,32,0,767,2020-02-29 09:00:00.000,2021-09-16 10:11:33.897
17018,0,5,전북,0,0,0,766,2020-02-29 09:00:00.000,2021-09-16 10:11:33.897
17019,0,2,전남,1,1,0,765,2020-02-29 09:00:00.000,2021-09-16 10:11:33.897
17020,7,472,경북,75,75,0,764,2020-02-29 09:00:00.000,2021-09-16 10:11:33.897
17021,0,59,경남,13,13,0,763,2020-02-29 09:00:00.000,2021-09-16 10:11:33.897
17022,0,2,제주,0,0,0,762,2020-02-29 09:00:00.000,2021-09-16 10:11:33.897
17023,0,0,검역,0,0,0,761,2020-02-29 09:00:00.000,2021-09-16 10:11:33.897
17024,13,2022,합계,427,427,0,760,2020-02-28 09:00:00.000,2021-09-16 10:11:33.897
17025,0,62,서울,7,7,0,759,2020-02-28 09:00:00.000,2021-09-16 10:11:33.897
17026,0,61,부산,5,5,0,758,2020-02-28 09:00:00.000,2021-09-16 10:11:33.897
17027,5,1313,대구,296,296,0,757,2020-02-28 09:00:00.000,2021-09-16 10:11:33.897
17028,0,4,인천,1,1,0,756,2020-02-28 09:00:00.000,2021-09-16 10:11:33.897
17029,0,9,광주,0,0,0,755,2020-02-28 09:00:00.000,2021-09-16 10:11:33.897
17030,0,12,대전,4,4,0,754,2020-02-28 09:00:00.000,2021-09-16 10:11:33.897
17031,0,11,울산,5,5,0,753,2020-02-28 09:00:00.000,2021-09-16 10:11:33.897
17032,0,1,세종,0,0,0,752,2020-02-28 09:00:00.000,2021-09-16 10:11:33.897
17033,1,66,경기,11,11,0,751,2020-02-28 09:00:00.000,2021-09-16 10:11:33.897
17034,0,6,강원,0,0,0,750,2020-02-28 09:00:00.000,2021-09-16 10:11:33.897
17035,0,10,충북,3,3,0,749,2020-02-28 09:00:00.000,2021-09-16 10:11:33.897
17036,0,16,충남,9,9,0,748,2020-02-28 09:00:00.000,2021-09-16 10:11:33.897
17037,0,5,전북,2,2,0,747,2020-02-28 09:00:00.000,2021-09-16 10:11:33.897
17038,0,1,전남,0,0,0,746,2020-02-28 09:00:00.000,2021-09-16 10:11:33.897
17039,7,397,경북,74,74,0,745,2020-02-28 09:00:00.000,2021-09-16 10:11:33.897
17040,0,46,경남,10,10,0,744,2020-02-28 09:00:00.000,2021-09-16 10:11:33.897
17041,0,2,제주,0,0,0,743,2020-02-28 09:00:00.000,2021-09-16 10:11:33.897
17042,0,0,검역,0,0,0,742,2020-02-28 09:00:00.000,2021-09-16 10:11:33.897
17043,12,1595,합계,449,447,2,741,2020-02-27 09:00:00.000,2021-09-16 10:11:33.897
17044,0,55,서울,10,8,2,740,2020-02-27 09:00:00.000,2021-09-16 10:11:33.897
17045,0,56,부산,8,8,0,739,2020-02-27 09:00:00.000,2021-09-16 10:11:33.897
17046,4,1017,대구,340,340,0,738,2020-02-27 09:00:00.000,2021-09-16 10:11:33.897
17047,0,3,인천,0,0,0,737,2020-02-27 09:00:00.000,2021-09-16 10:11:33.897
17048,0,9,광주,0,0,0,736,2020-02-27 09:00:00.000,2021-09-16 10:11:33.897
17049,0,8,대전,5,5,0,735,2020-02-27 09:00:00.000,2021-09-16 10:11:33.897
17050,0,6,울산,3,3,0,734,2020-02-27 09:00:00.000,2021-09-16 10:11:33.897
17051,0,1,세종,0,0,0,733,2020-02-27 09:00:00.000,2021-09-16 10:11:33.897
17052,1,55,경기,12,12,0,732,2020-02-27 09:00:00.000,2021-09-16 10:11:33.897
17053,0,6,강원,0,0,0,731,2020-02-27 09:00:00.000,2021-09-16 10:11:33.897
17054,0,7,충북,2,2,0,730,2020-02-27 09:00:00.000,2021-09-16 10:11:33.897
17055,0,7,충남,5,5,0,729,2020-02-27 09:00:00.000,2021-09-16 10:11:33.897
17056,0,3,전북,0,0,0,728,2020-02-27 09:00:00.000,2021-09-16 10:11:33.897
17057,0,1,전남,0,0,0,727,2020-02-27 09:00:00.000,2021-09-16 10:11:33.897
17058,7,323,경북,53,53,0,726,2020-02-27 09:00:00.000,2021-09-16 10:11:33.897
17059,0,36,경남,11,11,0,725,2020-02-27 09:00:00.000,2021-09-16 10:11:33.897
17060,0,2,제주,0,0,0,724,2020-02-27 09:00:00.000,2021-09-16 10:11:33.897
17061,0,0,검역,0,0,0,723,2020-02-27 09:00:00.000,2021-09-16 10:11:33.897
17062,11,1146,합계,253,252,1,722,2020-02-26 09:00:00.000,2021-09-16 10:11:33.897
17063,0,45,서울,8,7,1,721,2020-02-26 09:00:00.000,2021-09-16 10:11:33.897
17064,0,48,부산,13,13,0,720,2020-02-26 09:00:00.000,2021-09-16 10:11:33.897
17065,3,677,대구,184,184,0,719,2020-02-26 09:00:00.000,2021-09-16 10:11:33.897
17066,0,3,인천,1,1,0,718,2020-02-26 09:00:00.000,2021-09-16 10:11:33.897
17067,0,9,광주,0,0,0,717,2020-02-26 09:00:00.000,2021-09-16 10:11:33.897
17068,0,3,대전,0,0,0,716,2020-02-26 09:00:00.000,2021-09-16 10:11:33.897
17069,0,3,울산,1,1,0,715,2020-02-26 09:00:00.000,2021-09-16 10:11:33.897
17070,0,1,세종,0,0,0,714,2020-02-26 09:00:00.000,2021-09-16 10:11:33.897
17071,1,43,경기,3,3,0,713,2020-02-26 09:00:00.000,2021-09-16 10:11:33.897
17072,0,6,강원,0,0,0,712,2020-02-26 09:00:00.000,2021-09-16 10:11:33.897
17073,0,5,충북,2,2,0,711,2020-02-26 09:00:00.000,2021-09-16 10:11:33.897
17074,0,2,충남,1,1,0,710,2020-02-26 09:00:00.000,2021-09-16 10:11:33.897
17075,0,3,전북,0,0,0,709,2020-02-26 09:00:00.000,2021-09-16 10:11:33.897
17076,0,1,전남,0,0,0,708,2020-02-26 09:00:00.000,2021-09-16 10:11:33.897
17077,7,270,경북,36,36,0,707,2020-02-26 09:00:00.000,2021-09-16 10:11:33.897
17078,0,25,경남,4,4,0,706,2020-02-26 09:00:00.000,2021-09-16 10:11:33.897
17079,0,2,제주,0,0,0,705,2020-02-26 09:00:00.000,2021-09-16 10:11:33.897
17080,0,0,검역,0,0,0,704,2020-02-26 09:00:00.000,2021-09-16 10:11:33.897
17081,8,893,합계,130,129,1,703,2020-02-25 09:00:00.000,2021-09-16 10:11:33.897
17082,0,37,서울,7,7,0,702,2020-02-25 09:00:00.000,2021-09-16 10:11:33.897
17083,0,35,부산,18,18,0,701,2020-02-25 09:00:00.000,2021-09-16 10:11:33.897
17084,2,493,대구,54,54,0,700,2020-02-25 09:00:00.000,2021-09-16 10:11:33.897
17085,0,2,인천,0,0,0,699,2020-02-25 09:00:00.000,2021-09-16 10:11:33.897
17086,0,9,광주,0,0,0,698,2020-02-25 09:00:00.000,2021-09-16 10:11:33.897
17087,0,3,대전,0,0,0,697,2020-02-25 09:00:00.000,2021-09-16 10:11:33.897
17088,0,2,울산,1,1,0,696,2020-02-25 09:00:00.000,2021-09-16 10:11:33.897
17089,0,1,세종,0,0,0,695,2020-02-25 09:00:00.000,2021-09-16 10:11:33.897
17090,0,40,경기,5,5,0,694,2020-02-25 09:00:00.000,2021-09-16 10:11:33.897
17091,0,6,강원,0,0,0,693,2020-02-25 09:00:00.000,2021-09-16 10:11:33.897
17092,0,3,충북,0,0,0,692,2020-02-25 09:00:00.000,2021-09-16 10:11:33.897
17093,0,1,충남,0,0,0,691,2020-02-25 09:00:00.000,2021-09-16 10:11:33.897
17094,0,3,전북,0,0,0,690,2020-02-25 09:00:00.000,2021-09-16 10:11:33.897
17095,0,1,전남,0,0,0,689,2020-02-25 09:00:00.000,2021-09-16 10:11:33.897
17096,6,234,경북,44,44,0,688,2020-02-25 09:00:00.000,2021-09-16 10:11:33.897
17097,0,21,경남,1,0,1,687,2020-02-25 09:00:00.000,2021-09-16 10:11:33.897
17098,0,2,제주,0,0,0,686,2020-02-25 09:00:00.000,2021-09-16 10:11:33.897
17099,0,0,검역,0,0,0,685,2020-02-25 09:00:00.000,2021-09-16 10:11:33.897
17100,7,763,합계,207,206,1,684,2020-02-24 09:00:00.000,2021-09-16 10:11:33.897
17101,0,30,서울,4,3,1,683,2020-02-24 09:00:00.000,2021-09-16 10:11:33.897
17102,0,17,부산,8,8,0,682,2020-02-24 09:00:00.000,2021-09-16 10:11:33.897
17103,1,439,대구,152,152,0,681,2020-02-24 09:00:00.000,2021-09-16 10:11:33.897
17104,0,2,인천,0,0,0,680,2020-02-24 09:00:00.000,2021-09-16 10:11:33.897
17105,0,9,광주,2,2,0,679,2020-02-24 09:00:00.000,2021-09-16 10:11:33.897
17106,0,3,대전,1,1,0,678,2020-02-24 09:00:00.000,2021-09-16 10:11:33.897
17107,0,1,울산,0,0,0,677,2020-02-24 09:00:00.000,2021-09-16 10:11:33.897
17108,0,1,세종,0,0,0,676,2020-02-24 09:00:00.000,2021-09-16 10:11:33.897
17109,0,35,경기,12,12,0,675,2020-02-24 09:00:00.000,2021-09-16 10:11:33.897
17110,0,6,강원,0,0,0,674,2020-02-24 09:00:00.000,2021-09-16 10:11:33.897
17111,0,3,충북,0,0,0,673,2020-02-24 09:00:00.000,2021-09-16 10:11:33.897
17112,0,1,충남,0,0,0,672,2020-02-24 09:00:00.000,2021-09-16 10:11:33.897
17113,0,3,전북,0,0,0,671,2020-02-24 09:00:00.000,2021-09-16 10:11:33.897
17114,0,1,전남,0,0,0,670,2020-02-24 09:00:00.000,2021-09-16 10:11:33.897
17115,6,190,경북,19,19,0,669,2020-02-24 09:00:00.000,2021-09-16 10:11:33.897
17116,0,20,경남,9,9,0,668,2020-02-24 09:00:00.000,2021-09-16 10:11:33.897
17117,0,2,제주,0,0,0,667,2020-02-24 09:00:00.000,2021-09-16 10:11:33.897
17118,0,0,검역,0,0,0,666,2020-02-24 09:00:00.000,2021-09-16 10:11:33.897
17119,3,556,합계,210,209,1,665,2020-02-23 09:00:00.000,2021-09-16 10:11:33.897
17120,0,26,서울,3,3,0,664,2020-02-23 09:00:00.000,2021-09-16 10:11:33.897
17121,0,9,부산,7,7,0,663,2020-02-23 09:00:00.000,2021-09-16 10:11:33.897
17122,0,287,대구,136,136,0,662,2020-02-23 09:00:00.000,2021-09-16 10:11:33.897
17123,0,2,인천,1,1,0,661,2020-02-23 09:00:00.000,2021-09-16 10:11:33.897
17124,0,7,광주,1,1,0,660,2020-02-23 09:00:00.000,2021-09-16 10:11:33.897
17125,0,2,대전,1,1,0,659,2020-02-23 09:00:00.000,2021-09-16 10:11:33.897
17126,0,1,울산,1,1,0,658,2020-02-23 09:00:00.000,2021-09-16 10:11:33.897
17127,0,1,세종,0,0,0,657,2020-02-23 09:00:00.000,2021-09-16 10:11:33.897
17128,0,23,경기,8,7,1,656,2020-02-23 09:00:00.000,2021-09-16 10:11:33.897
17129,0,6,강원,6,6,0,655,2020-02-23 09:00:00.000,2021-09-16 10:11:33.897
17130,0,3,충북,0,0,0,654,2020-02-23 09:00:00.000,2021-09-16 10:11:33.897
17131,0,1,충남,0,0,0,653,2020-02-23 09:00:00.000,2021-09-16 10:11:33.897
17132,0,3,전북,0,0,0,652,2020-02-23 09:00:00.000,2021-09-16 10:11:33.897
17133,0,1,전남,0,0,0,651,2020-02-23 09:00:00.000,2021-09-16 10:11:33.897
17134,3,171,경북,39,39,0,650,2020-02-23 09:00:00.000,2021-09-16 10:11:33.897
17135,0,11,경남,7,7,0,649,2020-02-23 09:00:00.000,2021-09-16 10:11:33.897
17136,0,2,제주,0,0,0,648,2020-02-23 09:00:00.000,2021-09-16 10:11:33.897
17137,0,0,검역,0,0,0,647,2020-02-23 09:00:00.000,2021-09-16 10:11:33.897
17138,3,346,합계,190,190,0,646,2020-02-22 09:00:00.000,2021-09-16 10:11:33.897
17139,0,23,서울,2,2,0,645,2020-02-22 09:00:00.000,2021-09-16 10:11:33.897
17140,0,2,부산,2,2,0,644,2020-02-22 09:00:00.000,2021-09-16 10:11:33.897
17141,0,151,대구,67,67,0,643,2020-02-22 09:00:00.000,2021-09-16 10:11:33.897
17142,0,1,인천,0,0,0,642,2020-02-22 09:00:00.000,2021-09-16 10:11:33.897
17143,0,6,광주,3,3,0,641,2020-02-22 09:00:00.000,2021-09-16 10:11:33.897
17144,0,1,대전,1,1,0,640,2020-02-22 09:00:00.000,2021-09-16 10:11:33.897
17145,0,0,울산,0,0,0,639,2020-02-22 09:00:00.000,2021-09-16 10:11:33.897
17146,0,1,세종,1,1,0,638,2020-02-22 09:00:00.000,2021-09-16 10:11:33.897
17147,0,15,경기,2,2,0,637,2020-02-22 09:00:00.000,2021-09-16 10:11:33.897
17148,0,0,강원,0,0,0,636,2020-02-22 09:00:00.000,2021-09-16 10:11:33.897
17149,0,3,충북,2,2,0,635,2020-02-22 09:00:00.000,2021-09-16 10:11:33.897
17150,0,1,충남,0,0,0,634,2020-02-22 09:00:00.000,2021-09-16 10:11:33.897
17151,0,3,전북,1,1,0,633,2020-02-22 09:00:00.000,2021-09-16 10:11:33.897
17152,0,1,전남,0,0,0,632,2020-02-22 09:00:00.000,2021-09-16 10:11:33.897
17153,3,132,경북,106,106,0,631,2020-02-22 09:00:00.000,2021-09-16 10:11:33.897
17154,0,4,경남,2,2,0,630,2020-02-22 09:00:00.000,2021-09-16 10:11:33.897
17155,0,2,제주,1,1,0,629,2020-02-22 09:00:00.000,2021-09-16 10:11:33.897
17156,0,0,검역,0,0,0,628,2020-02-22 09:00:00.000,2021-09-16 10:11:33.897
17157,1,156,합계,74,74,0,627,2020-02-21 09:00:00.000,2021-09-16 10:11:33.897
17158,0,21,서울,5,5,0,626,2020-02-21 09:00:00.000,2021-09-16 10:11:33.897
17159,0,0,부산,0,0,0,625,2020-02-21 09:00:00.000,2021-09-16 10:11:33.897
17160,0,84,대구,44,44,0,624,2020-02-21 09:00:00.000,2021-09-16 10:11:33.897
17161,0,1,인천,0,0,0,623,2020-02-21 09:00:00.000,2021-09-16 10:11:33.897
17162,0,3,광주,1,1,0,622,2020-02-21 09:00:00.000,2021-09-16 10:11:33.897
17163,0,0,대전,0,0,0,621,2020-02-21 09:00:00.000,2021-09-16 10:11:33.897
17164,0,0,울산,0,0,0,620,2020-02-21 09:00:00.000,2021-09-16 10:11:33.897
17165,0,0,세종,0,0,0,619,2020-02-21 09:00:00.000,2021-09-16 10:11:33.897
17166,0,13,경기,1,1,0,618,2020-02-21 09:00:00.000,2021-09-16 10:11:33.897
17167,0,0,강원,0,0,0,617,2020-02-21 09:00:00.000,2021-09-16 10:11:33.897
17168,0,1,충북,1,1,0,616,2020-02-21 09:00:00.000,2021-09-16 10:11:33.897
17169,0,1,충남,1,1,0,615,2020-02-21 09:00:00.000,2021-09-16 10:11:33.897
17170,0,2,전북,1,1,0,614,2020-02-21 09:00:00.000,2021-09-16 10:11:33.897
17171,0,1,전남,0,0,0,613,2020-02-21 09:00:00.000,2021-09-16 10:11:33.897
17172,1,26,경북,17,17,0,612,2020-02-21 09:00:00.000,2021-09-16 10:11:33.897
17173,0,2,경남,2,2,0,611,2020-02-21 09:00:00.000,2021-09-16 10:11:33.897
17174,0,1,제주,1,1,0,610,2020-02-21 09:00:00.000,2021-09-16 10:11:33.897
17175,0,0,검역,0,0,0,609,2020-02-21 09:00:00.000,2021-09-16 10:11:33.897
17176,1,82,합계,16,16,0,608,2020-02-20 09:00:00.000,2021-09-16 10:11:33.897
17177,0,16,서울,0,0,0,607,2020-02-20 09:00:00.000,2021-09-16 10:11:33.897
17178,0,0,부산,0,0,0,606,2020-02-20 09:00:00.000,2021-09-16 10:11:33.897
17179,0,40,대구,12,12,0,605,2020-02-20 09:00:00.000,2021-09-16 10:11:33.897
17180,0,1,인천,0,0,0,604,2020-02-20 09:00:00.000,2021-09-16 10:11:33.897
17181,0,2,광주,0,0,0,603,2020-02-20 09:00:00.000,2021-09-16 10:11:33.897
17182,0,0,대전,0,0,0,602,2020-02-20 09:00:00.000,2021-09-16 10:11:33.897
17183,0,0,울산,0,0,0,601,2020-02-20 09:00:00.000,2021-09-16 10:11:33.897
17184,0,0,세종,0,0,0,600,2020-02-20 09:00:00.000,2021-09-16 10:11:33.897
17185,0,12,경기,0,0,0,599,2020-02-20 09:00:00.000,2021-09-16 10:11:33.897
17186,0,0,강원,0,0,0,598,2020-02-20 09:00:00.000,2021-09-16 10:11:33.897
17187,0,0,충북,0,0,0,597,2020-02-20 09:00:00.000,2021-09-16 10:11:33.897
17188,0,0,충남,0,0,0,596,2020-02-20 09:00:00.000,2021-09-16 10:11:33.897
17189,0,1,전북,0,0,0,595,2020-02-20 09:00:00.000,2021-09-16 10:11:33.897
17190,0,1,전남,0,0,0,594,2020-02-20 09:00:00.000,2021-09-16 10:11:33.897
17191,1,9,경북,4,4,0,593,2020-02-20 09:00:00.000,2021-09-16 10:11:33.897
17192,0,0,경남,0,0,0,592,2020-02-20 09:00:00.000,2021-09-16 10:11:33.897
17193,0,0,제주,0,0,0,591,2020-02-20 09:00:00.000,2021-09-16 10:11:33.897
17194,0,0,검역,0,0,0,590,2020-02-20 09:00:00.000,2021-09-16 10:11:33.897
17195,0,66,합계,34,34,0,589,2020-02-19 09:00:00.000,2021-09-16 10:11:33.897
17196,0,16,서울,2,2,0,588,2020-02-19 09:00:00.000,2021-09-16 10:11:33.897
17197,0,0,부산,0,0,0,587,2020-02-19 09:00:00.000,2021-09-16 10:11:33.897
17198,0,28,대구,27,27,0,586,2020-02-19 09:00:00.000,2021-09-16 10:11:33.897
17199,0,1,인천,0,0,0,585,2020-02-19 09:00:00.000,2021-09-16 10:11:33.897
17200,0,2,광주,0,0,0,584,2020-02-19 09:00:00.000,2021-09-16 10:11:33.897
17201,0,0,대전,0,0,0,583,2020-02-19 09:00:00.000,2021-09-16 10:11:33.897
17202,0,0,울산,0,0,0,582,2020-02-19 09:00:00.000,2021-09-16 10:11:33.897
17203,0,0,세종,0,0,0,581,2020-02-19 09:00:00.000,2021-09-16 10:11:33.897
17204,0,12,경기,0,0,0,580,2020-02-19 09:00:00.000,2021-09-16 10:11:33.897
17205,0,0,강원,0,0,0,579,2020-02-19 09:00:00.000,2021-09-16 10:11:33.897
17206,0,0,충북,0,0,0,578,2020-02-19 09:00:00.000,2021-09-16 10:11:33.897
17207,0,0,충남,0,0,0,577,2020-02-19 09:00:00.000,2021-09-16 10:11:33.897
17208,0,1,전북,0,0,0,576,2020-02-19 09:00:00.000,2021-09-16 10:11:33.897
17209,0,1,전남,0,0,0,575,2020-02-19 09:00:00.000,2021-09-16 10:11:33.897
17210,0,5,경북,5,5,0,574,2020-02-19 09:00:00.000,2021-09-16 10:11:33.897
17211,0,0,경남,0,0,0,573,2020-02-19 09:00:00.000,2021-09-16 10:11:33.897
17212,0,0,제주,0,0,0,572,2020-02-19 09:00:00.000,2021-09-16 10:11:33.897
17213,0,0,검역,0,0,0,571,2020-02-19 09:00:00.000,2021-09-16 10:11:33.897
17214,0,32,합계,2,2,0,570,2020-02-18 09:00:00.000,2021-09-16 10:11:33.897
17215,0,14,서울,0,0,0,569,2020-02-18 09:00:00.000,2021-09-16 10:11:33.897
17216,0,0,부산,0,0,0,568,2020-02-18 09:00:00.000,2021-09-16 10:11:33.897
17217,0,1,대구,1,1,0,567,2020-02-18 09:00:00.000,2021-09-16 10:11:33.897
17218,0,1,인천,0,0,0,566,2020-02-18 09:00:00.000,2021-09-16 10:11:33.897
17219,0,2,광주,0,0,0,565,2020-02-18 09:00:00.000,2021-09-16 10:11:33.897
17220,0,0,대전,0,0,0,564,2020-02-18 09:00:00.000,2021-09-16 10:11:33.897
17221,0,0,울산,0,0,0,563,2020-02-18 09:00:00.000,2021-09-16 10:11:33.897
17222,0,0,세종,0,0,0,562,2020-02-18 09:00:00.000,2021-09-16 10:11:33.897
17223,0,12,경기,1,1,0,561,2020-02-18 09:00:00.000,2021-09-16 10:11:33.897
17224,0,0,강원,0,0,0,560,2020-02-18 09:00:00.000,2021-09-16 10:11:33.897
17225,0,0,충북,0,0,0,559,2020-02-18 09:00:00.000,2021-09-16 10:11:33.897
17226,0,0,충남,0,0,0,558,2020-02-18 09:00:00.000,2021-09-16 10:11:33.897
17227,0,1,전북,0,0,0,557,2020-02-18 09:00:00.000,2021-09-16 10:11:33.897
17228,0,1,전남,0,0,0,556,2020-02-18 09:00:00.000,2021-09-16 10:11:33.897
17229,0,0,경북,0,0,0,555,2020-02-18 09:00:00.000,2021-09-16 10:11:33.897
17230,0,0,경남,0,0,0,554,2020-02-18 09:00:00.000,2021-09-16 10:11:33.897
17231,0,0,제주,0,0,0,553,2020-02-18 09:00:00.000,2021-09-16 10:11:33.897
17232,0,0,검역,0,0,0,552,2020-02-18 09:00:00.000,2021-09-16 10:11:33.897
17233,0,30,합계,0,0,0,551,2020-02-17 09:00:00.000,2021-09-16 10:11:33.897
17234,0,14,서울,0,0,0,550,2020-02-17 09:00:00.000,2021-09-16 10:11:33.897
17235,0,0,부산,0,0,0,549,2020-02-17 09:00:00.000,2021-09-16 10:11:33.897
17236,0,0,대구,0,0,0,548,2020-02-17 09:00:00.000,2021-09-16 10:11:33.897
17237,0,1,인천,0,0,0,547,2020-02-17 09:00:00.000,2021-09-16 10:11:33.897
17238,0,2,광주,0,0,0,546,2020-02-17 09:00:00.000,2021-09-16 10:11:33.897
17239,0,0,대전,0,0,0,545,2020-02-17 09:00:00.000,2021-09-16 10:11:33.897
17240,0,0,울산,0,0,0,544,2020-02-17 09:00:00.000,2021-09-16 10:11:33.897
17241,0,0,세종,0,0,0,543,2020-02-17 09:00:00.000,2021-09-16 10:11:33.897
17242,0,11,경기,0,0,0,542,2020-02-17 09:00:00.000,2021-09-16 10:11:33.897
17243,0,0,강원,0,0,0,541,2020-02-17 09:00:00.000,2021-09-16 10:11:33.897
17244,0,0,충북,0,0,0,540,2020-02-17 09:00:00.000,2021-09-16 10:11:33.897
17245,0,0,충남,0,0,0,539,2020-02-17 09:00:00.000,2021-09-16 10:11:33.897
17246,0,1,전북,0,0,0,538,2020-02-17 09:00:00.000,2021-09-16 10:11:33.897
17247,0,1,전남,0,0,0,537,2020-02-17 09:00:00.000,2021-09-16 10:11:33.897
17248,0,0,경북,0,0,0,536,2020-02-17 09:00:00.000,2021-09-16 10:11:33.897
17249,0,0,경남,0,0,0,535,2020-02-17 09:00:00.000,2021-09-16 10:11:33.897
17250,0,0,제주,0,0,0,534,2020-02-17 09:00:00.000,2021-09-16 10:11:33.897
17251,0,0,검역,0,0,0,533,2020-02-17 09:00:00.000,2021-09-16 10:11:33.897
17252,0,30,합계,2,2,0,532,2020-02-16 09:00:00.000,2021-09-16 10:11:33.897
17253,0,14,서울,2,2,0,531,2020-02-16 09:00:00.000,2021-09-16 10:11:33.897
17254,0,0,부산,0,0,0,530,2020-02-16 09:00:00.000,2021-09-16 10:11:33.897
17255,0,0,대구,0,0,0,529,2020-02-16 09:00:00.000,2021-09-16 10:11:33.897
17256,0,1,인천,0,0,0,528,2020-02-16 09:00:00.000,2021-09-16 10:11:33.897
17257,0,2,광주,0,0,0,527,2020-02-16 09:00:00.000,2021-09-16 10:11:33.897
17258,0,0,대전,0,0,0,526,2020-02-16 09:00:00.000,2021-09-16 10:11:33.897
17259,0,0,울산,0,0,0,525,2020-02-16 09:00:00.000,2021-09-16 10:11:33.897
17260,0,0,세종,0,0,0,524,2020-02-16 09:00:00.000,2021-09-16 10:11:33.897
17261,0,11,경기,0,0,0,523,2020-02-16 09:00:00.000,2021-09-16 10:11:33.897
17262,0,0,강원,0,0,0,522,2020-02-16 09:00:00.000,2021-09-16 10:11:33.897
17263,0,0,충북,0,0,0,521,2020-02-16 09:00:00.000,2021-09-16 10:11:33.897
17264,0,0,충남,0,0,0,520,2020-02-16 09:00:00.000,2021-09-16 10:11:33.897
17265,0,1,전북,0,0,0,519,2020-02-16 09:00:00.000,2021-09-16 10:11:33.897
17266,0,1,전남,0,0,0,518,2020-02-16 09:00:00.000,2021-09-16 10:11:33.897
17267,0,0,경북,0,0,0,517,2020-02-16 09:00:00.000,2021-09-16 10:11:33.897
17268,0,0,경남,0,0,0,516,2020-02-16 09:00:00.000,2021-09-16 10:11:33.897
17269,0,0,제주,0,0,0,515,2020-02-16 09:00:00.000,2021-09-16 10:11:33.897
17270,0,0,검역,0,0,0,514,2020-02-16 09:00:00.000,2021-09-16 10:11:33.897
17271,0,28,합계,0,0,0,513,2020-02-15 09:00:00.000,2021-09-16 10:11:33.897
17272,0,12,서울,0,0,0,512,2020-02-15 09:00:00.000,2021-09-16 10:11:33.897
17273,0,0,부산,0,0,0,511,2020-02-15 09:00:00.000,2021-09-16 10:11:33.897
17274,0,0,대구,0,0,0,510,2020-02-15 09:00:00.000,2021-09-16 10:11:33.897
17275,0,1,인천,0,0,0,509,2020-02-15 09:00:00.000,2021-09-16 10:11:33.897
17276,0,2,광주,0,0,0,508,2020-02-15 09:00:00.000,2021-09-16 10:11:33.897
17277,0,0,대전,0,0,0,507,2020-02-15 09:00:00.000,2021-09-16 10:11:33.897
17278,0,0,울산,0,0,0,506,2020-02-15 09:00:00.000,2021-09-16 10:11:33.897
17279,0,0,세종,0,0,0,505,2020-02-15 09:00:00.000,2021-09-16 10:11:33.897
17280,0,11,경기,0,0,0,504,2020-02-15 09:00:00.000,2021-09-16 10:11:33.897
17281,0,0,강원,0,0,0,503,2020-02-15 09:00:00.000,2021-09-16 10:11:33.897
17282,0,0,충북,0,0,0,502,2020-02-15 09:00:00.000,2021-09-16 10:11:33.897
17283,0,0,충남,0,0,0,501,2020-02-15 09:00:00.000,2021-09-16 10:11:33.897
17284,0,1,전북,0,0,0,500,2020-02-15 09:00:00.000,2021-09-16 10:11:33.897
17285,0,1,전남,0,0,0,499,2020-02-15 09:00:00.000,2021-09-16 10:11:33.897
17286,0,0,경북,0,0,0,498,2020-02-15 09:00:00.000,2021-09-16 10:11:33.897
17287,0,0,경남,0,0,0,497,2020-02-15 09:00:00.000,2021-09-16 10:11:33.897
17288,0,0,제주,0,0,0,496,2020-02-15 09:00:00.000,2021-09-16 10:11:33.897
17289,0,0,검역,0,0,0,495,2020-02-15 09:00:00.000,2021-09-16 10:11:33.897
17290,0,28,합계,0,0,0,494,2020-02-14 09:00:00.000,2021-09-16 10:11:33.897
17291,0,12,서울,0,0,0,493,2020-02-14 09:00:00.000,2021-09-16 10:11:33.897
17292,0,0,부산,0,0,0,492,2020-02-14 09:00:00.000,2021-09-16 10:11:33.897
17293,0,0,대구,0,0,0,491,2020-02-14 09:00:00.000,2021-09-16 10:11:33.897
17294,0,1,인천,0,0,0,490,2020-02-14 09:00:00.000,2021-09-16 10:11:33.897
17295,0,2,광주,0,0,0,489,2020-02-14 09:00:00.000,2021-09-16 10:11:33.897
17296,0,0,대전,0,0,0,488,2020-02-14 09:00:00.000,2021-09-16 10:11:33.897
17297,0,0,울산,0,0,0,487,2020-02-14 09:00:00.000,2021-09-16 10:11:33.897
17298,0,0,세종,0,0,0,486,2020-02-14 09:00:00.000,2021-09-16 10:11:33.897
17299,0,11,경기,0,0,0,485,2020-02-14 09:00:00.000,2021-09-16 10:11:33.897
17300,0,0,강원,0,0,0,484,2020-02-14 09:00:00.000,2021-09-16 10:11:33.897
17301,0,0,충북,0,0,0,483,2020-02-14 09:00:00.000,2021-09-16 10:11:33.897
17302,0,0,충남,0,0,0,482,2020-02-14 09:00:00.000,2021-09-16 10:11:33.897
17303,0,1,전북,0,0,0,481,2020-02-14 09:00:00.000,2021-09-16 10:11:33.897
17304,0,1,전남,0,0,0,480,2020-02-14 09:00:00.000,2021-09-16 10:11:33.897
17305,0,0,경북,0,0,0,479,2020-02-14 09:00:00.000,2021-09-16 10:11:33.897
17306,0,0,경남,0,0,0,478,2020-02-14 09:00:00.000,2021-09-16 10:11:33.897
17307,0,0,제주,0,0,0,477,2020-02-14 09:00:00.000,2021-09-16 10:11:33.897
17308,0,0,검역,0,0,0,476,2020-02-14 09:00:00.000,2021-09-16 10:11:33.897
17309,0,28,합계,0,0,0,475,2020-02-13 09:00:00.000,2021-09-16 10:11:33.897
17310,0,12,서울,0,0,0,474,2020-02-13 09:00:00.000,2021-09-16 10:11:33.897
17311,0,0,부산,0,0,0,473,2020-02-13 09:00:00.000,2021-09-16 10:11:33.897
17312,0,0,대구,0,0,0,472,2020-02-13 09:00:00.000,2021-09-16 10:11:33.897
17313,0,1,인천,0,0,0,471,2020-02-13 09:00:00.000,2021-09-16 10:11:33.897
17314,0,2,광주,0,0,0,470,2020-02-13 09:00:00.000,2021-09-16 10:11:33.897
17315,0,0,대전,0,0,0,469,2020-02-13 09:00:00.000,2021-09-16 10:11:33.897
17316,0,0,울산,0,0,0,468,2020-02-13 09:00:00.000,2021-09-16 10:11:33.897
17317,0,0,세종,0,0,0,467,2020-02-13 09:00:00.000,2021-09-16 10:11:33.897
17318,0,11,경기,0,0,0,466,2020-02-13 09:00:00.000,2021-09-16 10:11:33.897
17319,0,0,강원,0,0,0,465,2020-02-13 09:00:00.000,2021-09-16 10:11:33.897
17320,0,0,충북,0,0,0,464,2020-02-13 09:00:00.000,2021-09-16 10:11:33.897
17321,0,0,충남,0,0,0,463,2020-02-13 09:00:00.000,2021-09-16 10:11:33.897
17322,0,1,전북,0,0,0,462,2020-02-13 09:00:00.000,2021-09-16 10:11:33.897
17323,0,1,전남,0,0,0,461,2020-02-13 09:00:00.000,2021-09-16 10:11:33.897
17324,0,0,경북,0,0,0,460,2020-02-13 09:00:00.000,2021-09-16 10:11:33.897
17325,0,0,경남,0,0,0,459,2020-02-13 09:00:00.000,2021-09-16 10:11:33.897
17326,0,0,제주,0,0,0,458,2020-02-13 09:00:00.000,2021-09-16 10:11:33.897
17327,0,0,검역,0,0,0,457,2020-02-13 09:00:00.000,2021-09-16 10:11:33.897
17328,0,28,합계,0,0,0,456,2020-02-12 09:00:00.000,2021-09-16 10:11:33.897
17329,0,12,서울,0,0,0,455,2020-02-12 09:00:00.000,2021-09-16 10:11:33.897
17330,0,0,부산,0,0,0,454,2020-02-12 09:00:00.000,2021-09-16 10:11:33.897
17331,0,0,대구,0,0,0,453,2020-02-12 09:00:00.000,2021-09-16 10:11:33.897
17332,0,1,인천,0,0,0,452,2020-02-12 09:00:00.000,2021-09-16 10:11:33.897
17333,0,2,광주,0,0,0,451,2020-02-12 09:00:00.000,2021-09-16 10:11:33.897
17334,0,0,대전,0,0,0,450,2020-02-12 09:00:00.000,2021-09-16 10:11:33.897
17335,0,0,울산,0,0,0,449,2020-02-12 09:00:00.000,2021-09-16 10:11:33.897
17336,0,0,세종,0,0,0,448,2020-02-12 09:00:00.000,2021-09-16 10:11:33.897
17337,0,11,경기,0,0,0,447,2020-02-12 09:00:00.000,2021-09-16 10:11:33.897
17338,0,0,강원,0,0,0,446,2020-02-12 09:00:00.000,2021-09-16 10:11:33.897
17339,0,0,충북,0,0,0,445,2020-02-12 09:00:00.000,2021-09-16 10:11:33.897
17340,0,0,충남,0,0,0,444,2020-02-12 09:00:00.000,2021-09-16 10:11:33.897
17341,0,1,전북,0,0,0,443,2020-02-12 09:00:00.000,2021-09-16 10:11:33.897
17342,0,1,전남,0,0,0,442,2020-02-12 09:00:00.000,2021-09-16 10:11:33.897
17343,0,0,경북,0,0,0,441,2020-02-12 09:00:00.000,2021-09-16 10:11:33.897
17344,0,0,경남,0,0,0,440,2020-02-12 09:00:00.000,2021-09-16 10:11:33.897
17345,0,0,제주,0,0,0,439,2020-02-12 09:00:00.000,2021-09-16 10:11:33.897
17346,0,0,검역,0,0,0,438,2020-02-12 09:00:00.000,2021-09-16 10:11:33.897
17347,0,28,합계,0,0,0,437,2020-02-11 09:00:00.000,2021-09-16 10:11:33.897
17348,0,12,서울,0,0,0,436,2020-02-11 09:00:00.000,2021-09-16 10:11:33.897
17349,0,0,부산,0,0,0,435,2020-02-11 09:00:00.000,2021-09-16 10:11:33.897
17350,0,0,대구,0,0,0,434,2020-02-11 09:00:00.000,2021-09-16 10:11:33.897
17351,0,1,인천,0,0,0,433,2020-02-11 09:00:00.000,2021-09-16 10:11:33.897
17352,0,2,광주,0,0,0,432,2020-02-11 09:00:00.000,2021-09-16 10:11:33.897
17353,0,0,대전,0,0,0,431,2020-02-11 09:00:00.000,2021-09-16 10:11:33.897
17354,0,0,울산,0,0,0,430,2020-02-11 09:00:00.000,2021-09-16 10:11:33.897
17355,0,0,세종,0,0,0,429,2020-02-11 09:00:00.000,2021-09-16 10:11:33.897
17356,0,11,경기,0,0,0,428,2020-02-11 09:00:00.000,2021-09-16 10:11:33.897
17357,0,0,강원,0,0,0,427,2020-02-11 09:00:00.000,2021-09-16 10:11:33.897
17358,0,0,충북,0,0,0,426,2020-02-11 09:00:00.000,2021-09-16 10:11:33.897
17359,0,0,충남,0,0,0,425,2020-02-11 09:00:00.000,2021-09-16 10:11:33.897
17360,0,1,전북,0,0,0,424,2020-02-11 09:00:00.000,2021-09-16 10:11:33.897
17361,0,1,전남,0,0,0,423,2020-02-11 09:00:00.000,2021-09-16 10:11:33.897
17362,0,0,경북,0,0,0,422,2020-02-11 09:00:00.000,2021-09-16 10:11:33.897
17363,0,0,경남,0,0,0,421,2020-02-11 09:00:00.000,2021-09-16 10:11:33.897
17364,0,0,제주,0,0,0,420,2020-02-11 09:00:00.000,2021-09-16 10:11:33.897
17365,0,0,검역,0,0,0,419,2020-02-11 09:00:00.000,2021-09-16 10:11:33.897
17366,0,28,합계,1,1,0,418,2020-02-10 09:00:00.000,2021-09-16 10:11:33.897
17367,0,12,서울,0,0,0,417,2020-02-10 09:00:00.000,2021-09-16 10:11:33.897
17368,0,0,부산,0,0,0,416,2020-02-10 09:00:00.000,2021-09-16 10:11:33.897
17369,0,0,대구,0,0,0,415,2020-02-10 09:00:00.000,2021-09-16 10:11:33.897
17370,0,1,인천,0,0,0,414,2020-02-10 09:00:00.000,2021-09-16 10:11:33.897
17371,0,2,광주,0,0,0,413,2020-02-10 09:00:00.000,2021-09-16 10:11:33.897
17372,0,0,대전,0,0,0,412,2020-02-10 09:00:00.000,2021-09-16 10:11:33.897
17373,0,0,울산,0,0,0,411,2020-02-10 09:00:00.000,2021-09-16 10:11:33.897
17374,0,0,세종,0,0,0,410,2020-02-10 09:00:00.000,2021-09-16 10:11:33.897
17375,0,11,경기,1,1,0,409,2020-02-10 09:00:00.000,2021-09-16 10:11:33.897
17376,0,0,강원,0,0,0,408,2020-02-10 09:00:00.000,2021-09-16 10:11:33.897
17377,0,0,충북,0,0,0,407,2020-02-10 09:00:00.000,2021-09-16 10:11:33.897
17378,0,0,충남,0,0,0,406,2020-02-10 09:00:00.000,2021-09-16 10:11:33.897
17379,0,1,전북,0,0,0,405,2020-02-10 09:00:00.000,2021-09-16 10:11:33.897
17380,0,1,전남,0,0,0,404,2020-02-10 09:00:00.000,2021-09-16 10:11:33.897
17381,0,0,경북,0,0,0,403,2020-02-10 09:00:00.000,2021-09-16 10:11:33.897
17382,0,0,경남,0,0,0,402,2020-02-10 09:00:00.000,2021-09-16 10:11:33.897
17383,0,0,제주,0,0,0,401,2020-02-10 09:00:00.000,2021-09-16 10:11:33.897
17384,0,0,검역,0,0,0,400,2020-02-10 09:00:00.000,2021-09-16 10:11:33.897
17385,0,27,합계,3,1,2,399,2020-02-09 09:00:00.000,2021-09-16 10:11:33.897
17386,0,12,서울,0,0,0,398,2020-02-09 09:00:00.000,2021-09-16 10:11:33.897
17387,0,0,부산,0,0,0,397,2020-02-09 09:00:00.000,2021-09-16 10:11:33.897
17388,0,0,대구,0,0,0,396,2020-02-09 09:00:00.000,2021-09-16 10:11:33.897
17389,0,1,인천,0,0,0,395,2020-02-09 09:00:00.000,2021-09-16 10:11:33.897
17390,0,2,광주,0,0,0,394,2020-02-09 09:00:00.000,2021-09-16 10:11:33.897
17391,0,0,대전,0,0,0,393,2020-02-09 09:00:00.000,2021-09-16 10:11:33.897
17392,0,0,울산,0,0,0,392,2020-02-09 09:00:00.000,2021-09-16 10:11:33.897
17393,0,0,세종,0,0,0,391,2020-02-09 09:00:00.000,2021-09-16 10:11:33.897
17394,0,10,경기,3,1,2,390,2020-02-09 09:00:00.000,2021-09-16 10:11:33.897
17395,0,0,강원,0,0,0,389,2020-02-09 09:00:00.000,2021-09-16 10:11:33.897
17396,0,0,충북,0,0,0,388,2020-02-09 09:00:00.000,2021-09-16 10:11:33.897
17397,0,0,충남,0,0,0,387,2020-02-09 09:00:00.000,2021-09-16 10:11:33.897
17398,0,1,전북,0,0,0,386,2020-02-09 09:00:00.000,2021-09-16 10:11:33.897
17399,0,1,전남,0,0,0,385,2020-02-09 09:00:00.000,2021-09-16 10:11:33.897
17400,0,0,경북,0,0,0,384,2020-02-09 09:00:00.000,2021-09-16 10:11:33.897
17401,0,0,경남,0,0,0,383,2020-02-09 09:00:00.000,2021-09-16 10:11:33.897
17402,0,0,제주,0,0,0,382,2020-02-09 09:00:00.000,2021-09-16 10:11:33.897
17403,0,0,검역,0,0,0,381,2020-02-09 09:00:00.000,2021-09-16 10:11:33.897
17404,0,24,합계,0,0,0,380,2020-02-08 09:00:00.000,2021-09-16 10:11:33.897
17405,0,12,서울,0,0,0,379,2020-02-08 09:00:00.000,2021-09-16 10:11:33.897
17406,0,0,부산,0,0,0,378,2020-02-08 09:00:00.000,2021-09-16 10:11:33.897
17407,0,0,대구,0,0,0,377,2020-02-08 09:00:00.000,2021-09-16 10:11:33.897
17408,0,1,인천,0,0,0,376,2020-02-08 09:00:00.000,2021-09-16 10:11:33.897
17409,0,2,광주,0,0,0,375,2020-02-08 09:00:00.000,2021-09-16 10:11:33.897
17410,0,0,대전,0,0,0,374,2020-02-08 09:00:00.000,2021-09-16 10:11:33.897
17411,0,0,울산,0,0,0,373,2020-02-08 09:00:00.000,2021-09-16 10:11:33.897
17412,0,0,세종,0,0,0,372,2020-02-08 09:00:00.000,2021-09-16 10:11:33.897
17413,0,7,경기,0,0,0,371,2020-02-08 09:00:00.000,2021-09-16 10:11:33.897
17414,0,0,강원,0,0,0,370,2020-02-08 09:00:00.000,2021-09-16 10:11:33.897
17415,0,0,충북,0,0,0,369,2020-02-08 09:00:00.000,2021-09-16 10:11:33.897
17416,0,0,충남,0,0,0,368,2020-02-08 09:00:00.000,2021-09-16 10:11:33.897
17417,0,1,전북,0,0,0,367,2020-02-08 09:00:00.000,2021-09-16 10:11:33.897
17418,0,1,전남,0,0,0,366,2020-02-08 09:00:00.000,2021-09-16 10:11:33.897
17419,0,0,경북,0,0,0,365,2020-02-08 09:00:00.000,2021-09-16 10:11:33.897
17420,0,0,경남,0,0,0,364,2020-02-08 09:00:00.000,2021-09-16 10:11:33.897
17421,0,0,제주,0,0,0,363,2020-02-08 09:00:00.000,2021-09-16 10:11:33.897
17422,0,0,검역,0,0,0,362,2020-02-08 09:00:00.000,2021-09-16 10:11:33.897
17423,0,24,합계,0,0,0,361,2020-02-07 09:00:00.000,2021-09-16 10:11:33.897
17424,0,12,서울,0,0,0,360,2020-02-07 09:00:00.000,2021-09-16 10:11:33.897
17425,0,0,부산,0,0,0,359,2020-02-07 09:00:00.000,2021-09-16 10:11:33.897
17426,0,0,대구,0,0,0,358,2020-02-07 09:00:00.000,2021-09-16 10:11:33.897
17427,0,1,인천,0,0,0,357,2020-02-07 09:00:00.000,2021-09-16 10:11:33.897
17428,0,2,광주,0,0,0,356,2020-02-07 09:00:00.000,2021-09-16 10:11:33.897
17429,0,0,대전,0,0,0,355,2020-02-07 09:00:00.000,2021-09-16 10:11:33.897
17430,0,0,울산,0,0,0,354,2020-02-07 09:00:00.000,2021-09-16 10:11:33.897
17431,0,0,세종,0,0,0,353,2020-02-07 09:00:00.000,2021-09-16 10:11:33.897
17432,0,7,경기,0,0,0,352,2020-02-07 09:00:00.000,2021-09-16 10:11:33.897
17433,0,0,강원,0,0,0,351,2020-02-07 09:00:00.000,2021-09-16 10:11:33.897
17434,0,0,충북,0,0,0,350,2020-02-07 09:00:00.000,2021-09-16 10:11:33.897
17435,0,0,충남,0,0,0,349,2020-02-07 09:00:00.000,2021-09-16 10:11:33.897
17436,0,1,전북,0,0,0,348,2020-02-07 09:00:00.000,2021-09-16 10:11:33.897
17437,0,1,전남,0,0,0,347,2020-02-07 09:00:00.000,2021-09-16 10:11:33.897
17438,0,0,경북,0,0,0,346,2020-02-07 09:00:00.000,2021-09-16 10:11:33.897
17439,0,0,경남,0,0,0,345,2020-02-07 09:00:00.000,2021-09-16 10:11:33.897
17440,0,0,제주,0,0,0,344,2020-02-07 09:00:00.000,2021-09-16 10:11:33.897
17441,0,0,검역,0,0,0,343,2020-02-07 09:00:00.000,2021-09-16 10:11:33.897
17442,0,24,합계,3,1,2,342,2020-02-06 09:00:00.000,2021-09-16 10:11:33.897
17443,0,12,서울,2,0,2,341,2020-02-06 09:00:00.000,2021-09-16 10:11:33.897
17444,0,0,부산,0,0,0,340,2020-02-06 09:00:00.000,2021-09-16 10:11:33.897
17445,0,0,대구,0,0,0,339,2020-02-06 09:00:00.000,2021-09-16 10:11:33.897
17446,0,1,인천,0,0,0,338,2020-02-06 09:00:00.000,2021-09-16 10:11:33.897
17447,0,2,광주,0,0,0,337,2020-02-06 09:00:00.000,2021-09-16 10:11:33.897
17448,0,0,대전,0,0,0,336,2020-02-06 09:00:00.000,2021-09-16 10:11:33.897
17449,0,0,울산,0,0,0,335,2020-02-06 09:00:00.000,2021-09-16 10:11:33.897
17450,0,0,세종,0,0,0,334,2020-02-06 09:00:00.000,2021-09-16 10:11:33.897
17451,0,7,경기,0,0,0,333,2020-02-06 09:00:00.000,2021-09-16 10:11:33.897
17452,0,0,강원,0,0,0,332,2020-02-06 09:00:00.000,2021-09-16 10:11:33.897
17453,0,0,충북,0,0,0,331,2020-02-06 09:00:00.000,2021-09-16 10:11:33.897
17454,0,0,충남,0,0,0,330,2020-02-06 09:00:00.000,2021-09-16 10:11:33.897
17455,0,1,전북,0,0,0,329,2020-02-06 09:00:00.000,2021-09-16 10:11:33.897
17456,0,1,전남,1,1,0,328,2020-02-06 09:00:00.000,2021-09-16 10:11:33.897
17457,0,0,경북,0,0,0,327,2020-02-06 09:00:00.000,2021-09-16 10:11:33.897
17458,0,0,경남,0,0,0,326,2020-02-06 09:00:00.000,2021-09-16 10:11:33.897
17459,0,0,제주,0,0,0,325,2020-02-06 09:00:00.000,2021-09-16 10:11:33.897
17460,0,0,검역,0,0,0,324,2020-02-06 09:00:00.000,2021-09-16 10:11:33.897
17461,0,21,합계,5,3,2,323,2020-02-05 09:00:00.000,2021-09-16 10:11:33.897
17462,0,10,서울,2,1,1,322,2020-02-05 09:00:00.000,2021-09-16 10:11:33.897
17463,0,0,부산,0,0,0,321,2020-02-05 09:00:00.000,2021-09-16 10:11:33.897
17464,0,0,대구,0,0,0,320,2020-02-05 09:00:00.000,2021-09-16 10:11:33.897
17465,0,1,인천,0,0,0,319,2020-02-05 09:00:00.000,2021-09-16 10:11:33.897
17466,0,2,광주,1,1,0,318,2020-02-05 09:00:00.000,2021-09-16 10:11:33.897
17467,0,0,대전,0,0,0,317,2020-02-05 09:00:00.000,2021-09-16 10:11:33.897
17468,0,0,울산,0,0,0,316,2020-02-05 09:00:00.000,2021-09-16 10:11:33.897
17469,0,0,세종,0,0,0,315,2020-02-05 09:00:00.000,2021-09-16 10:11:33.897
17470,0,7,경기,2,1,1,314,2020-02-05 09:00:00.000,2021-09-16 10:11:33.897
17471,0,0,강원,0,0,0,313,2020-02-05 09:00:00.000,2021-09-16 10:11:33.897
17472,0,0,충북,0,0,0,312,2020-02-05 09:00:00.000,2021-09-16 10:11:33.897
17473,0,0,충남,0,0,0,311,2020-02-05 09:00:00.000,2021-09-16 10:11:33.897
17474,0,1,전북,0,0,0,310,2020-02-05 09:00:00.000,2021-09-16 10:11:33.897
17475,0,0,전남,0,0,0,309,2020-02-05 09:00:00.000,2021-09-16 10:11:33.897
17476,0,0,경북,0,0,0,308,2020-02-05 09:00:00.000,2021-09-16 10:11:33.897
17477,0,0,경남,0,0,0,307,2020-02-05 09:00:00.000,2021-09-16 10:11:33.897
17478,0,0,제주,0,0,0,306,2020-02-05 09:00:00.000,2021-09-16 10:11:33.897
17479,0,0,검역,0,0,0,305,2020-02-05 09:00:00.000,2021-09-16 10:11:33.897
17480,0,16,합계,1,0,1,304,2020-02-04 09:00:00.000,2021-09-16 10:11:33.897
17481,0,8,서울,0,0,0,303,2020-02-04 09:00:00.000,2021-09-16 10:11:33.897
17482,0,0,부산,0,0,0,302,2020-02-04 09:00:00.000,2021-09-16 10:11:33.897
17483,0,0,대구,0,0,0,301,2020-02-04 09:00:00.000,2021-09-16 10:11:33.897
17484,0,1,인천,0,0,0,300,2020-02-04 09:00:00.000,2021-09-16 10:11:33.897
17485,0,1,광주,1,0,1,299,2020-02-04 09:00:00.000,2021-09-16 10:11:33.897
17486,0,0,대전,0,0,0,298,2020-02-04 09:00:00.000,2021-09-16 10:11:33.897
17487,0,0,울산,0,0,0,297,2020-02-04 09:00:00.000,2021-09-16 10:11:33.897
17488,0,0,세종,0,0,0,296,2020-02-04 09:00:00.000,2021-09-16 10:11:33.897
17489,0,5,경기,0,0,0,295,2020-02-04 09:00:00.000,2021-09-16 10:11:33.897
17490,0,0,강원,0,0,0,294,2020-02-04 09:00:00.000,2021-09-16 10:11:33.897
17491,0,0,충북,0,0,0,293,2020-02-04 09:00:00.000,2021-09-16 10:11:33.897
17492,0,0,충남,0,0,0,292,2020-02-04 09:00:00.000,2021-09-16 10:11:33.897
17493,0,1,전북,0,0,0,291,2020-02-04 09:00:00.000,2021-09-16 10:11:33.897
17494,0,0,전남,0,0,0,290,2020-02-04 09:00:00.000,2021-09-16 10:11:33.897
17495,0,0,경북,0,0,0,289,2020-02-04 09:00:00.000,2021-09-16 10:11:33.897
17496,0,0,경남,0,0,0,288,2020-02-04 09:00:00.000,2021-09-16 10:11:33.897
17497,0,0,제주,0,0,0,287,2020-02-04 09:00:00.000,2021-09-16 10:11:33.897
17498,0,0,검역,0,0,0,286,2020-02-04 09:00:00.000,2021-09-16 10:11:33.897
17499,0,15,합계,0,0,0,285,2020-02-03 09:00:00.000,2021-09-16 10:11:33.897
17500,0,8,서울,0,0,0,284,2020-02-03 09:00:00.000,2021-09-16 10:11:33.897
17501,0,0,부산,0,0,0,283,2020-02-03 09:00:00.000,2021-09-16 10:11:33.897
17502,0,0,대구,0,0,0,282,2020-02-03 09:00:00.000,2021-09-16 10:11:33.897
17503,0,1,인천,0,0,0,281,2020-02-03 09:00:00.000,2021-09-16 10:11:33.897
17504,0,0,광주,0,0,0,280,2020-02-03 09:00:00.000,2021-09-16 10:11:33.897
17505,0,0,대전,0,0,0,279,2020-02-03 09:00:00.000,2021-09-16 10:11:33.897
17506,0,0,울산,0,0,0,278,2020-02-03 09:00:00.000,2021-09-16 10:11:33.897
17507,0,0,세종,0,0,0,277,2020-02-03 09:00:00.000,2021-09-16 10:11:33.897
17508,0,5,경기,0,0,0,276,2020-02-03 09:00:00.000,2021-09-16 10:11:33.897
17509,0,0,강원,0,0,0,275,2020-02-03 09:00:00.000,2021-09-16 10:11:33.897
17510,0,0,충북,0,0,0,274,2020-02-03 09:00:00.000,2021-09-16 10:11:33.897
17511,0,0,충남,0,0,0,273,2020-02-03 09:00:00.000,2021-09-16 10:11:33.897
17512,0,1,전북,0,0,0,272,2020-02-03 09:00:00.000,2021-09-16 10:11:33.897
17513,0,0,전남,0,0,0,271,2020-02-03 09:00:00.000,2021-09-16 10:11:33.897
17514,0,0,경북,0,0,0,270,2020-02-03 09:00:00.000,2021-09-16 10:11:33.897
17515,0,0,경남,0,0,0,269,2020-02-03 09:00:00.000,2021-09-16 10:11:33.897
17516,0,0,제주,0,0,0,268,2020-02-03 09:00:00.000,2021-09-16 10:11:33.897
17517,0,0,검역,0,0,0,267,2020-02-03 09:00:00.000,2021-09-16 10:11:33.897
17518,0,15,합계,3,1,2,266,2020-02-02 09:00:00.000,2021-09-16 10:11:33.897
17519,0,8,서울,1,0,1,265,2020-02-02 09:00:00.000,2021-09-16 10:11:33.897
17520,0,0,부산,0,0,0,264,2020-02-02 09:00:00.000,2021-09-16 10:11:33.897
17521,0,0,대구,0,0,0,263,2020-02-02 09:00:00.000,2021-09-16 10:11:33.897
17522,0,1,인천,0,0,0,262,2020-02-02 09:00:00.000,2021-09-16 10:11:33.897
17523,0,0,광주,0,0,0,261,2020-02-02 09:00:00.000,2021-09-16 10:11:33.897
17524,0,0,대전,0,0,0,260,2020-02-02 09:00:00.000,2021-09-16 10:11:33.897
17525,0,0,울산,0,0,0,259,2020-02-02 09:00:00.000,2021-09-16 10:11:33.897
17526,0,0,세종,0,0,0,258,2020-02-02 09:00:00.000,2021-09-16 10:11:33.897
17527,0,5,경기,2,1,1,257,2020-02-02 09:00:00.000,2021-09-16 10:11:33.897
17528,0,0,강원,0,0,0,256,2020-02-02 09:00:00.000,2021-09-16 10:11:33.897
17529,0,0,충북,0,0,0,255,2020-02-02 09:00:00.000,2021-09-16 10:11:33.897
17530,0,0,충남,0,0,0,254,2020-02-02 09:00:00.000,2021-09-16 10:11:33.897
17531,0,1,전북,0,0,0,253,2020-02-02 09:00:00.000,2021-09-16 10:11:33.897
17532,0,0,전남,0,0,0,252,2020-02-02 09:00:00.000,2021-09-16 10:11:33.897
17533,0,0,경북,0,0,0,251,2020-02-02 09:00:00.000,2021-09-16 10:11:33.897
17534,0,0,경남,0,0,0,250,2020-02-02 09:00:00.000,2021-09-16 10:11:33.897
17535,0,0,제주,0,0,0,249,2020-02-02 09:00:00.000,2021-09-16 10:11:33.897
17536,0,0,검역,0,0,0,248,2020-02-02 09:00:00.000,2021-09-16 10:11:33.897
17537,0,12,합계,1,0,1,247,2020-02-01 09:00:00.000,2021-09-16 10:11:33.897
17538,0,7,서울,0,0,0,246,2020-02-01 09:00:00.000,2021-09-16 10:11:33.897
17539,0,0,부산,0,0,0,245,2020-02-01 09:00:00.000,2021-09-16 10:11:33.897
17540,0,0,대구,0,0,0,244,2020-02-01 09:00:00.000,2021-09-16 10:11:33.897
17541,0,1,인천,0,0,0,243,2020-02-01 09:00:00.000,2021-09-16 10:11:33.897
17542,0,0,광주,0,0,0,242,2020-02-01 09:00:00.000,2021-09-16 10:11:33.897
17543,0,0,대전,0,0,0,241,2020-02-01 09:00:00.000,2021-09-16 10:11:33.897
17544,0,0,울산,0,0,0,240,2020-02-01 09:00:00.000,2021-09-16 10:11:33.897
17545,0,0,세종,0,0,0,239,2020-02-01 09:00:00.000,2021-09-16 10:11:33.897
17546,0,3,경기,1,0,1,238,2020-02-01 09:00:00.000,2021-09-16 10:11:33.897
17547,0,0,강원,0,0,0,237,2020-02-01 09:00:00.000,2021-09-16 10:11:33.897
17548,0,0,충북,0,0,0,236,2020-02-01 09:00:00.000,2021-09-16 10:11:33.897
17549,0,0,충남,0,0,0,235,2020-02-01 09:00:00.000,2021-09-16 10:11:33.897
17550,0,1,전북,0,0,0,234,2020-02-01 09:00:00.000,2021-09-16 10:11:33.897
17551,0,0,전남,0,0,0,233,2020-02-01 09:00:00.000,2021-09-16 10:11:33.897
17552,0,0,경북,0,0,0,232,2020-02-01 09:00:00.000,2021-09-16 10:11:33.897
17553,0,0,경남,0,0,0,231,2020-02-01 09:00:00.000,2021-09-16 10:11:33.897
17554,0,0,제주,0,0,0,230,2020-02-01 09:00:00.000,2021-09-16 10:11:33.897
17555,0,0,검역,0,0,0,229,2020-02-01 09:00:00.000,2021-09-16 10:11:33.897
17556,0,11,합계,4,3,1,228,2020-01-31 09:00:00.000,2021-09-16 10:11:33.897
17557,0,7,서울,3,3,0,227,2020-01-31 09:00:00.000,2021-09-16 10:11:33.897
17558,0,0,부산,0,0,0,226,2020-01-31 09:00:00.000,2021-09-16 10:11:33.897
17559,0,0,대구,0,0,0,225,2020-01-31 09:00:00.000,2021-09-16 10:11:33.897
17560,0,1,인천,0,0,0,224,2020-01-31 09:00:00.000,2021-09-16 10:11:33.897
17561,0,0,광주,0,0,0,223,2020-01-31 09:00:00.000,2021-09-16 10:11:33.897
17562,0,0,대전,0,0,0,222,2020-01-31 09:00:00.000,2021-09-16 10:11:33.897
17563,0,0,울산,0,0,0,221,2020-01-31 09:00:00.000,2021-09-16 10:11:33.897
17564,0,0,세종,0,0,0,220,2020-01-31 09:00:00.000,2021-09-16 10:11:33.897
17565,0,2,경기,0,0,0,219,2020-01-31 09:00:00.000,2021-09-16 10:11:33.897
17566,0,0,강원,0,0,0,218,2020-01-31 09:00:00.000,2021-09-16 10:11:33.897
17567,0,0,충북,0,0,0,217,2020-01-31 09:00:00.000,2021-09-16 10:11:33.897
17568,0,0,충남,0,0,0,216,2020-01-31 09:00:00.000,2021-09-16 10:11:33.897
17569,0,1,전북,1,0,1,215,2020-01-31 09:00:00.000,2021-09-16 10:11:33.897
17570,0,0,전남,0,0,0,214,2020-01-31 09:00:00.000,2021-09-16 10:11:33.897
17571,0,0,경북,0,0,0,213,2020-01-31 09:00:00.000,2021-09-16 10:11:33.897
17572,0,0,경남,0,0,0,212,2020-01-31 09:00:00.000,2021-09-16 10:11:33.897
17573,0,0,제주,0,0,0,211,2020-01-31 09:00:00.000,2021-09-16 10:11:33.897
17574,0,0,검역,0,0,0,210,2020-01-31 09:00:00.000,2021-09-16 10:11:33.897
17575,0,7,합계,3,1,2,209,2020-01-30 09:00:00.000,2021-09-16 10:11:33.897
17576,0,4,서울,3,1,2,208,2020-01-30 09:00:00.000,2021-09-16 10:11:33.897
17577,0,0,부산,0,0,0,207,2020-01-30 09:00:00.000,2021-09-16 10:11:33.897
17578,0,0,대구,0,0,0,206,2020-01-30 09:00:00.000,2021-09-16 10:11:33.897
17579,0,1,인천,0,0,0,205,2020-01-30 09:00:00.000,2021-09-16 10:11:33.897
17580,0,0,광주,0,0,0,204,2020-01-30 09:00:00.000,2021-09-16 10:11:33.897
17581,0,0,대전,0,0,0,203,2020-01-30 09:00:00.000,2021-09-16 10:11:33.897
17582,0,0,울산,0,0,0,202,2020-01-30 09:00:00.000,2021-09-16 10:11:33.897
17583,0,0,세종,0,0,0,201,2020-01-30 09:00:00.000,2021-09-16 10:11:33.897
17584,0,2,경기,0,0,0,200,2020-01-30 09:00:00.000,2021-09-16 10:11:33.897
17585,0,0,강원,0,0,0,199,2020-01-30 09:00:00.000,2021-09-16 10:11:33.897
17586,0,0,충북,0,0,0,198,2020-01-30 09:00:00.000,2021-09-16 10:11:33.897
17587,0,0,충남,0,0,0,197,2020-01-30 09:00:00.000,2021-09-16 10:11:33.897
17588,0,0,전북,0,0,0,196,2020-01-30 09:00:00.000,2021-09-16 10:11:33.897
17589,0,0,전남,0,0,0,195,2020-01-30 09:00:00.000,2021-09-16 10:11:33.897
17590,0,0,경북,0,0,0,194,2020-01-30 09:00:00.000,2021-09-16 10:11:33.897
17591,0,0,경남,0,0,0,193,2020-01-30 09:00:00.000,2021-09-16 10:11:33.897
17592,0,0,제주,0,0,0,192,2020-01-30 09:00:00.000,2021-09-16 10:11:33.897
17593,0,0,검역,0,0,0,191,2020-01-30 09:00:00.000,2021-09-16 10:11:33.897
17594,0,4,합계,0,0,0,190,2020-01-29 09:00:00.000,2021-09-16 10:11:33.897
17595,0,1,서울,0,0,0,189,2020-01-29 09:00:00.000,2021-09-16 10:11:33.897
17596,0,0,부산,0,0,0,188,2020-01-29 09:00:00.000,2021-09-16 10:11:33.897
17597,0,0,대구,0,0,0,187,2020-01-29 09:00:00.000,2021-09-16 10:11:33.897
17598,0,1,인천,0,0,0,186,2020-01-29 09:00:00.000,2021-09-16 10:11:33.897
17599,0,0,광주,0,0,0,185,2020-01-29 09:00:00.000,2021-09-16 10:11:33.897
17600,0,0,대전,0,0,0,184,2020-01-29 09:00:00.000,2021-09-16 10:11:33.897
17601,0,0,울산,0,0,0,183,2020-01-29 09:00:00.000,2021-09-16 10:11:33.897
17602,0,0,세종,0,0,0,182,2020-01-29 09:00:00.000,2021-09-16 10:11:33.897
17603,0,2,경기,0,0,0,181,2020-01-29 09:00:00.000,2021-09-16 10:11:33.897
17604,0,0,강원,0,0,0,180,2020-01-29 09:00:00.000,2021-09-16 10:11:33.897
17605,0,0,충북,0,0,0,179,2020-01-29 09:00:00.000,2021-09-16 10:11:33.897
17606,0,0,충남,0,0,0,178,2020-01-29 09:00:00.000,2021-09-16 10:11:33.897
17607,0,0,전북,0,0,0,177,2020-01-29 09:00:00.000,2021-09-16 10:11:33.897
17608,0,0,전남,0,0,0,176,2020-01-29 09:00:00.000,2021-09-16 10:11:33.897
17609,0,0,경북,0,0,0,175,2020-01-29 09:00:00.000,2021-09-16 10:11:33.897
17610,0,0,경남,0,0,0,174,2020-01-29 09:00:00.000,2021-09-16 10:11:33.897
17611,0,0,제주,0,0,0,173,2020-01-29 09:00:00.000,2021-09-16 10:11:33.897
17612,0,0,검역,0,0,0,172,2020-01-29 09:00:00.000,2021-09-16 10:11:33.897
17613,0,4,합계,0,0,0,171,2020-01-28 09:00:00.000,2021-09-16 10:11:33.897
17614,0,1,서울,0,0,0,170,2020-01-28 09:00:00.000,2021-09-16 10:11:33.897
17615,0,0,부산,0,0,0,169,2020-01-28 09:00:00.000,2021-09-16 10:11:33.897
17616,0,0,대구,0,0,0,168,2020-01-28 09:00:00.000,2021-09-16 10:11:33.897
17617,0,1,인천,0,0,0,167,2020-01-28 09:00:00.000,2021-09-16 10:11:33.897
17618,0,0,광주,0,0,0,166,2020-01-28 09:00:00.000,2021-09-16 10:11:33.897
17619,0,0,대전,0,0,0,165,2020-01-28 09:00:00.000,2021-09-16 10:11:33.897
17620,0,0,울산,0,0,0,164,2020-01-28 09:00:00.000,2021-09-16 10:11:33.897
17621,0,0,세종,0,0,0,163,2020-01-28 09:00:00.000,2021-09-16 10:11:33.897
17622,0,2,경기,0,0,0,162,2020-01-28 09:00:00.000,2021-09-16 10:11:33.897
17623,0,0,강원,0,0,0,161,2020-01-28 09:00:00.000,2021-09-16 10:11:33.897
17624,0,0,충북,0,0,0,160,2020-01-28 09:00:00.000,2021-09-16 10:11:33.897
17625,0,0,충남,0,0,0,159,2020-01-28 09:00:00.000,2021-09-16 10:11:33.897
17626,0,0,전북,0,0,0,158,2020-01-28 09:00:00.000,2021-09-16 10:11:33.897
17627,0,0,전남,0,0,0,157,2020-01-28 09:00:00.000,2021-09-16 10:11:33.897
17628,0,0,경북,0,0,0,156,2020-01-28 09:00:00.000,2021-09-16 10:11:33.897
17629,0,0,경남,0,0,0,155,2020-01-28 09:00:00.000,2021-09-16 10:11:33.897
17630,0,0,제주,0,0,0,154,2020-01-28 09:00:00.000,2021-09-16 10:11:33.897
17631,0,0,검역,0,0,0,153,2020-01-28 09:00:00.000,2021-09-16 10:11:33.897
17632,0,4,합계,1,0,1,152,2020-01-27 09:00:00.000,2021-09-16 10:11:33.897
17633,0,1,서울,0,0,0,151,2020-01-27 09:00:00.000,2021-09-16 10:11:33.897
17634,0,0,부산,0,0,0,150,2020-01-27 09:00:00.000,2021-09-16 10:11:33.897
17635,0,0,대구,0,0,0,149,2020-01-27 09:00:00.000,2021-09-16 10:11:33.897
17636,0,1,인천,0,0,0,148,2020-01-27 09:00:00.000,2021-09-16 10:11:33.897
17637,0,0,광주,0,0,0,147,2020-01-27 09:00:00.000,2021-09-16 10:11:33.897
17638,0,0,대전,0,0,0,146,2020-01-27 09:00:00.000,2021-09-16 10:11:33.897
17639,0,0,울산,0,0,0,145,2020-01-27 09:00:00.000,2021-09-16 10:11:33.897
17640,0,0,세종,0,0,0,144,2020-01-27 09:00:00.000,2021-09-16 10:11:33.897
17641,0,2,경기,1,0,1,143,2020-01-27 09:00:00.000,2021-09-16 10:11:33.897
17642,0,0,강원,0,0,0,142,2020-01-27 09:00:00.000,2021-09-16 10:11:33.897
17643,0,0,충북,0,0,0,141,2020-01-27 09:00:00.000,2021-09-16 10:11:33.897
17644,0,0,충남,0,0,0,140,2020-01-27 09:00:00.000,2021-09-16 10:11:33.897
17645,0,0,전북,0,0,0,139,2020-01-27 09:00:00.000,2021-09-16 10:11:33.897
17646,0,0,전남,0,0,0,138,2020-01-27 09:00:00.000,2021-09-16 10:11:33.897
17647,0,0,경북,0,0,0,137,2020-01-27 09:00:00.000,2021-09-16 10:11:33.897
17648,0,0,경남,0,0,0,136,2020-01-27 09:00:00.000,2021-09-16 10:11:33.897
17649,0,0,제주,0,0,0,135,2020-01-27 09:00:00.000,2021-09-16 10:11:33.897
17650,0,0,검역,0,0,0,134,2020-01-27 09:00:00.000,2021-09-16 10:11:33.897
17651,0,3,합계,1,0,1,133,2020-01-26 09:00:00.000,2021-09-16 10:11:33.897
17652,0,1,서울,0,0,0,132,2020-01-26 09:00:00.000,2021-09-16 10:11:33.897
17653,0,0,부산,0,0,0,131,2020-01-26 09:00:00.000,2021-09-16 10:11:33.897
17654,0,0,대구,0,0,0,130,2020-01-26 09:00:00.000,2021-09-16 10:11:33.897
17655,0,1,인천,0,0,0,129,2020-01-26 09:00:00.000,2021-09-16 10:11:33.897
17656,0,0,광주,0,0,0,128,2020-01-26 09:00:00.000,2021-09-16 10:11:33.897
17657,0,0,대전,0,0,0,127,2020-01-26 09:00:00.000,2021-09-16 10:11:33.897
17658,0,0,울산,0,0,0,126,2020-01-26 09:00:00.000,2021-09-16 10:11:33.897
17659,0,0,세종,0,0,0,125,2020-01-26 09:00:00.000,2021-09-16 10:11:33.897
17660,0,1,경기,1,0,1,124,2020-01-26 09:00:00.000,2021-09-16 10:11:33.897
17661,0,0,강원,0,0,0,123,2020-01-26 09:00:00.000,2021-09-16 10:11:33.897
17662,0,0,충북,0,0,0,122,2020-01-26 09:00:00.000,2021-09-16 10:11:33.897
17663,0,0,충남,0,0,0,121,2020-01-26 09:00:00.000,2021-09-16 10:11:33.897
17664,0,0,전북,0,0,0,120,2020-01-26 09:00:00.000,2021-09-16 10:11:33.897
17665,0,0,전남,0,0,0,119,2020-01-26 09:00:00.000,2021-09-16 10:11:33.897
17666,0,0,경북,0,0,0,118,2020-01-26 09:00:00.000,2021-09-16 10:11:33.897
17667,0,0,경남,0,0,0,117,2020-01-26 09:00:00.000,2021-09-16 10:11:33.897
17668,0,0,제주,0,0,0,116,2020-01-26 09:00:00.000,2021-09-16 10:11:33.897
17669,0,0,검역,0,0,0,115,2020-01-26 09:00:00.000,2021-09-16 10:11:33.897
17670,0,2,합계,0,0,0,114,2020-01-25 09:00:00.000,2021-09-16 10:11:33.897
17671,0,1,서울,0,0,0,113,2020-01-25 09:00:00.000,2021-09-16 10:11:33.897
17672,0,0,부산,0,0,0,112,2020-01-25 09:00:00.000,2021-09-16 10:11:33.897
17673,0,0,대구,0,0,0,111,2020-01-25 09:00:00.000,2021-09-16 10:11:33.897
17674,0,1,인천,0,0,0,110,2020-01-25 09:00:00.000,2021-09-16 10:11:33.897
17675,0,0,광주,0,0,0,109,2020-01-25 09:00:00.000,2021-09-16 10:11:33.897
17676,0,0,대전,0,0,0,108,2020-01-25 09:00:00.000,2021-09-16 10:11:33.897
17677,0,0,울산,0,0,0,107,2020-01-25 09:00:00.000,2021-09-16 10:11:33.897
17678,0,0,세종,0,0,0,106,2020-01-25 09:00:00.000,2021-09-16 10:11:33.897
17679,0,0,경기,0,0,0,105,2020-01-25 09:00:00.000,2021-09-16 10:11:33.897
17680,0,0,강원,0,0,0,104,2020-01-25 09:00:00.000,2021-09-16 10:11:33.897
17681,0,0,충북,0,0,0,103,2020-01-25 09:00:00.000,2021-09-16 10:11:33.897
17682,0,0,충남,0,0,0,102,2020-01-25 09:00:00.000,2021-09-16 10:11:33.897
17683,0,0,전북,0,0,0,101,2020-01-25 09:00:00.000,2021-09-16 10:11:33.897
17684,0,0,전남,0,0,0,100,2020-01-25 09:00:00.000,2021-09-16 10:11:33.897
17685,0,0,경북,0,0,0,99,2020-01-25 09:00:00.000,2021-09-16 10:11:33.897
17686,0,0,경남,0,0,0,98,2020-01-25 09:00:00.000,2021-09-16 10:11:33.897
17687,0,0,제주,0,0,0,97,2020-01-25 09:00:00.000,2021-09-16 10:11:33.897
17688,0,0,검역,0,0,0,96,2020-01-25 09:00:00.000,2021-09-16 10:11:33.897
17689,0,2,합계,1,0,1,95,2020-01-24 09:00:00.000,2021-09-16 10:11:33.897
17690,0,1,서울,1,0,1,94,2020-01-24 09:00:00.000,2021-09-16 10:11:33.897
17691,0,0,부산,0,0,0,93,2020-01-24 09:00:00.000,2021-09-16 10:11:33.897
17692,0,0,대구,0,0,0,92,2020-01-24 09:00:00.000,2021-09-16 10:11:33.897
17693,0,1,인천,0,0,0,91,2020-01-24 09:00:00.000,2021-09-16 10:11:33.897
17694,0,0,광주,0,0,0,90,2020-01-24 09:00:00.000,2021-09-16 10:11:33.897
17695,0,0,대전,0,0,0,89,2020-01-24 09:00:00.000,2021-09-16 10:11:33.897
17696,0,0,울산,0,0,0,88,2020-01-24 09:00:00.000,2021-09-16 10:11:33.897
17697,0,0,세종,0,0,0,87,2020-01-24 09:00:00.000,2021-09-16 10:11:33.897
17698,0,0,경기,0,0,0,86,2020-01-24 09:00:00.000,2021-09-16 10:11:33.897
17699,0,0,강원,0,0,0,85,2020-01-24 09:00:00.000,2021-09-16 10:11:33.897
17700,0,0,충북,0,0,0,84,2020-01-24 09:00:00.000,2021-09-16 10:11:33.897
17701,0,0,충남,0,0,0,83,2020-01-24 09:00:00.000,2021-09-16 10:11:33.897
17702,0,0,전북,0,0,0,82,2020-01-24 09:00:00.000,2021-09-16 10:11:33.897
17703,0,0,전남,0,0,0,81,2020-01-24 09:00:00.000,2021-09-16 10:11:33.897
17704,0,0,경북,0,0,0,80,2020-01-24 09:00:00.000,2021-09-16 10:11:33.897
17705,0,0,경남,0,0,0,79,2020-01-24 09:00:00.000,2021-09-16 10:11:33.897
17706,0,0,제주,0,0,0,78,2020-01-24 09:00:00.000,2021-09-16 10:11:33.897
17707,0,0,검역,0,0,0,77,2020-01-24 09:00:00.000,2021-09-16 10:11:33.897
17708,0,1,합계,0,0,0,76,2020-01-23 09:00:00.000,2021-09-16 10:11:33.897
17709,0,0,서울,0,0,0,75,2020-01-23 09:00:00.000,2021-09-16 10:11:33.897
17710,0,0,부산,0,0,0,74,2020-01-23 09:00:00.000,2021-09-16 10:11:33.897
17711,0,0,대구,0,0,0,73,2020-01-23 09:00:00.000,2021-09-16 10:11:33.897
17712,0,1,인천,0,0,0,72,2020-01-23 09:00:00.000,2021-09-16 10:11:33.897
17713,0,0,광주,0,0,0,71,2020-01-23 09:00:00.000,2021-09-16 10:11:33.897
17714,0,0,대전,0,0,0,70,2020-01-23 09:00:00.000,2021-09-16 10:11:33.897
17715,0,0,울산,0,0,0,69,2020-01-23 09:00:00.000,2021-09-16 10:11:33.897
17716,0,0,세종,0,0,0,68,2020-01-23 09:00:00.000,2021-09-16 10:11:33.897
17717,0,0,경기,0,0,0,67,2020-01-23 09:00:00.000,2021-09-16 10:11:33.897
17718,0,0,강원,0,0,0,66,2020-01-23 09:00:00.000,2021-09-16 10:11:33.897
17719,0,0,충북,0,0,0,65,2020-01-23 09:00:00.000,2021-09-16 10:11:33.897
17720,0,0,충남,0,0,0,64,2020-01-23 09:00:00.000,2021-09-16 10:11:33.897
17721,0,0,전북,0,0,0,63,2020-01-23 09:00:00.000,2021-09-16 10:11:33.897
17722,0,0,전남,0,0,0,62,2020-01-23 09:00:00.000,2021-09-16 10:11:33.897
17723,0,0,경북,0,0,0,61,2020-01-23 09:00:00.000,2021-09-16 10:11:33.897
17724,0,0,경남,0,0,0,60,2020-01-23 09:00:00.000,2021-09-16 10:11:33.897
17725,0,0,제주,0,0,0,59,2020-01-23 09:00:00.000,2021-09-16 10:11:33.897
17726,0,0,검역,0,0,0,58,2020-01-23 09:00:00.000,2021-09-16 10:11:33.897
17727,0,1,합계,0,0,0,57,2020-01-22 09:00:00.000,2021-09-16 10:11:33.897
17728,0,0,서울,0,0,0,56,2020-01-22 09:00:00.000,2021-09-16 10:11:33.897
17729,0,0,부산,0,0,0,55,2020-01-22 09:00:00.000,2021-09-16 10:11:33.897
17730,0,0,대구,0,0,0,54,2020-01-22 09:00:00.000,2021-09-16 10:11:33.897
17731,0,1,인천,0,0,0,53,2020-01-22 09:00:00.000,2021-09-16 10:11:33.897
17732,0,0,광주,0,0,0,52,2020-01-22 09:00:00.000,2021-09-16 10:11:33.897
17733,0,0,대전,0,0,0,51,2020-01-22 09:00:00.000,2021-09-16 10:11:33.897
17734,0,0,울산,0,0,0,50,2020-01-22 09:00:00.000,2021-09-16 10:11:33.897
17735,0,0,세종,0,0,0,49,2020-01-22 09:00:00.000,2021-09-16 10:11:33.897
17736,0,0,경기,0,0,0,48,2020-01-22 09:00:00.000,2021-09-16 10:11:33.897
17737,0,0,강원,0,0,0,47,2020-01-22 09:00:00.000,2021-09-16 10:11:33.897
17738,0,0,충북,0,0,0,46,2020-01-22 09:00:00.000,2021-09-16 10:11:33.897
17739,0,0,충남,0,0,0,45,2020-01-22 09:00:00.000,2021-09-16 10:11:33.897
17740,0,0,전북,0,0,0,44,2020-01-22 09:00:00.000,2021-09-16 10:11:33.897
17741,0,0,전남,0,0,0,43,2020-01-22 09:00:00.000,2021-09-16 10:11:33.897
17742,0,0,경북,0,0,0,42,2020-01-22 09:00:00.000,2021-09-16 10:11:33.897
17743,0,0,경남,0,0,0,41,2020-01-22 09:00:00.000,2021-09-16 10:11:33.897
17744,0,0,제주,0,0,0,40,2020-01-22 09:00:00.000,2021-09-16 10:11:33.897
17745,0,0,검역,0,0,0,39,2020-01-22 09:00:00.000,2021-09-16 10:11:33.897
17746,0,1,합계,0,0,0,38,2020-01-21 09:00:00.000,2021-09-16 10:11:33.897
17747,0,0,서울,0,0,0,37,2020-01-21 09:00:00.000,2021-09-16 10:11:33.897
17748,0,0,부산,0,0,0,36,2020-01-21 09:00:00.000,2021-09-16 10:11:33.897
17749,0,0,대구,0,0,0,35,2020-01-21 09:00:00.000,2021-09-16 10:11:33.897
17750,0,1,인천,0,0,0,34,2020-01-21 09:00:00.000,2021-09-16 10:11:33.897
17751,0,0,광주,0,0,0,33,2020-01-21 09:00:00.000,2021-09-16 10:11:33.897
17752,0,0,대전,0,0,0,32,2020-01-21 09:00:00.000,2021-09-16 10:11:33.897
17753,0,0,울산,0,0,0,31,2020-01-21 09:00:00.000,2021-09-16 10:11:33.897
17754,0,0,세종,0,0,0,30,2020-01-21 09:00:00.000,2021-09-16 10:11:33.897
17755,0,0,경기,0,0,0,29,2020-01-21 09:00:00.000,2021-09-16 10:11:33.897
17756,0,0,강원,0,0,0,28,2020-01-21 09:00:00.000,2021-09-16 10:11:33.897
17757,0,0,충북,0,0,0,27,2020-01-21 09:00:00.000,2021-09-16 10:11:33.897
17758,0,0,충남,0,0,0,26,2020-01-21 09:00:00.000,2021-09-16 10:11:33.897
17759,0,0,전북,0,0,0,25,2020-01-21 09:00:00.000,2021-09-16 10:11:33.897
17760,0,0,전남,0,0,0,24,2020-01-21 09:00:00.000,2021-09-16 10:11:33.897
17761,0,0,경북,0,0,0,23,2020-01-21 09:00:00.000,2021-09-16 10:11:33.897
17762,0,0,경남,0,0,0,22,2020-01-21 09:00:00.000,2021-09-16 10:11:33.897
17763,0,0,제주,0,0,0,21,2020-01-21 09:00:00.000,2021-09-16 10:11:33.897
17764,0,0,검역,0,0,0,20,2020-01-21 09:00:00.000,2021-09-16 10:11:33.897
17765,0,1,합계,0,0,1,19,2020-01-20 09:00:00.000,2021-09-16 10:11:33.897
17766,0,0,서울,0,0,0,18,2020-01-20 09:00:00.000,2021-09-16 10:11:33.897
17767,0,0,부산,0,0,0,17,2020-01-20 09:00:00.000,2021-09-16 10:11:33.897
17768,0,0,대구,0,0,0,16,2020-01-20 09:00:00.000,2021-09-16 10:11:33.897
17769,0,1,인천,0,0,1,15,2020-01-20 09:00:00.000,2021-09-16 10:11:33.897
17770,0,0,광주,0,0,0,14,2020-01-20 09:00:00.000,2021-09-16 10:11:33.897
17771,0,0,대전,0,0,0,13,2020-01-20 09:00:00.000,2021-09-16 10:11:33.897
17772,0,0,울산,0,0,0,12,2020-01-20 09:00:00.000,2021-09-16 10:11:33.897
17773,0,0,세종,0,0,0,11,2020-01-20 09:00:00.000,2021-09-16 10:11:33.897
17774,0,0,경기,0,0,0,10,2020-01-20 09:00:00.000,2021-09-16 10:11:33.897
17775,0,0,강원,0,0,0,9,2020-01-20 09:00:00.000,2021-09-16 10:11:33.897
17776,0,0,충북,0,0,0,8,2020-01-20 09:00:00.000,2021-09-16 10:11:33.897
17777,0,0,충남,0,0,0,7,2020-01-20 09:00:00.000,2021-09-16 10:11:33.897
17778,0,0,전북,0,0,0,6,2020-01-20 09:00:00.000,2021-09-16 10:11:33.897
17779,0,0,전남,0,0,0,5,2020-01-20 09:00:00.000,2021-09-16 10:11:33.897
17780,0,0,경북,0,0,0,4,2020-01-20 09:00:00.000,2021-09-16 10:11:33.897
17781,0,0,경남,0,0,0,3,2020-01-20 09:00:00.000,2021-09-16 10:11:33.897
17782,0,0,제주,0,0,0,2,2020-01-20 09:00:00.000,2021-09-16 10:11:33.897
17783,0,0,검역,0,0,0,1,2020-01-20 09:00:00.000,2021-09-16 10:11:33.897
